gene	gapped_len	mel_len	sim_len	gap_num	indel_num	indel_mean_len	ungapped_len
FBgn0000008	566	500	550	82	9	9.11111111111111	484
FBgn0000014	500	500	494	6	3	2	494
FBgn0000015	500	500	499	1	1	1	499
FBgn0000017	506	500	401	111	5	22.2	395
FBgn0000022	513	500	510	16	4	4	497
FBgn0000024	501	500	496	6	3	2	495
FBgn0000028	510	500	505	15	3	5	495
FBgn0000032	350	350	343	7	1	7	343
FBgn0000036	521	500	515	27	4	6.75	494
FBgn0000037	502	500	496	8	2	4	494
FBgn0000038	501	500	494	8	4	2	493
FBgn0000039	514	500	512	16	5	3.2	498
FBgn0000042	508	500	446	70	6	11.666666666666666	438
FBgn0000043	517	500	368	166	6	27.666666666666668	351
FBgn0000044	503	500	491	15	5	3	488
FBgn0000045	540	500	405	175	6	29.166666666666668	365
FBgn0000046	504	500	463	45	6	7.5	459
FBgn0000047	582	500	573	91	9	10.11111111111111	491
FBgn0000052	516	500	508	24	4	6	492
FBgn0000053	525	500	519	31	4	7.75	494
FBgn0000057	537	500	531	43	5	8.6	494
FBgn0000061	500	500	498	2	1	2	498
FBgn0000063	508	500	495	21	6	3.5	487
FBgn0000064	506	500	504	8	3	2.6666666666666665	498
FBgn0000071	502	500	470	34	2	17	468
FBgn0000077	501	500	498	4	2	2	497
FBgn0000079	520	500	518	22	5	4.4	498
FBgn0000083	540	500	519	61	8	7.625	479
FBgn0000084	501	500	451	51	7	7.285714285714286	450
FBgn0000092	511	500	511	11	1	11	500
FBgn0000094	514	500	455	73	7	10.428571428571429	441
FBgn0000097	505	500	501	9	4	2.25	496
FBgn0000100	510	500	510	10	1	10	500
FBgn0000108	513	500	481	45	6	7.5	468
FBgn0000109	507	500	465	49	5	9.8	458
FBgn0000115	501	500	501	1	1	1	500
FBgn0000116	513	500	490	36	4	9	477
FBgn0000119	512	500	478	46	7	6.571428571428571	466
FBgn0000120	500	500	496	4	2	2	496
FBgn0000121	500	500	495	5	2	2.5	495
FBgn0000137	500	500	494	6	2	3	494
FBgn0000139	500	500	497	3	2	1.5	497
FBgn0000140	452	428	448	28	5	5.6	424
FBgn0000147	503	500	293	213	2	106.5	290
FBgn0000150	505	489	477	44	9	4.888888888888889	461
FBgn0000152	544	500	541	47	6	7.833333333333333	497
FBgn0000153	501	500	499	3	2	1.5	498
FBgn0000157	500	500	500	0	0	NA	500
FBgn0000158	514	500	447	81	9	9	433
FBgn0000173	520	500	515	25	4	6.25	495
FBgn0000179	500	500	495	5	2	2.5	495
FBgn0000180	521	500	510	32	7	4.571428571428571	489
FBgn0000181	503	465	493	48	10	4.8	455
FBgn0000183	504	500	499	9	4	2.25	495
FBgn0000206	502	500	502	2	1	2	500
FBgn0000212	500	500	490	10	2	5	490
FBgn0000216	500	500	493	7	3	2.3333333333333335	493
FBgn0000221	504	500	502	6	2	3	498
FBgn0000227	500	500	491	9	1	9	491
FBgn0000228	500	500	208	292	4	73	208
FBgn0000229	500	500	500	0	0	NA	500
FBgn0000233	500	500	500	0	0	NA	500
FBgn0000239	527	500	520	34	7	4.857142857142857	493
FBgn0000244	520	500	484	56	7	8	464
FBgn0000246	500	500	496	4	2	2	496
FBgn0000247	520	500	516	24	4	6	496
FBgn0000251	502	500	498	6	3	2	496
FBgn0000253	516	500	479	53	9	5.888888888888889	463
FBgn0000256	509	500	501	17	4	4.25	492
FBgn0000257	500	500	344	156	5	31.2	344
FBgn0000273	563	500	542	84	8	10.5	479
FBgn0000274	518	500	517	19	4	4.75	499
FBgn0000276	502	500	475	29	8	3.625	473
FBgn0000277	403	402	321	83	7	11.857142857142858	320
FBgn0000278	523	500	504	42	10	4.2	481
FBgn0000279	500	500	448	52	3	17.333333333333332	448
FBgn0000281	426	415	396	41	8	5.125	385
FBgn0000283	360	359	346	15	3	5	345
FBgn0000286	501	500	499	3	3	1	498
FBgn0000287	502	500	500	4	3	1.3333333333333333	498
FBgn0000289	500	500	500	0	0	NA	500
FBgn0000299	515	500	514	16	3	5.333333333333333	499
FBgn0000308	520	500	461	79	9	8.777777777777779	441
FBgn0000317	549	500	538	60	5	12	489
FBgn0000318	501	500	425	77	4	19.25	424
FBgn0000320	500	500	480	20	3	6.666666666666667	480
FBgn0000326	500	500	408	92	3	30.666666666666668	408
FBgn0000330	557	500	543	71	4	17.75	486
FBgn0000337	521	500	463	79	7	11.285714285714286	442
FBgn0000339	501	500	499	3	2	1.5	498
FBgn0000352	513	500	500	26	7	3.7142857142857144	487
FBgn0000355	511	500	506	16	4	4	495
FBgn0000356	500	500	492	8	2	4	492
FBgn0000357	503	500	503	3	2	1.5	500
FBgn0000358	512	500	408	116	4	29	396
FBgn0000359	510	500	477	43	11	3.909090909090909	467
FBgn0000360	500	500	486	14	2	7	486
FBgn0000376	387	387	384	3	2	1.5	384
FBgn0000382	510	500	509	11	2	5.5	499
FBgn0000384	501	500	273	229	6	38.166666666666664	272
FBgn0000394	500	500	489	11	3	3.6666666666666665	489
FBgn0000395	551	500	546	56	6	9.333333333333334	495
FBgn0000404	550	500	501	99	12	8.25	451
FBgn0000405	511	500	508	14	4	3.5	497
FBgn0000406	505	500	504	6	3	2	499
FBgn0000411	505	500	333	177	3	59	328
FBgn0000414	525	500	525	25	3	8.333333333333334	500
FBgn0000416	515	500	504	26	4	6.5	489
FBgn0000422	513	500	464	62	7	8.857142857142858	451
FBgn0000426	500	500	497	3	1	3	497
FBgn0000427	510	500	473	47	5	9.4	463
FBgn0000439	511	500	507	15	3	5	496
FBgn0000442	502	500	498	6	4	1.5	496
FBgn0000447	517	500	517	17	4	4.25	500
FBgn0000448	395	395	392	3	1	3	392
FBgn0000449	467	440	438	56	5	11.2	411
FBgn0000451	500	500	483	17	3	5.666666666666667	483
FBgn0000455	500	500	500	0	0	NA	500
FBgn0000459	518	500	518	18	1	18	500
FBgn0000463	526	500	513	39	7	5.571428571428571	487
FBgn0000464	396	396	393	3	2	1.5	393
FBgn0000477	504	500	484	24	5	4.8	480
FBgn0000482	511	500	500	22	4	5.5	489
FBgn0000489	507	500	490	24	10	2.4	483
FBgn0000490	510	500	497	23	5	4.6	487
FBgn0000492	508	500	506	10	2	5	498
FBgn0000499	501	500	482	20	4	5	481
FBgn0000500	522	500	360	184	7	26.285714285714285	338
FBgn0000524	514	500	487	41	7	5.857142857142857	473
FBgn0000527	500	500	446	54	4	13.5	446
FBgn0000529	500	500	495	5	2	2.5	495
FBgn0000533	507	500	479	35	4	8.75	472
FBgn0000535	500	500	255	245	1	245	255
FBgn0000536	503	500	503	3	2	1.5	500
FBgn0000541	501	500	290	212	5	42.4	289
FBgn0000543	535	500	502	68	7	9.714285714285714	467
FBgn0000546	545	500	539	51	9	5.666666666666667	494
FBgn0000547	525	500	521	29	8	3.625	496
FBgn0000551	506	500	499	13	2	6.5	493
FBgn0000552	548	500	545	51	6	8.5	497
FBgn0000557	531	500	467	95	9	10.555555555555555	436
FBgn0000560	507	500	482	32	4	8	475
FBgn0000564	500	500	489	11	3	3.6666666666666665	489
FBgn0000565	448	447	448	1	1	1	447
FBgn0000567	514	500	514	14	2	7	500
FBgn0000568	500	500	475	25	2	12.5	475
FBgn0000575	513	500	506	20	6	3.3333333333333335	493
FBgn0000576	500	500	500	0	0	NA	500
FBgn0000577	501	500	501	1	1	1	500
FBgn0000578	539	500	515	63	9	7	476
FBgn0000579	507	500	496	18	6	3	489
FBgn0000581	500	500	494	6	3	2	494
FBgn0000591	503	500	502	4	2	2	499
FBgn0000592	503	500	495	11	4	2.75	492
FBgn0000606	500	500	498	2	1	2	498
FBgn0000611	533	500	512	54	7	7.714285714285714	479
FBgn0000615	510	500	510	10	1	10	500
FBgn0000617	511	500	480	42	7	6	469
FBgn0000618	501	500	500	2	2	1	499
FBgn0000625	502	500	499	5	2	2.5	497
FBgn0000629	500	500	496	4	2	2	496
FBgn0000633	520	500	507	33	11	3	487
FBgn0000635	515	500	511	19	4	4.75	496
FBgn0000636	501	500	371	131	4	32.75	370
FBgn0000639	517	500	502	32	4	8	485
FBgn0000640	505	500	486	24	3	8	481
FBgn0000644	515	500	495	35	13	2.6923076923076925	480
FBgn0000658	468	466	455	15	4	3.75	453
FBgn0000659	500	500	500	0	0	NA	500
FBgn0000662	509	500	506	12	5	2.4	497
FBgn0000709	511	500	500	22	3	7.333333333333333	489
FBgn0000711	519	500	345	193	5	38.6	326
FBgn0000715	502	500	497	7	4	1.75	495
FBgn0000721	506	500	461	51	11	4.636363636363637	455
FBgn0000723	508	500	382	134	8	16.75	374
FBgn0000808	412	398	389	37	4	9.25	375
FBgn0000810	521	500	516	26	5	5.2	495
FBgn0000928	502	500	470	34	8	4.25	468
FBgn0000964	515	500	502	28	7	4	487
FBgn0000996	555	500	550	60	12	5	495
FBgn0001075	520	500	493	47	8	5.875	473
FBgn0001077	500	500	498	2	2	1	498
FBgn0001079	531	500	509	53	7	7.571428571428571	478
FBgn0001083	507	500	478	36	10	3.6	471
FBgn0001085	500	500	499	1	1	1	499
FBgn0001086	500	500	497	3	2	1.5	497
FBgn0001087	504	500	431	77	7	11	427
FBgn0001089	509	500	452	66	9	7.333333333333333	443
FBgn0001090	511	500	477	45	4	11.25	466
FBgn0001091	500	500	479	21	5	4.2	479
FBgn0001092	509	500	503	15	6	2.5	494
FBgn0001104	502	500	499	5	5	1	497
FBgn0001105	500	500	215	285	1	285	215
FBgn0001108	547	500	495	99	9	11	448
FBgn0001112	530	500	529	31	5	6.2	499
FBgn0001114	507	500	451	63	5	12.6	444
FBgn0001120	545	500	525	65	6	10.833333333333334	480
FBgn0001122	524	500	486	62	8	7.75	462
FBgn0001123	513	500	502	24	4	6	489
FBgn0001124	509	500	509	9	3	3	500
FBgn0001125	500	500	491	9	4	2.25	491
FBgn0001128	509	500	483	35	6	5.833333333333333	474
FBgn0001133	500	500	498	2	2	1	498
FBgn0001134	501	500	501	1	1	1	500
FBgn0001137	509	500	469	49	7	7	460
FBgn0001138	500	500	493	7	3	2.3333333333333335	493
FBgn0001139	510	500	433	87	8	10.875	423
FBgn0001145	504	500	486	22	5	4.4	482
FBgn0001147	500	500	500	0	0	NA	500
FBgn0001148	519	500	517	21	4	5.25	498
FBgn0001149	510	500	507	13	5	2.6	497
FBgn0001150	501	500	500	2	2	1	499
FBgn0001168	502	500	478	26	3	8.666666666666666	476
FBgn0001169	509	500	485	33	9	3.6666666666666665	476
FBgn0001174	501	500	396	106	2	53	395
FBgn0001180	507	500	498	16	4	4	491
FBgn0001185	511	500	509	13	3	4.333333333333333	498
FBgn0001186	501	500	474	28	4	7	473
FBgn0001187	512	500	510	14	3	4.666666666666667	498
FBgn0001189	502	500	501	3	2	1.5	499
FBgn0001206	523	500	504	42	7	6	481
FBgn0001208	507	500	505	9	2	4.5	498
FBgn0001216	515	500	461	69	6	11.5	446
FBgn0001222	515	500	505	25	11	2.272727272727273	490
FBgn0001224	500	500	478	22	2	11	478
FBgn0001225	504	500	498	10	5	2	494
FBgn0001226	502	500	501	3	3	1	499
FBgn0001227	501	500	494	8	3	2.6666666666666665	493
FBgn0001228	503	500	503	3	1	3	500
FBgn0001229	503	500	490	16	3	5.333333333333333	487
FBgn0001230	511	500	504	18	5	3.6	493
FBgn0001233	516	500	321	211	8	26.375	305
FBgn0001235	501	500	487	15	4	3.75	486
FBgn0001247	510	500	478	42	5	8.4	468
FBgn0001248	504	500	488	20	5	4	484
FBgn0001250	513	500	465	61	6	10.166666666666666	452
FBgn0001253	500	500	474	26	2	13	474
FBgn0001254	522	500	446	98	7	14	424
FBgn0001256	500	500	499	1	1	1	499
FBgn0001257	505	500	504	6	3	2	499
FBgn0001259	509	500	475	43	7	6.142857142857143	466
FBgn0001269	501	500	501	1	1	1	500
FBgn0001276	512	500	497	27	9	3	485
FBgn0001280	500	500	499	1	1	1	499
FBgn0001291	500	500	492	8	4	2	492
FBgn0001296	502	500	501	3	3	1	499
FBgn0001297	508	500	490	26	5	5.2	482
FBgn0001301	583	500	468	198	11	18	385
FBgn0001308	500	500	499	1	1	1	499
FBgn0001311	524	500	521	27	8	3.375	497
FBgn0001316	540	500	526	54	9	6	486
FBgn0001319	523	500	507	39	5	7.8	484
FBgn0001320	512	500	497	27	5	5.4	485
FBgn0001321	503	500	465	41	9	4.555555555555555	462
FBgn0001323	500	500	462	38	2	19	462
FBgn0001324	388	376	388	12	3	4	376
FBgn0001325	500	500	500	0	0	NA	500
FBgn0001330	514	500	505	23	6	3.8333333333333335	491
FBgn0001341	515	500	514	16	4	4	499
FBgn0001404	501	500	473	29	5	5.8	472
FBgn0001491	510	500	504	16	3	5.333333333333333	494
FBgn0001612	510	500	495	25	5	5	485
FBgn0001624	537	500	513	61	8	7.625	476
FBgn0001941	523	500	487	59	9	6.555555555555555	464
FBgn0001942	528	500	512	44	7	6.285714285714286	484
FBgn0001961	506	500	481	31	7	4.428571428571429	475
FBgn0001967	503	500	428	78	6	13	425
FBgn0001970	539	500	497	81	8	10.125	458
FBgn0001977	501	500	481	21	3	7	480
FBgn0001978	536	500	519	53	6	8.833333333333334	483
FBgn0001983	500	500	499	1	1	1	499
FBgn0001987	522	500	348	196	13	15.076923076923077	326
FBgn0001989	497	478	222	294	6	49	203
FBgn0001990	389	389	130	259	5	51.8	130
FBgn0001991	539	500	521	57	4	14.25	482
FBgn0001992	518	500	516	20	5	4	498
FBgn0001994	526	500	514	38	6	6.333333333333333	488
FBgn0002022	515	500	508	22	9	2.4444444444444446	493
FBgn0002023	500	500	497	3	1	3	497
FBgn0002036	394	389	391	8	5	1.6	386
FBgn0002044	520	500	478	62	7	8.857142857142858	458
FBgn0002121	506	500	477	35	6	5.833333333333333	471
FBgn0002174	523	500	510	36	6	6	487
FBgn0002183	385	375	357	38	5	7.6	347
FBgn0002283	531	500	525	37	5	7.4	494
FBgn0002306	515	500	508	22	4	5.5	493
FBgn0002354	502	500	498	6	3	2	496
FBgn0002413	545	500	510	80	11	7.2727272727272725	465
FBgn0002431	510	500	493	27	5	5.4	483
FBgn0002440	500	500	498	2	2	1	498
FBgn0002441	502	500	499	5	4	1.25	497
FBgn0002522	524	500	521	27	6	4.5	497
FBgn0002524	511	500	478	44	5	8.8	467
FBgn0002525	506	500	496	16	5	3.2	490
FBgn0002526	527	500	522	32	6	5.333333333333333	495
FBgn0002531	507	500	503	11	4	2.75	496
FBgn0002533	536	500	514	58	9	6.444444444444445	478
FBgn0002534	536	500	519	53	8	6.625	483
FBgn0002535	512	500	495	29	6	4.833333333333333	483
FBgn0002542	505	500	462	48	3	16	457
FBgn0002552	525	500	519	31	4	7.75	494
FBgn0002561	504	500	501	7	2	3.5	497
FBgn0002562	500	500	490	10	2	5	490
FBgn0002563	500	500	457	43	5	8.6	457
FBgn0002564	513	500	513	13	1	13	500
FBgn0002565	500	500	497	3	1	3	497
FBgn0002569	526	500	482	70	10	7	456
FBgn0002570	546	500	538	54	5	10.8	492
FBgn0002571	502	500	500	4	2	2	498
FBgn0002573	507	500	470	44	3	14.666666666666666	463
FBgn0002576	500	500	499	1	1	1	499
FBgn0002579	515	500	514	16	4	4	499
FBgn0002592	501	500	475	27	3	9	474
FBgn0002593	500	500	497	3	3	1	497
FBgn0002609	500	500	278	222	1	222	278
FBgn0002626	507	500	490	24	5	4.8	483
FBgn0002629	500	500	499	1	1	1	499
FBgn0002631	500	500	500	0	0	NA	500
FBgn0002632	501	500	496	6	3	2	495
FBgn0002633	500	500	297	203	1	203	297
FBgn0002638	500	500	487	13	2	6.5	487
FBgn0002641	508	500	505	11	2	5.5	497
FBgn0002643	525	500	508	42	7	6	483
FBgn0002645	524	500	514	34	7	4.857142857142857	490
FBgn0002673	524	500	504	44	5	8.8	480
FBgn0002715	507	500	505	9	2	4.5	498
FBgn0002732	500	500	500	0	0	NA	500
FBgn0002733	490	478	490	12	1	12	478
FBgn0002734	507	500	464	50	7	7.142857142857143	457
FBgn0002735	500	500	498	2	1	2	498
FBgn0002736	506	500	499	13	3	4.333333333333333	493
FBgn0002772	531	500	523	39	7	5.571428571428571	492
FBgn0002773	500	500	493	7	1	7	493
FBgn0002774	513	500	347	179	7	25.571428571428573	334
FBgn0002775	512	500	511	13	3	4.333333333333333	499
FBgn0002778	504	500	502	6	4	1.5	498
FBgn0002780	537	500	536	38	2	19	499
FBgn0002781	523	500	383	163	10	16.3	360
FBgn0002783	509	500	506	12	3	4	497
FBgn0002787	500	500	497	3	1	3	497
FBgn0002789	504	500	488	20	4	5	484
FBgn0002791	509	500	507	11	2	5.5	498
FBgn0002838	528	500	521	35	4	8.75	493
FBgn0002842	505	500	465	45	6	7.5	460
FBgn0002862	504	500	469	39	2	19.5	465
FBgn0002863	500	500	479	21	4	5.25	479
FBgn0002865	501	500	498	4	3	1.3333333333333333	497
FBgn0002868	509	500	509	9	3	3	500
FBgn0002869	500	500	494	6	2	3	494
FBgn0002872	500	500	481	19	3	6.333333333333333	481
FBgn0002878	531	500	525	37	4	9.25	494
FBgn0002891	532	500	514	50	10	5	482
FBgn0002901	541	500	510	72	3	24	469
FBgn0002906	535	500	529	41	4	10.25	494
FBgn0002917	500	500	499	1	1	1	499
FBgn0002921	528	500	526	30	7	4.285714285714286	498
FBgn0002922	506	500	479	33	8	4.125	473
FBgn0002924	500	500	489	11	2	5.5	489
FBgn0002926	504	500	498	10	4	2.5	494
FBgn0002930	500	500	497	3	1	3	497
FBgn0002931	517	500	507	27	9	3	490
FBgn0002932	502	500	500	4	4	1	498
FBgn0002936	504	500	466	42	5	8.4	462
FBgn0002937	501	500	466	36	6	6	465
FBgn0002938	444	442	435	11	4	2.75	433
FBgn0002939	539	500	527	51	4	12.75	488
FBgn0002940	500	500	461	39	2	19.5	461
FBgn0002941	504	500	472	36	4	9	468
FBgn0002948	360	339	341	40	2	20	320
FBgn0002962	517	500	516	18	4	4.5	499
FBgn0002985	500	500	479	21	2	10.5	479
FBgn0002989	502	500	493	11	4	2.75	491
FBgn0003008	502	500	495	9	6	1.5	493
FBgn0003009	509	500	478	40	9	4.444444444444445	469
FBgn0003011	503	500	499	7	3	2.3333333333333335	496
FBgn0003015	501	500	495	7	4	1.75	494
FBgn0003023	545	500	507	83	8	10.375	462
FBgn0003028	501	500	498	4	3	1.3333333333333333	497
FBgn0003034	502	500	482	22	7	3.142857142857143	480
FBgn0003041	545	500	513	77	7	11	468
FBgn0003044	509	500	494	24	9	2.6666666666666665	485
FBgn0003046	510	500	498	22	6	3.6666666666666665	488
FBgn0003048	500	500	487	13	3	4.333333333333333	487
FBgn0003053	514	500	448	80	5	16	434
FBgn0003057	520	500	503	37	4	9.25	483
FBgn0003060	502	500	496	8	3	2.6666666666666665	494
FBgn0003062	504	500	454	54	7	7.714285714285714	450
FBgn0003065	503	500	503	3	1	3	500
FBgn0003068	518	500	489	47	6	7.833333333333333	471
FBgn0003071	503	500	498	8	4	2	495
FBgn0003074	525	500	522	28	3	9.333333333333334	497
FBgn0003076	508	500	504	12	2	6	496
FBgn0003079	557	500	502	112	13	8.615384615384615	445
FBgn0003082	511	500	501	21	3	7	490
FBgn0003086	538	500	508	68	11	6.181818181818182	470
FBgn0003087	500	500	489	11	3	3.6666666666666665	489
FBgn0003089	501	500	498	4	2	2	497
FBgn0003090	515	500	514	16	4	4	499
FBgn0003091	521	500	519	23	6	3.8333333333333335	498
FBgn0003093	500	500	500	0	0	NA	500
FBgn0003114	501	500	501	1	1	1	500
FBgn0003116	456	453	450	9	5	1.8	447
FBgn0003117	500	500	488	12	3	4	488
FBgn0003118	503	500	493	13	3	4.333333333333333	490
FBgn0003124	510	500	486	34	8	4.25	476
FBgn0003129	510	500	510	10	2	5	500
FBgn0003130	500	500	492	8	2	4	492
FBgn0003137	505	500	494	16	4	4	489
FBgn0003139	513	500	501	25	6	4.166666666666667	488
FBgn0003140	503	500	474	32	4	8	471
FBgn0003141	500	500	500	0	0	NA	500
FBgn0003145	508	500	504	12	5	2.4	496
FBgn0003149	500	500	492	8	2	4	492
FBgn0003159	530	500	508	52	8	6.5	478
FBgn0003162	500	500	480	20	2	10	480
FBgn0003165	500	500	466	34	5	6.8	466
FBgn0003169	506	500	506	6	1	6	500
FBgn0003175	515	500	509	21	6	3.5	494
FBgn0003187	507	500	454	60	10	6	447
FBgn0003189	518	500	511	25	7	3.5714285714285716	493
FBgn0003204	510	500	505	15	4	3.75	495
FBgn0003205	500	500	500	0	0	NA	500
FBgn0003206	500	500	500	0	0	NA	500
FBgn0003231	518	500	368	168	5	33.6	350
FBgn0003249	509	500	436	82	5	16.4	427
FBgn0003250	520	500	520	20	2	10	500
FBgn0003254	501	500	490	12	3	4	489
FBgn0003255	514	500	490	38	5	7.6	476
FBgn0003257	520	500	505	35	6	5.833333333333333	485
FBgn0003261	500	500	256	244	6	40.666666666666664	256
FBgn0003267	501	500	486	16	4	4	485
FBgn0003268	500	500	500	0	0	NA	500
FBgn0003270	500	500	497	3	2	1.5	497
FBgn0003274	500	500	478	22	1	22	478
FBgn0003278	511	500	503	19	4	4.75	492
FBgn0003285	511	500	483	39	7	5.571428571428571	472
FBgn0003292	502	500	492	12	3	4	490
FBgn0003295	507	500	465	49	5	9.8	458
FBgn0003300	507	500	469	45	4	11.25	462
FBgn0003301	505	500	482	28	6	4.666666666666667	477
FBgn0003308	585	500	541	129	11	11.727272727272727	456
FBgn0003310	500	500	500	0	0	NA	500
FBgn0003312	504	500	481	27	3	9	477
FBgn0003317	505	500	502	8	3	2.6666666666666665	497
FBgn0003319	510	500	507	13	5	2.6	497
FBgn0003321	521	500	519	23	4	5.75	498
FBgn0003326	503	500	497	9	3	3	494
FBgn0003330	531	500	525	37	7	5.285714285714286	494
FBgn0003334	530	500	330	230	6	38.333333333333336	300
FBgn0003339	506	500	506	6	2	3	500
FBgn0003346	537	500	530	44	10	4.4	493
FBgn0003353	503	500	478	28	8	3.5	475
FBgn0003356	508	500	444	72	8	9	436
FBgn0003357	503	500	503	3	1	3	500
FBgn0003366	501	500	451	51	8	6.375	450
FBgn0003371	508	500	494	22	3	7.333333333333333	486
FBgn0003372	521	500	474	68	5	13.6	453
FBgn0003375	395	388	376	26	6	4.333333333333333	369
FBgn0003377	558	500	558	58	6	9.666666666666666	500
FBgn0003378	558	500	558	58	6	9.666666666666666	500
FBgn0003380	500	500	492	8	2	4	492
FBgn0003382	509	500	482	36	6	6	473
FBgn0003388	507	500	494	20	4	5	487
FBgn0003390	507	500	487	27	7	3.857142857142857	480
FBgn0003392	507	500	498	16	4	4	491
FBgn0003396	548	500	472	124	9	13.777777777777779	424
FBgn0003401	469	436	445	57	8	7.125	412
FBgn0003410	542	500	529	55	9	6.111111111111111	487
FBgn0003411	510	500	486	34	8	4.25	476
FBgn0003415	507	500	474	40	5	8	467
FBgn0003416	521	500	485	57	10	5.7	464
FBgn0003423	512	500	436	88	9	9.777777777777779	424
FBgn0003429	500	500	489	11	2	5.5	489
FBgn0003430	500	500	496	4	2	2	496
FBgn0003435	528	500	521	35	4	8.75	493
FBgn0003444	500	500	487	13	2	6.5	487
FBgn0003447	500	500	494	6	2	3	494
FBgn0003448	502	500	487	17	4	4.25	485
FBgn0003449	523	500	522	24	5	4.8	499
FBgn0003450	500	500	469	31	7	4.428571428571429	469
FBgn0003460	505	500	478	32	7	4.571428571428571	473
FBgn0003462	522	500	497	47	11	4.2727272727272725	475
FBgn0003463	504	500	484	24	6	4	480
FBgn0003464	512	500	509	15	7	2.142857142857143	497
FBgn0003475	500	500	479	21	7	3	479
FBgn0003479	511	500	507	15	3	5	496
FBgn0003480	517	500	499	35	5	7	482
FBgn0003482	506	500	505	7	2	3.5	499
FBgn0003483	504	500	463	45	6	7.5	459
FBgn0003495	529	500	456	102	8	12.75	427
FBgn0003499	500	500	488	12	3	4	488
FBgn0003502	469	457	437	44	5	8.8	425
FBgn0003507	522	500	521	23	2	11.5	499
FBgn0003512	514	500	486	42	6	7	472
FBgn0003513	501	500	501	1	1	1	500
FBgn0003514	514	500	479	49	8	6.125	465
FBgn0003515	558	500	538	78	7	11.142857142857142	480
FBgn0003517	513	500	503	23	5	4.6	490
FBgn0003520	507	500	506	8	3	2.6666666666666665	499
FBgn0003525	510	500	504	16	5	3.2	494
FBgn0003545	521	500	521	21	3	7	500
FBgn0003557	500	500	491	9	3	3	491
FBgn0003559	509	500	168	350	5	70	159
FBgn0003567	520	500	516	24	6	4	496
FBgn0003575	500	500	486	14	2	7	486
FBgn0003598	500	500	478	22	4	5.5	478
FBgn0003607	501	500	488	14	3	4.666666666666667	487
FBgn0003655	502	500	484	20	3	6.666666666666667	482
FBgn0003660	519	500	478	60	9	6.666666666666667	459
FBgn0003687	462	461	460	3	2	1.5	459
FBgn0003701	500	500	317	183	1	183	317
FBgn0003714	500	500	496	4	1	4	496
FBgn0003716	511	500	507	15	6	2.5	496
FBgn0003719	505	500	477	33	4	8.25	472
FBgn0003720	500	500	498	2	1	2	498
FBgn0003721	500	500	498	2	1	2	498
FBgn0003733	535	500	533	37	3	12.333333333333334	498
FBgn0003741	362	353	348	23	5	4.6	339
FBgn0003744	500	500	477	23	3	7.666666666666667	477
FBgn0003747	524	500	507	41	9	4.555555555555555	483
FBgn0003748	505	500	463	47	9	5.222222222222222	458
FBgn0003751	387	387	386	1	1	1	386
FBgn0003861	505	500	470	40	4	10	465
FBgn0003862	500	500	497	3	2	1.5	497
FBgn0003865	500	500	343	157	2	78.5	343
FBgn0003866	507	500	506	8	3	2.6666666666666665	499
FBgn0003867	525	500	525	25	2	12.5	500
FBgn0003870	500	500	500	0	0	NA	500
FBgn0003882	558	500	474	142	10	14.2	416
FBgn0003884	458	458	447	11	3	3.6666666666666665	447
FBgn0003885	529	500	508	50	8	6.25	479
FBgn0003886	515	500	488	42	6	7	473
FBgn0003888	502	500	475	29	7	4.142857142857143	473
FBgn0003889	492	474	487	23	5	4.6	469
FBgn0003890	515	500	496	34	11	3.090909090909091	481
FBgn0003891	431	395	353	114	7	16.285714285714285	317
FBgn0003892	502	500	449	55	6	9.166666666666666	447
FBgn0003896	500	500	476	24	3	8	476
FBgn0003938	505	500	487	23	4	5.75	482
FBgn0003941	519	500	477	61	11	5.545454545454546	458
FBgn0003943	501	500	497	5	4	1.25	496
FBgn0003944	503	500	490	16	4	4	487
FBgn0003950	505	500	466	44	7	6.285714285714286	461
FBgn0003961	500	500	363	137	2	68.5	363
FBgn0003965	515	500	484	46	8	5.75	469
FBgn0003969	517	500	513	21	6	3.5	496
FBgn0003975	500	500	500	0	0	NA	500
FBgn0003978	513	500	483	43	7	6.142857142857143	470
FBgn0003979	500	500	374	126	1	126	374
FBgn0003980	500	500	499	1	1	1	499
FBgn0003983	511	500	511	11	1	11	500
FBgn0003984	557	500	557	57	5	11.4	500
FBgn0003997	530	500	489	71	8	8.875	459
FBgn0004003	505	500	489	21	2	10.5	484
FBgn0004034	510	500	483	37	4	9.25	473
FBgn0004045	507	500	503	11	5	2.2	496
FBgn0004049	504	500	501	7	5	1.4	497
FBgn0004050	503	500	502	4	2	2	499
FBgn0004052	540	500	533	47	8	5.875	493
FBgn0004053	502	500	502	2	2	1	500
FBgn0004054	558	500	495	121	6	20.166666666666668	437
FBgn0004066	515	500	503	27	7	3.857142857142857	488
FBgn0004101	516	500	504	28	3	9.333333333333334	488
FBgn0004102	500	500	494	6	1	6	494
FBgn0004103	533	500	533	33	4	8.25	500
FBgn0004106	531	500	510	52	10	5.2	479
FBgn0004108	500	500	494	6	1	6	494
FBgn0004110	528	500	527	29	5	5.8	499
FBgn0004117	501	500	485	17	5	3.4	484
FBgn0004118	519	500	516	22	5	4.4	497
FBgn0004132	505	500	501	9	3	3	496
FBgn0004133	520	500	514	26	5	5.2	494
FBgn0004143	528	500	510	46	10	4.6	482
FBgn0004167	502	500	493	11	4	2.75	491
FBgn0004168	502	500	460	44	7	6.285714285714286	458
FBgn0004169	508	500	506	10	4	2.5	498
FBgn0004170	510	500	510	10	2	5	500
FBgn0004172	500	500	459	41	3	13.666666666666666	459
FBgn0004173	504	500	490	18	6	3	486
FBgn0004174	548	500	386	210	10	21	338
FBgn0004175	546	500	400	192	11	17.454545454545453	354
FBgn0004177	501	500	295	207	7	29.571428571428573	294
FBgn0004181	511	500	459	63	7	9	448
FBgn0004185	506	500	491	21	8	2.625	485
FBgn0004189	366	366	353	13	1	13	353
FBgn0004191	500	500	274	226	3	75.33333333333333	274
FBgn0004192	505	500	487	23	7	3.2857142857142856	482
FBgn0004197	500	500	491	9	2	4.5	491
FBgn0004198	501	500	500	2	2	1	499
FBgn0004227	424	354	422	72	5	14.4	352
FBgn0004228	502	500	485	19	4	4.75	483
FBgn0004240	503	500	481	25	7	3.5714285714285716	478
FBgn0004242	531	500	519	43	7	6.142857142857143	488
FBgn0004244	506	500	497	15	4	3.75	491
FBgn0004359	501	500	486	16	4	4	485
FBgn0004360	512	500	496	28	6	4.666666666666667	484
FBgn0004362	500	500	310	190	5	38	310
FBgn0004363	501	500	478	24	4	6	477
FBgn0004367	505	500	496	14	5	2.8	491
FBgn0004368	528	500	476	80	3	26.666666666666668	448
FBgn0004369	502	500	498	6	3	2	496
FBgn0004372	559	500	540	78	9	8.666666666666666	481
FBgn0004373	500	500	483	17	3	5.666666666666667	483
FBgn0004374	500	500	500	0	0	NA	500
FBgn0004379	500	500	500	0	0	NA	500
FBgn0004380	527	500	516	38	13	2.923076923076923	489
FBgn0004387	502	495	500	9	2	4.5	493
FBgn0004389	516	500	514	18	3	6	498
FBgn0004390	500	500	490	10	5	2	490
FBgn0004391	501	500	501	1	1	1	500
FBgn0004394	523	500	510	36	8	4.5	487
FBgn0004396	561	500	561	61	7	8.714285714285714	500
FBgn0004397	500	500	493	7	2	3.5	493
FBgn0004401	535	500	484	86	10	8.6	449
FBgn0004403	516	500	512	20	5	4	496
FBgn0004404	350	349	342	9	2	4.5	341
FBgn0004406	446	443	325	124	4	31	322
FBgn0004414	500	500	500	0	0	NA	500
FBgn0004419	535	500	507	63	11	5.7272727272727275	472
FBgn0004427	500	500	493	7	3	2.3333333333333335	493
FBgn0004429	523	500	499	47	7	6.714285714285714	476
FBgn0004432	509	500	477	41	6	6.833333333333333	468
FBgn0004449	516	500	505	27	4	6.75	489
FBgn0004507	509	500	506	12	5	2.4	497
FBgn0004509	534	500	531	37	5	7.4	497
FBgn0004510	531	500	487	75	6	12.5	456
FBgn0004512	518	500	496	40	10	4	478
FBgn0004513	500	500	499	1	1	1	499
FBgn0004514	501	500	301	201	2	100.5	300
FBgn0004516	512	500	510	14	3	4.666666666666667	498
FBgn0004552	500	500	499	1	1	1	499
FBgn0004554	506	500	502	10	3	3.3333333333333335	496
FBgn0004567	500	500	493	7	3	2.3333333333333335	493
FBgn0004569	565	500	533	97	7	13.857142857142858	468
FBgn0004574	500	500	498	2	2	1	498
FBgn0004575	500	500	499	1	1	1	499
FBgn0004577	511	500	492	30	6	5	481
FBgn0004580	500	500	500	0	0	NA	500
FBgn0004581	513	500	496	30	8	3.75	483
FBgn0004583	561	500	557	65	6	10.833333333333334	496
FBgn0004584	524	500	502	46	7	6.571428571428571	478
FBgn0004587	512	500	345	179	6	29.833333333333332	333
FBgn0004588	509	500	508	10	3	3.3333333333333335	499
FBgn0004589	509	500	506	12	4	3	497
FBgn0004590	500	500	496	4	2	2	496
FBgn0004591	500	500	500	0	0	NA	500
FBgn0004592	502	500	502	2	1	2	500
FBgn0004593	542	500	539	45	3	15	497
FBgn0004594	542	500	540	44	3	14.666666666666666	498
FBgn0004595	506	500	506	6	1	6	500
FBgn0004597	502	500	500	4	2	2	498
FBgn0004598	500	500	500	0	0	NA	500
FBgn0004606	503	500	494	12	5	2.4	491
FBgn0004607	500	500	500	0	0	NA	500
FBgn0004611	533	500	517	49	5	9.8	484
FBgn0004618	519	500	504	34	6	5.666666666666667	485
FBgn0004619	505	500	505	5	2	2.5	500
FBgn0004622	500	500	493	7	3	2.3333333333333335	493
FBgn0004623	501	500	489	13	2	6.5	488
FBgn0004629	500	500	134	366	3	122	134
FBgn0004635	512	500	447	77	10	7.7	435
FBgn0004636	515	500	508	22	8	2.75	493
FBgn0004638	500	500	500	0	0	NA	500
FBgn0004643	507	500	478	36	9	4	471
FBgn0004644	504	500	488	20	7	2.857142857142857	484
FBgn0004646	416	411	381	40	5	8	376
FBgn0004647	532	500	423	141	8	17.625	391
FBgn0004648	503	500	502	4	3	1.3333333333333333	499
FBgn0004649	500	500	473	27	2	13.5	473
FBgn0004650	504	500	504	4	1	4	500
FBgn0004652	509	500	499	19	4	4.75	490
FBgn0004656	501	500	498	4	3	1.3333333333333333	497
FBgn0004657	502	500	498	6	2	3	496
FBgn0004666	505	500	494	16	6	2.6666666666666665	489
FBgn0004687	501	500	500	2	2	1	499
FBgn0004698	528	500	512	44	8	5.5	484
FBgn0004777	506	500	506	6	1	6	500
FBgn0004778	535	500	534	36	6	6	499
FBgn0004780	500	500	492	8	3	2.6666666666666665	492
FBgn0004781	507	500	503	11	2	5.5	496
FBgn0004782	502	500	501	3	2	1.5	499
FBgn0004783	522	500	489	55	5	11	467
FBgn0004784	525	500	493	57	5	11.4	468
FBgn0004795	503	500	499	7	3	2.3333333333333335	496
FBgn0004797	525	500	512	38	6	6.333333333333333	487
FBgn0004811	524	500	509	39	9	4.333333333333333	485
FBgn0004828	363	338	330	58	6	9.666666666666666	305
FBgn0004832	504	500	499	9	3	3	495
FBgn0004837	501	500	498	4	3	1.3333333333333333	497
FBgn0004838	504	500	478	30	10	3	474
FBgn0004839	521	500	514	28	7	4	493
FBgn0004841	530	500	463	97	8	12.125	433
FBgn0004842	513	500	488	38	3	12.666666666666666	475
FBgn0004852	517	500	477	57	4	14.25	460
FBgn0004854	500	500	434	66	2	33	434
FBgn0004855	520	500	515	25	6	4.166666666666667	495
FBgn0004858	500	500	498	2	2	1	498
FBgn0004859	502	500	436	68	6	11.333333333333334	434
FBgn0004862	500	500	492	8	2	4	492
FBgn0004863	500	500	499	1	1	1	499
FBgn0004864	506	500	468	44	5	8.8	462
FBgn0004865	504	500	504	4	1	4	500
FBgn0004867	474	400	465	83	6	13.833333333333334	391
FBgn0004870	514	500	502	26	2	13	488
FBgn0004872	501	500	250	252	2	126	249
FBgn0004875	543	500	489	97	8	12.125	446
FBgn0004878	502	500	494	10	4	2.5	492
FBgn0004880	500	500	499	1	1	1	499
FBgn0004882	507	500	493	21	5	4.2	486
FBgn0004885	503	500	489	17	5	3.4	486
FBgn0004889	516	500	483	49	11	4.454545454545454	467
FBgn0004892	500	500	500	0	0	NA	500
FBgn0004893	511	500	499	23	5	4.6	488
FBgn0004895	514	500	504	24	4	6	490
FBgn0004896	501	500	501	1	1	1	500
FBgn0004897	506	500	413	99	4	24.75	407
FBgn0004898	505	500	501	9	4	2.25	496
FBgn0004901	549	500	541	57	7	8.142857142857142	492
FBgn0004903	528	500	523	33	3	11	495
FBgn0004907	500	500	500	0	0	NA	500
FBgn0004908	509	500	507	11	3	3.6666666666666665	498
FBgn0004910	530	500	511	49	5	9.8	481
FBgn0004911	509	500	480	38	6	6.333333333333333	471
FBgn0004914	551	500	544	58	6	9.666666666666666	493
FBgn0004915	511	500	511	11	3	3.6666666666666665	500
FBgn0004919	513	500	348	178	4	44.5	335
FBgn0004921	500	500	499	1	1	1	499
FBgn0004924	530	500	521	39	7	5.571428571428571	491
FBgn0004926	505	500	330	180	4	45	325
FBgn0004956	513	500	513	13	2	6.5	500
FBgn0004957	501	500	497	5	3	1.6666666666666667	496
FBgn0004959	536	500	534	38	5	7.6	498
FBgn0005198	509	500	491	27	7	3.857142857142857	482
FBgn0005278	500	500	489	11	2	5.5	489
FBgn0005355	501	500	500	2	2	1	499
FBgn0005390	500	500	494	6	3	2	494
FBgn0005391	500	500	414	86	2	43	414
FBgn0005411	504	500	467	41	4	10.25	463
FBgn0005533	548	500	535	61	6	10.166666666666666	487
FBgn0005561	500	500	499	1	1	1	499
FBgn0005564	515	500	507	23	3	7.666666666666667	492
FBgn0005585	500	500	495	5	3	1.6666666666666667	495
FBgn0005586	435	435	418	17	3	5.666666666666667	418
FBgn0005590	514	500	504	24	4	6	490
FBgn0005596	500	500	484	16	1	16	484
FBgn0005612	507	500	504	10	5	2	497
FBgn0005613	508	500	497	19	5	3.8	489
FBgn0005614	504	500	476	32	6	5.333333333333333	472
FBgn0005616	500	500	500	0	0	NA	500
FBgn0005619	545	500	536	54	6	9	491
FBgn0005624	502	500	499	5	3	1.6666666666666667	497
FBgn0005626	500	500	500	0	0	NA	500
FBgn0005631	473	473	462	11	4	2.75	462
FBgn0005632	511	500	493	29	8	3.625	482
FBgn0005636	518	500	518	18	1	18	500
FBgn0005638	492	477	450	57	6	9.5	435
FBgn0005640	509	500	453	65	4	16.25	444
FBgn0005642	501	500	415	87	6	14.5	414
FBgn0005649	500	500	498	2	1	2	498
FBgn0005659	502	500	494	10	3	3.3333333333333335	492
FBgn0005660	522	500	520	24	5	4.8	498
FBgn0005664	508	500	489	27	3	9	481
FBgn0005666	541	500	491	91	12	7.583333333333333	450
FBgn0005670	512	500	480	44	6	7.333333333333333	468
FBgn0005671	500	500	486	14	2	7	486
FBgn0005672	513	500	492	34	5	6.8	479
FBgn0005674	505	500	486	24	3	8	481
FBgn0005677	507	500	507	7	1	7	500
FBgn0005683	567	500	549	85	11	7.7272727272727275	482
FBgn0005694	438	428	436	12	5	2.4	426
FBgn0005695	535	500	522	48	8	6	487
FBgn0005696	502	500	476	28	4	7	474
FBgn0005771	504	500	504	4	2	2	500
FBgn0005775	500	500	500	0	0	NA	500
FBgn0005777	523	500	522	24	6	4	499
FBgn0005778	511	500	511	11	2	5.5	500
FBgn0005779	510	500	172	348	4	87	162
FBgn0008635	551	500	521	81	11	7.363636363636363	470
FBgn0008636	507	500	500	14	4	3.5	493
FBgn0008646	514	500	510	18	4	4.5	496
FBgn0008651	502	500	500	4	3	1.3333333333333333	498
FBgn0010015	505	500	484	26	4	6.5	479
FBgn0010038	502	500	291	213	4	53.25	289
FBgn0010039	443	422	408	56	6	9.333333333333334	387
FBgn0010040	387	370	331	73	7	10.428571428571429	314
FBgn0010041	514	500	262	266	7	38	248
FBgn0010043	506	500	334	178	4	44.5	328
FBgn0010051	524	500	452	96	11	8.727272727272727	428
FBgn0010052	521	500	492	50	7	7.142857142857143	471
FBgn0010053	500	500	497	3	2	1.5	497
FBgn0010078	501	500	364	138	5	27.6	363
FBgn0010097	502	500	495	9	6	1.5	493
FBgn0010105	506	500	506	6	5	1.2	500
FBgn0010109	503	500	498	8	2	4	495
FBgn0010113	511	500	489	33	6	5.5	478
FBgn0010114	513	500	508	18	4	4.5	495
FBgn0010173	564	500	543	85	11	7.7272727272727275	479
FBgn0010194	502	500	488	16	4	4	486
FBgn0010197	506	500	503	9	3	3	497
FBgn0010213	505	500	484	26	6	4.333333333333333	479
FBgn0010217	508	500	438	78	7	11.142857142857142	430
FBgn0010220	501	500	480	22	6	3.6666666666666665	479
FBgn0010222	501	500	493	9	3	3	492
FBgn0010223	505	500	498	12	5	2.4	493
FBgn0010226	502	500	470	34	7	4.857142857142857	468
FBgn0010235	502	500	502	2	2	1	500
FBgn0010238	507	500	506	8	4	2	499
FBgn0010240	506	500	488	24	10	2.4	482
FBgn0010241	523	500	515	31	6	5.166666666666667	492
FBgn0010246	480	478	471	11	5	2.2	469
FBgn0010263	503	500	500	6	3	2	497
FBgn0010265	500	500	499	1	1	1	499
FBgn0010269	519	500	501	37	6	6.166666666666667	482
FBgn0010278	507	500	465	49	7	7	458
FBgn0010280	504	500	300	208	6	34.666666666666664	296
FBgn0010282	501	500	501	1	1	1	500
FBgn0010287	509	500	509	9	1	9	500
FBgn0010288	520	500	520	20	2	10	500
FBgn0010294	500	500	378	122	1	122	378
FBgn0010296	542	500	518	66	9	7.333333333333333	476
FBgn0010300	523	500	520	26	6	4.333333333333333	497
FBgn0010303	502	500	484	20	8	2.5	482
FBgn0010309	502	500	481	23	9	2.5555555555555554	479
FBgn0010313	512	500	508	16	2	8	496
FBgn0010315	514	500	504	24	6	4	490
FBgn0010316	535	500	500	70	6	11.666666666666666	465
FBgn0010317	549	500	539	59	6	9.833333333333334	490
FBgn0010323	500	500	493	7	2	3.5	493
FBgn0010328	359	359	331	28	2	14	331
FBgn0010329	511	500	501	21	5	4.2	490
FBgn0010333	501	500	500	2	2	1	499
FBgn0010339	500	500	488	12	5	2.4	488
FBgn0010340	500	500	494	6	2	3	494
FBgn0010342	514	482	293	253	6	42.166666666666664	261
FBgn0010350	500	500	496	4	1	4	496
FBgn0010356	501	500	485	17	4	4.25	484
FBgn0010357	502	500	502	2	1	2	500
FBgn0010380	509	500	413	105	5	21	404
FBgn0010382	526	500	501	51	9	5.666666666666667	475
FBgn0010383	508	500	489	27	8	3.375	481
FBgn0010385	503	500	475	31	6	5.166666666666667	472
FBgn0010387	481	473	473	16	4	4	465
FBgn0010388	505	500	481	29	7	4.142857142857143	476
FBgn0010389	507	500	486	28	9	3.111111111111111	479
FBgn0010391	502	500	475	29	4	7.25	473
FBgn0010397	501	500	500	2	2	1	499
FBgn0010398	507	500	507	7	2	3.5	500
FBgn0010399	500	500	490	10	3	3.3333333333333335	490
FBgn0010401	500	500	498	2	2	1	498
FBgn0010403	512	500	512	12	1	12	500
FBgn0010406	510	500	494	26	6	4.333333333333333	484
FBgn0010407	350	341	331	28	4	7	322
FBgn0010409	500	500	499	1	1	1	499
FBgn0010411	500	500	497	3	1	3	497
FBgn0010412	504	500	498	10	4	2.5	494
FBgn0010414	504	500	504	4	1	4	500
FBgn0010415	500	500	477	23	4	5.75	477
FBgn0010416	504	500	495	13	4	3.25	491
FBgn0010422	503	500	217	289	6	48.166666666666664	214
FBgn0010423	503	500	489	17	2	8.5	486
FBgn0010424	518	500	518	18	3	6	500
FBgn0010433	500	500	500	0	0	NA	500
FBgn0010434	534	500	530	38	8	4.75	496
FBgn0010435	507	500	507	7	1	7	500
FBgn0010441	550	500	518	82	7	11.714285714285714	468
FBgn0010452	502	500	491	13	4	3.25	489
FBgn0010453	508	500	508	8	2	4	500
FBgn0010470	548	500	542	54	10	5.4	494
FBgn0010473	501	500	485	17	6	2.8333333333333335	484
FBgn0010482	503	500	434	72	4	18	431
FBgn0010488	511	500	449	73	8	9.125	438
FBgn0010497	526	500	298	254	4	63.5	272
FBgn0010501	514	500	506	22	4	5.5	492
FBgn0010516	520	500	503	37	6	6.166666666666667	483
FBgn0010520	500	500	434	66	3	22	434
FBgn0010548	523	500	470	76	10	7.6	447
FBgn0010549	500	500	173	327	5	65.4	173
FBgn0010551	519	500	400	138	5	27.6	381
FBgn0010583	500	500	497	3	1	3	497
FBgn0010590	512	500	510	14	4	3.5	498
FBgn0010591	500	500	499	1	1	1	499
FBgn0010602	502	500	412	92	5	18.4	410
FBgn0010607	511	500	502	20	3	6.666666666666667	491
FBgn0010611	509	500	509	9	2	4.5	500
FBgn0010612	504	500	477	31	7	4.428571428571429	473
FBgn0010620	506	500	484	28	11	2.5454545454545454	478
FBgn0010638	508	500	466	50	8	6.25	458
FBgn0010651	511	500	426	96	6	16	415
FBgn0010660	521	500	507	35	6	5.833333333333333	486
FBgn0010747	504	500	501	7	3	2.3333333333333335	497
FBgn0010750	543	500	328	258	5	51.6	285
FBgn0010762	374	373	373	2	2	1	372
FBgn0010768	504	500	358	150	9	16.666666666666668	354
FBgn0010770	500	500	499	1	1	1	499
FBgn0010772	500	500	400	100	3	33.333333333333336	400
FBgn0010786	500	500	491	9	1	9	491
FBgn0010803	504	500	453	55	3	18.333333333333332	449
FBgn0010808	500	500	490	10	3	3.3333333333333335	490
FBgn0010812	515	500	514	16	2	8	499
FBgn0010825	501	500	480	22	4	5.5	479
FBgn0010830	527	500	514	40	9	4.444444444444445	487
FBgn0010877	501	500	500	2	2	1	499
FBgn0010909	536	500	517	55	12	4.583333333333333	481
FBgn0010926	501	500	489	13	3	4.333333333333333	488
FBgn0011016	553	500	520	86	9	9.555555555555555	467
FBgn0011202	504	500	489	19	4	4.75	485
FBgn0011204	500	500	479	21	2	10.5	479
FBgn0011205	525	500	523	27	5	5.4	498
FBgn0011206	502	500	500	4	4	1	498
FBgn0011207	465	429	444	57	8	7.125	408
FBgn0011211	509	500	501	17	5	3.4	492
FBgn0011217	511	500	507	15	4	3.75	496
FBgn0011224	500	500	485	15	3	5	485
FBgn0011227	500	500	495	5	2	2.5	495
FBgn0011230	414	378	374	76	11	6.909090909090909	338
FBgn0011232	505	500	484	26	8	3.25	479
FBgn0011236	509	500	226	292	4	73	217
FBgn0011244	510	500	494	26	5	5.2	484
FBgn0011260	503	500	501	5	2	2.5	498
FBgn0011272	506	500	505	7	2	3.5	499
FBgn0011274	502	500	458	46	4	11.5	456
FBgn0011276	405	393	350	67	10	6.7	338
FBgn0011277	502	500	469	35	6	5.833333333333333	467
FBgn0011278	500	500	500	0	0	NA	500
FBgn0011279	508	500	504	12	2	6	496
FBgn0011280	501	500	409	93	5	18.6	408
FBgn0011281	500	500	496	4	1	4	496
FBgn0011282	500	500	500	0	0	NA	500
FBgn0011283	543	500	542	44	4	11	499
FBgn0011284	522	500	506	38	6	6.333333333333333	484
FBgn0011286	500	500	180	320	1	320	180
FBgn0011289	500	500	489	11	1	11	489
FBgn0011290	505	500	505	5	2	2.5	500
FBgn0011291	502	500	470	34	5	6.8	468
FBgn0011293	548	500	517	79	11	7.181818181818182	469
FBgn0011294	508	500	493	23	2	11.5	485
FBgn0011296	500	500	481	19	2	9.5	481
FBgn0011297	501	500	500	2	2	1	499
FBgn0011305	516	500	490	42	8	5.25	474
FBgn0011327	500	500	500	0	0	NA	500
FBgn0011335	501	500	484	18	2	9	483
FBgn0011336	501	500	500	2	2	1	499
FBgn0011361	508	500	508	8	4	2	500
FBgn0011455	502	500	473	31	6	5.166666666666667	471
FBgn0011476	520	500	514	26	5	5.2	494
FBgn0011481	502	500	497	7	3	2.3333333333333335	495
FBgn0011554	541	500	533	49	6	8.166666666666666	492
FBgn0011555	518	500	467	69	8	8.625	449
FBgn0011556	512	500	483	41	7	5.857142857142857	471
FBgn0011559	502	500	495	9	6	1.5	493
FBgn0011566	497	496	487	11	5	2.2	486
FBgn0011569	506	500	477	35	9	3.888888888888889	471
FBgn0011570	509	500	497	21	5	4.2	488
FBgn0011573	501	500	501	1	1	1	500
FBgn0011581	500	500	500	0	0	NA	500
FBgn0011582	500	500	467	33	2	16.5	467
FBgn0011584	541	500	489	93	10	9.3	448
FBgn0011589	536	500	512	60	8	7.5	476
FBgn0011591	500	500	490	10	4	2.5	490
FBgn0011592	510	500	419	101	3	33.666666666666664	409
FBgn0011603	500	500	481	19	3	6.333333333333333	481
FBgn0011604	542	500	542	42	2	21	500
FBgn0011606	506	500	500	12	2	6	494
FBgn0011638	553	500	518	88	5	17.6	465
FBgn0011640	505	500	500	10	4	2.5	495
FBgn0011648	505	500	505	5	2	2.5	500
FBgn0011653	501	500	481	21	8	2.625	480
FBgn0011655	501	500	500	2	2	1	499
FBgn0011659	504	500	493	15	4	3.75	489
FBgn0011661	529	500	512	46	9	5.111111111111111	483
FBgn0011666	507	500	489	25	11	2.272727272727273	482
FBgn0011668	548	500	535	61	8	7.625	487
FBgn0011669	509	500	455	63	5	12.6	446
FBgn0011672	510	500	483	37	7	5.285714285714286	473
FBgn0011676	500	500	480	20	2	10	480
FBgn0011693	520	500	517	23	4	5.75	497
FBgn0011694	502	500	417	87	8	10.875	415
FBgn0011695	502	500	500	4	3	1.3333333333333333	498
FBgn0011701	500	500	474	26	5	5.2	474
FBgn0011703	403	403	379	24	3	8	379
FBgn0011704	534	500	534	34	9	3.7777777777777777	500
FBgn0011705	533	500	528	38	6	6.333333333333333	495
FBgn0011706	505	500	500	10	6	1.6666666666666667	495
FBgn0011708	509	500	503	15	5	3	494
FBgn0011710	529	500	496	62	10	6.2	467
FBgn0011715	501	500	469	33	7	4.714285714285714	468
FBgn0011722	503	500	500	6	3	2	497
FBgn0011723	511	500	511	11	4	2.75	500
FBgn0011725	524	500	521	27	7	3.857142857142857	497
FBgn0011726	483	477	477	12	5	2.4	471
FBgn0011737	501	500	494	8	4	2	493
FBgn0011739	514	500	499	29	8	3.625	485
FBgn0011740	505	500	504	6	5	1.2	499
FBgn0011742	516	500	485	47	5	9.4	469
FBgn0011743	506	500	496	16	4	4	490
FBgn0011745	501	500	498	4	3	1.3333333333333333	497
FBgn0011746	500	500	263	237	1	237	263
FBgn0011754	509	500	495	23	7	3.2857142857142856	486
FBgn0011758	533	500	531	35	5	7	498
FBgn0011763	503	500	501	5	2	2.5	498
FBgn0011766	512	500	485	39	7	5.571428571428571	473
FBgn0011768	539	500	522	56	10	5.6	483
FBgn0011769	479	479	454	25	4	6.25	454
FBgn0011774	500	500	490	10	6	1.6666666666666667	490
FBgn0011785	509	500	499	19	6	3.1666666666666665	490
FBgn0011802	537	500	535	39	7	5.571428571428571	498
FBgn0011812	560	500	481	139	11	12.636363636363637	421
FBgn0011817	501	500	481	21	5	4.2	480
FBgn0011818	553	500	547	59	5	11.8	494
FBgn0011824	548	500	545	51	7	7.285714285714286	497
FBgn0011826	505	500	498	12	5	2.4	493
FBgn0011829	500	500	454	46	2	23	454
FBgn0011834	502	500	325	179	3	59.666666666666664	323
FBgn0011836	514	500	511	17	7	2.4285714285714284	497
FBgn0011837	506	500	465	47	8	5.875	459
FBgn0011840	500	500	489	11	1	11	489
FBgn0011850	507	500	489	25	8	3.125	482
FBgn0011851	507	500	498	16	5	3.2	491
FBgn0011858	501	500	499	3	2	1.5	498
FBgn0011859	504	500	502	6	3	2	498
FBgn0011860	534	500	524	44	3	14.666666666666666	490
FBgn0011861	500	500	483	17	3	5.666666666666667	483
FBgn0011862	505	500	485	25	6	4.166666666666667	480
FBgn0011864	501	500	499	3	2	1.5	498
FBgn0011866	500	500	381	119	3	39.666666666666664	381
FBgn0011867	526	500	511	41	8	5.125	485
FBgn0011868	505	500	477	33	5	6.6	472
FBgn0011869	500	500	478	22	4	5.5	478
FBgn0011884	423	418	267	161	6	26.833333333333332	262
FBgn0011896	504	500	495	13	5	2.6	491
FBgn0011902	568	500	565	71	8	8.875	497
FBgn0011906	513	500	499	27	2	13.5	486
FBgn0011910	502	500	478	26	4	6.5	476
FBgn0011919	571	500	531	111	14	7.928571428571429	460
FBgn0011921	524	500	494	54	3	18	470
FBgn0011937	518	500	464	72	9	8	446
FBgn0011952	522	500	517	27	4	6.75	495
FBgn0011953	504	500	275	233	3	77.66666666666667	271
FBgn0011954	507	500	505	9	4	2.25	498
FBgn0011955	550	500	547	53	6	8.833333333333334	497
FBgn0011956	545	500	527	63	9	7	482
FBgn0011958	512	500	478	46	5	9.2	466
FBgn0011959	538	500	537	39	5	7.8	499
FBgn0011965	524	500	404	144	4	36	380
FBgn0011966	526	500	507	45	7	6.428571428571429	481
FBgn0011970	526	500	512	40	10	4	486
FBgn0011971	512	500	488	36	10	3.6	476
FBgn0011974	522	500	450	94	7	13.428571428571429	428
FBgn0011981	512	500	336	188	5	37.6	324
FBgn0011982	506	500	447	65	8	8.125	441
FBgn0011983	519	500	516	22	6	3.6666666666666665	497
FBgn0011985	528	500	506	50	4	12.5	478
FBgn0011986	523	500	518	28	6	4.666666666666667	495
FBgn0011987	465	465	451	14	4	3.5	451
FBgn0011994	515	500	512	18	5	3.6	497
FBgn0011999	503	500	503	3	1	3	500
FBgn0012001	509	500	424	94	6	15.666666666666666	415
FBgn0012003	503	500	440	66	3	22	437
FBgn0012004	502	500	496	8	5	1.6	494
FBgn0012010	508	500	507	9	4	2.25	499
FBgn0012016	500	500	499	1	1	1	499
FBgn0012017	502	500	500	4	2	2	498
FBgn0012027	502	500	496	8	4	2	494
FBgn0012034	445	445	443	2	1	2	443
FBgn0012036	506	500	347	165	7	23.571428571428573	341
FBgn0012037	500	500	217	283	1	283	217
FBgn0012042	501	500	500	2	2	1	499
FBgn0012051	501	500	455	47	3	15.666666666666666	454
FBgn0012344	547	500	417	177	8	22.125	370
FBgn0013269	508	500	500	16	3	5.333333333333333	492
FBgn0013305	500	500	500	0	0	NA	500
FBgn0013307	500	500	489	11	4	2.75	489
FBgn0013308	529	500	514	44	11	4	485
FBgn0013323	501	500	495	7	3	2.3333333333333335	494
FBgn0013325	518	500	501	35	7	5	483
FBgn0013334	469	462	451	25	4	6.25	444
FBgn0013348	505	500	442	68	3	22.666666666666668	437
FBgn0013432	504	500	487	21	4	5.25	483
FBgn0013433	506	500	463	49	8	6.125	457
FBgn0013435	503	500	503	3	2	1.5	500
FBgn0013467	503	500	340	166	3	55.333333333333336	337
FBgn0013469	500	500	489	11	2	5.5	489
FBgn0013531	500	500	500	0	0	NA	500
FBgn0013548	504	500	494	14	4	3.5	490
FBgn0013563	526	500	511	41	6	6.833333333333333	485
FBgn0013576	522	500	519	25	3	8.333333333333334	497
FBgn0013687	500	500	500	0	0	NA	500
FBgn0013702	500	500	500	0	0	NA	500
FBgn0013707	500	500	500	0	0	NA	500
FBgn0013710	500	500	500	0	0	NA	500
FBgn0013717	514	500	514	14	2	7	500
FBgn0013718	502	500	469	35	7	5	467
FBgn0013725	513	500	481	45	10	4.5	468
FBgn0013726	512	500	512	12	2	6	500
FBgn0013732	543	500	487	99	6	16.5	444
FBgn0013733	480	480	209	271	2	135.5	209
FBgn0013746	500	500	493	7	2	3.5	493
FBgn0013749	550	500	538	62	12	5.166666666666667	488
FBgn0013750	500	500	252	248	2	124	252
FBgn0013751	527	500	527	27	3	9	500
FBgn0013753	539	500	505	73	7	10.428571428571429	466
FBgn0013755	505	500	498	12	5	2.4	493
FBgn0013759	529	500	527	31	7	4.428571428571429	498
FBgn0013762	504	500	495	13	3	4.333333333333333	491
FBgn0013763	527	500	514	40	7	5.714285714285714	487
FBgn0013764	509	500	496	22	5	4.4	487
FBgn0013765	500	500	498	2	2	1	498
FBgn0013767	500	500	459	41	3	13.666666666666666	459
FBgn0013770	513	500	512	14	2	7	499
FBgn0013771	554	500	545	63	10	6.3	491
FBgn0013773	515	500	515	15	6	2.5	500
FBgn0013799	502	500	494	10	3	3.3333333333333335	492
FBgn0013810	515	500	494	36	4	9	479
FBgn0013811	507	500	495	19	4	4.75	488
FBgn0013812	501	500	500	2	2	1	499
FBgn0013813	500	500	500	0	0	NA	500
FBgn0013949	517	500	498	36	3	12	481
FBgn0013953	517	500	508	26	6	4.333333333333333	491
FBgn0013973	504	500	468	40	7	5.714285714285714	464
FBgn0013981	501	500	494	8	3	2.6666666666666665	493
FBgn0013983	515	500	515	15	2	7.5	500
FBgn0013987	512	500	500	24	5	4.8	488
FBgn0013995	533	500	510	56	6	9.333333333333334	477
FBgn0013997	505	500	503	7	5	1.4	498
FBgn0014000	535	500	530	40	4	10	495
FBgn0014007	505	500	447	63	8	7.875	442
FBgn0014009	504	500	498	10	4	2.5	494
FBgn0014010	501	500	498	4	2	2	497
FBgn0014011	522	500	520	24	3	8	498
FBgn0014019	511	500	350	172	9	19.11111111111111	339
FBgn0014020	504	500	503	5	2	2.5	499
FBgn0014022	501	500	501	1	1	1	500
FBgn0014023	500	500	494	6	2	3	494
FBgn0014028	542	500	369	215	10	21.5	327
FBgn0014029	523	500	504	42	5	8.4	481
FBgn0014031	512	500	504	20	4	5	492
FBgn0014032	566	500	561	71	9	7.888888888888889	495
FBgn0014073	544	500	532	56	5	11.2	488
FBgn0014075	514	500	507	21	3	7	493
FBgn0014127	509	500	503	15	4	3.75	494
FBgn0014133	505	500	489	21	5	4.2	484
FBgn0014135	502	500	447	57	6	9.5	445
FBgn0014141	500	500	413	87	1	87	413
FBgn0014143	500	500	472	28	3	9.333333333333334	472
FBgn0014163	501	500	434	68	10	6.8	433
FBgn0014179	502	500	492	12	5	2.4	490
FBgn0014189	500	500	497	3	3	1	497
FBgn0014269	502	457	494	53	6	8.833333333333334	449
FBgn0014340	506	500	501	11	3	3.6666666666666665	495
FBgn0014342	559	500	530	88	10	8.8	471
FBgn0014343	503	500	500	6	4	1.5	497
FBgn0014366	512	500	504	20	7	2.857142857142857	492
FBgn0014380	504	500	439	69	8	8.625	435
FBgn0014388	500	500	499	1	1	1	499
FBgn0014391	513	500	508	18	9	2	495
FBgn0014395	513	500	378	148	8	18.5	365
FBgn0014396	506	500	470	42	5	8.4	464
FBgn0014411	500	500	499	1	1	1	499
FBgn0014417	516	500	454	78	6	13	438
FBgn0014427	500	500	490	10	4	2.5	490
FBgn0014454	504	500	497	11	4	2.75	493
FBgn0014455	533	500	527	39	4	9.75	494
FBgn0014464	501	500	495	7	5	1.4	494
FBgn0014465	500	500	499	1	1	1	499
FBgn0014466	511	500	421	101	7	14.428571428571429	410
FBgn0014469	500	500	365	135	5	27	365
FBgn0014848	507	500	499	15	3	5	492
FBgn0014849	500	500	498	2	1	2	498
FBgn0014850	500	500	492	8	3	2.6666666666666665	492
FBgn0014851	500	500	493	7	3	2.3333333333333335	493
FBgn0014857	507	500	504	10	3	3.3333333333333335	497
FBgn0014859	503	500	502	4	2	2	499
FBgn0014861	564	500	541	87	12	7.25	477
FBgn0014868	500	500	496	4	2	2	496
FBgn0014869	505	500	503	7	2	3.5	498
FBgn0014870	547	500	521	73	7	10.428571428571429	474
FBgn0014877	504	500	474	34	7	4.857142857142857	470
FBgn0014879	503	500	495	11	3	3.6666666666666665	492
FBgn0014906	369	355	236	147	3	49	222
FBgn0014949	501	500	492	10	3	3.3333333333333335	491
FBgn0015000	513	500	512	14	4	3.5	499
FBgn0015001	500	500	497	3	1	3	497
FBgn0015008	531	500	510	52	9	5.777777777777778	479
FBgn0015010	555	500	539	71	11	6.454545454545454	484
FBgn0015011	500	500	499	1	1	1	499
FBgn0015019	532	500	515	49	10	4.9	483
FBgn0015024	432	422	422	20	5	4	412
FBgn0015025	502	500	397	107	6	17.833333333333332	395
FBgn0015032	508	500	497	19	5	3.8	489
FBgn0015033	502	500	502	2	1	2	500
FBgn0015034	441	428	434	20	6	3.3333333333333335	421
FBgn0015035	500	500	469	31	3	10.333333333333334	469
FBgn0015036	343	338	325	23	6	3.8333333333333335	320
FBgn0015038	557	500	518	96	8	12	461
FBgn0015039	517	500	505	29	7	4.142857142857143	488
FBgn0015040	506	500	489	23	5	4.6	483
FBgn0015075	505	500	296	214	7	30.571428571428573	291
FBgn0015218	500	500	467	33	1	33	467
FBgn0015221	500	500	493	7	2	3.5	493
FBgn0015222	515	500	514	16	3	5.333333333333333	499
FBgn0015229	507	500	392	122	8	15.25	385
FBgn0015230	501	500	499	3	2	1.5	498
FBgn0015239	553	500	531	75	9	8.333333333333334	478
FBgn0015240	520	500	518	22	4	5.5	498
FBgn0015245	409	403	372	43	6	7.166666666666667	366
FBgn0015247	501	500	501	1	1	1	500
FBgn0015268	513	500	509	17	5	3.4	496
FBgn0015269	502	500	480	24	7	3.4285714285714284	478
FBgn0015271	500	500	498	2	2	1	498
FBgn0015279	511	500	474	48	12	4	463
FBgn0015282	501	500	496	6	4	1.5	495
FBgn0015286	501	500	501	1	1	1	500
FBgn0015288	545	500	524	66	7	9.428571428571429	479
FBgn0015296	501	500	479	23	3	7.666666666666667	478
FBgn0015298	542	500	501	83	9	9.222222222222221	459
FBgn0015300	510	500	471	49	5	9.8	461
FBgn0015336	511	500	469	53	4	13.25	458
FBgn0015338	502	500	501	3	2	1.5	499
FBgn0015359	500	500	495	5	2	2.5	495
FBgn0015360	507	500	491	23	8	2.875	484
FBgn0015371	520	500	495	45	8	5.625	475
FBgn0015372	503	500	503	3	1	3	500
FBgn0015380	522	500	458	86	9	9.555555555555555	436
FBgn0015381	515	500	515	15	3	5	500
FBgn0015391	504	500	485	23	4	5.75	481
FBgn0015399	500	500	498	2	1	2	498
FBgn0015400	503	500	458	48	4	12	455
FBgn0015402	506	500	434	78	5	15.6	428
FBgn0015509	506	500	459	53	5	10.6	453
FBgn0015513	508	500	491	25	5	5	483
FBgn0015519	510	500	461	59	7	8.428571428571429	451
FBgn0015520	505	500	500	10	7	1.4285714285714286	495
FBgn0015521	508	500	501	15	7	2.142857142857143	493
FBgn0015524	500	500	499	1	1	1	499
FBgn0015527	512	500	510	14	6	2.3333333333333335	498
FBgn0015544	500	500	500	0	0	NA	500
FBgn0015550	500	500	492	8	1	8	492
FBgn0015553	500	500	495	5	1	5	495
FBgn0015558	508	500	505	11	4	2.75	497
FBgn0015561	507	500	506	8	2	4	499
FBgn0015568	503	500	478	28	5	5.6	475
FBgn0015569	500	500	495	5	1	5	495
FBgn0015570	544	500	514	74	12	6.166666666666667	470
FBgn0015571	531	500	301	261	6	43.5	270
FBgn0015572	526	500	483	69	7	9.857142857142858	457
FBgn0015575	514	500	479	49	13	3.769230769230769	465
FBgn0015576	513	500	496	30	3	10	483
FBgn0015577	505	500	491	19	6	3.1666666666666665	486
FBgn0015583	340	337	288	55	4	13.75	285
FBgn0015584	526	467	459	126	13	9.692307692307692	400
FBgn0015585	500	500	468	32	4	8	468
FBgn0015586	539	500	524	54	6	9	485
FBgn0015591	507	500	507	7	1	7	500
FBgn0015600	431	413	431	18	2	9	413
FBgn0015602	500	500	191	309	4	77.25	191
FBgn0015609	535	500	477	93	11	8.454545454545455	442
FBgn0015614	497	424	476	94	10	9.4	403
FBgn0015615	520	500	506	34	10	3.4	486
FBgn0015618	500	500	159	341	1	341	159
FBgn0015621	501	500	482	20	3	6.666666666666667	481
FBgn0015623	500	500	498	2	2	1	498
FBgn0015625	552	500	536	68	7	9.714285714285714	484
FBgn0015663	545	500	504	86	12	7.166666666666667	459
FBgn0015664	500	500	500	0	0	NA	500
FBgn0015714	515	500	484	46	6	7.666666666666667	469
FBgn0015721	522	500	510	34	6	5.666666666666667	488
FBgn0015737	532	500	527	37	7	5.285714285714286	495
FBgn0015754	502	500	499	5	4	1.25	497
FBgn0015756	515	500	427	103	6	17.166666666666668	412
FBgn0015765	500	500	500	0	0	NA	500
FBgn0015766	520	500	506	34	6	5.666666666666667	486
FBgn0015770	502	500	494	10	3	3.3333333333333335	492
FBgn0015772	518	500	517	19	2	9.5	499
FBgn0015773	500	500	471	29	5	5.8	471
FBgn0015776	508	500	503	13	3	4.333333333333333	495
FBgn0015777	561	500	549	73	8	9.125	488
FBgn0015778	536	500	510	62	7	8.857142857142858	474
FBgn0015781	500	500	498	2	2	1	498
FBgn0015789	518	500	518	18	3	6	500
FBgn0015790	574	500	554	94	10	9.4	480
FBgn0015791	500	500	500	0	0	NA	500
FBgn0015793	505	500	470	40	5	8	465
FBgn0015795	500	500	497	3	2	1.5	497
FBgn0015797	516	500	489	43	6	7.166666666666667	473
FBgn0015799	478	465	471	20	4	5	458
FBgn0015801	506	500	464	48	4	12	458
FBgn0015803	559	500	523	95	7	13.571428571428571	464
FBgn0015805	528	500	518	38	11	3.4545454545454546	490
FBgn0015808	512	500	505	19	5	3.8	493
FBgn0015818	511	500	498	24	3	8	487
FBgn0015828	504	500	469	39	7	5.571428571428571	465
FBgn0015829	549	500	534	64	9	7.111111111111111	485
FBgn0015831	529	500	511	47	7	6.714285714285714	482
FBgn0015872	503	500	464	42	11	3.8181818181818183	461
FBgn0015904	511	500	499	23	6	3.8333333333333335	488
FBgn0015905	505	500	502	8	4	2	497
FBgn0015919	500	500	500	0	0	NA	500
FBgn0015924	500	500	499	1	1	1	499
FBgn0015925	500	500	500	0	0	NA	500
FBgn0015926	517	500	509	25	6	4.166666666666667	492
FBgn0015929	503	500	497	9	3	3	494
FBgn0015946	500	500	485	15	2	7.5	485
FBgn0015949	507	500	502	12	7	1.7142857142857142	495
FBgn0016013	502	500	496	8	3	2.6666666666666665	494
FBgn0016032	519	500	491	47	8	5.875	472
FBgn0016036	501	500	458	44	7	6.285714285714286	457
FBgn0016038	545	500	540	50	6	8.333333333333334	495
FBgn0016041	509	500	438	80	5	16	429
FBgn0016047	539	500	535	43	3	14.333333333333334	496
FBgn0016054	500	500	500	0	0	NA	500
FBgn0016059	500	500	490	10	1	10	490
FBgn0016061	508	500	508	8	2	4	500
FBgn0016070	500	500	497	3	3	1	497
FBgn0016075	526	500	485	67	6	11.166666666666666	459
FBgn0016076	507	500	498	16	5	3.2	491
FBgn0016081	501	500	485	17	8	2.125	484
FBgn0016119	508	500	481	35	5	7	473
FBgn0016120	510	500	496	24	2	12	486
FBgn0016123	502	500	482	22	11	2	480
FBgn0016126	518	500	364	172	7	24.571428571428573	346
FBgn0016131	503	500	472	34	4	8.5	469
FBgn0016641	504	500	494	14	5	2.8	490
FBgn0016650	507	500	492	22	6	3.6666666666666665	485
FBgn0016660	503	500	503	3	2	1.5	500
FBgn0016672	500	500	479	21	2	10.5	479
FBgn0016675	524	500	501	47	9	5.222222222222222	477
FBgn0016684	522	500	522	22	2	11	500
FBgn0016685	500	500	499	1	1	1	499
FBgn0016687	501	500	466	36	7	5.142857142857143	465
FBgn0016691	508	500	467	49	7	7	459
FBgn0016694	501	500	442	60	2	30	441
FBgn0016697	537	500	537	37	4	9.25	500
FBgn0016698	502	500	499	5	4	1.25	497
FBgn0016715	506	500	368	144	4	36	362
FBgn0016726	522	500	513	31	3	10.333333333333334	491
FBgn0016754	502	500	493	11	3	3.6666666666666665	491
FBgn0016756	568	500	532	104	12	8.666666666666666	464
FBgn0016762	513	500	501	25	7	3.5714285714285716	488
FBgn0016794	518	500	498	38	9	4.222222222222222	480
FBgn0016797	540	500	416	164	9	18.22222222222222	376
FBgn0016917	536	500	534	38	5	7.6	498
FBgn0016920	502	500	502	2	2	1	500
FBgn0016926	509	500	485	33	4	8.25	476
FBgn0016930	513	500	498	28	9	3.111111111111111	485
FBgn0016970	521	500	512	30	8	3.75	491
FBgn0016974	374	370	372	6	3	2	368
FBgn0016977	506	500	498	14	5	2.8	492
FBgn0016978	506	500	373	139	11	12.636363636363637	367
FBgn0016983	500	500	498	2	2	1	498
FBgn0017414	501	500	497	5	3	1.6666666666666667	496
FBgn0017424	512	500	462	62	9	6.888888888888889	450
FBgn0017429	512	500	504	20	5	4	492
FBgn0017430	500	500	453	47	1	47	453
FBgn0017448	509	500	503	15	3	5	494
FBgn0017457	519	500	515	23	3	7.666666666666667	496
FBgn0017482	504	500	501	7	2	3.5	497
FBgn0017545	558	500	503	113	10	11.3	445
FBgn0017551	516	500	490	42	6	7	474
FBgn0017556	507	500	484	30	5	6	477
FBgn0017558	504	500	468	40	7	5.714285714285714	464
FBgn0017561	504	500	494	14	4	3.5	490
FBgn0017566	521	500	515	27	10	2.7	494
FBgn0017567	504	500	457	51	6	8.5	453
FBgn0017572	504	500	459	49	5	9.8	455
FBgn0017577	519	500	517	21	3	7	498
FBgn0017578	512	500	486	38	6	6.333333333333333	474
FBgn0017579	506	500	481	31	3	10.333333333333334	475
FBgn0017581	500	500	491	9	2	4.5	491
FBgn0017590	503	500	417	89	4	22.25	414
FBgn0019624	501	500	491	11	2	5.5	490
FBgn0019637	500	500	497	3	1	3	497
FBgn0019644	504	500	502	6	2	3	498
FBgn0019650	500	500	500	0	0	NA	500
FBgn0019661	478	476	464	16	5	3.2	462
FBgn0019662	525	500	494	56	7	8	469
FBgn0019686	538	500	536	40	7	5.714285714285714	498
FBgn0019809	500	500	489	11	2	5.5	489
FBgn0019828	556	500	548	64	10	6.4	492
FBgn0019830	500	500	500	0	0	NA	500
FBgn0019890	530	500	518	42	7	6	488
FBgn0019925	502	500	490	14	4	3.5	488
FBgn0019928	502	500	491	13	5	2.6	489
FBgn0019929	513	500	482	44	7	6.285714285714286	469
FBgn0019932	502	500	502	2	2	1	500
FBgn0019936	505	500	503	7	3	2.3333333333333335	498
FBgn0019938	500	500	485	15	1	15	485
FBgn0019949	500	500	500	0	0	NA	500
FBgn0019952	512	500	485	39	8	4.875	473
FBgn0019957	508	500	460	56	7	8	452
FBgn0019960	500	500	498	2	1	2	498
FBgn0019968	503	500	198	308	5	61.6	195
FBgn0019972	520	500	507	33	5	6.6	487
FBgn0019982	493	482	482	22	8	2.75	471
FBgn0019985	514	500	497	31	6	5.166666666666667	483
FBgn0019990	515	500	475	55	4	13.75	460
FBgn0020018	504	500	499	9	3	3	495
FBgn0020235	501	500	499	3	3	1	498
FBgn0020236	562	500	534	90	9	10	472
FBgn0020238	509	500	506	12	8	1.5	497
FBgn0020248	501	500	438	64	7	9.142857142857142	437
FBgn0020249	502	500	502	2	2	1	500
FBgn0020251	500	500	487	13	4	3.25	487
FBgn0020258	520	500	520	20	4	5	500
FBgn0020261	556	500	289	323	6	53.833333333333336	233
FBgn0020269	502	500	346	158	5	31.6	344
FBgn0020270	461	419	454	49	4	12.25	412
FBgn0020272	527	500	498	56	10	5.6	471
FBgn0020277	508	500	484	32	7	4.571428571428571	476
FBgn0020278	508	500	506	10	3	3.3333333333333335	498
FBgn0020279	514	500	514	14	3	4.666666666666667	500
FBgn0020280	500	500	500	0	0	NA	500
FBgn0020294	509	500	390	128	6	21.333333333333332	381
FBgn0020299	516	500	476	56	8	7	460
FBgn0020300	516	500	465	67	6	11.166666666666666	449
FBgn0020304	371	371	178	193	1	193	178
FBgn0020305	505	500	485	25	6	4.166666666666667	480
FBgn0020306	540	500	540	40	2	20	500
FBgn0020307	517	500	435	99	6	16.5	418
FBgn0020312	500	500	490	10	2	5	490
FBgn0020370	503	500	496	10	4	2.5	493
FBgn0020371	512	500	482	42	5	8.4	470
FBgn0020376	615	500	595	135	6	22.5	480
FBgn0020377	501	500	495	7	4	1.75	494
FBgn0020378	501	500	482	20	4	5	481
FBgn0020379	500	500	497	3	2	1.5	497
FBgn0020381	500	500	496	4	1	4	496
FBgn0020385	505	500	481	29	4	7.25	476
FBgn0020386	512	500	500	24	9	2.6666666666666665	488
FBgn0020389	534	430	506	132	8	16.5	402
FBgn0020399	466	465	325	142	4	35.5	324
FBgn0020407	500	500	499	1	1	1	499
FBgn0020412	580	500	577	83	5	16.6	497
FBgn0020415	542	500	489	95	7	13.571428571428571	447
FBgn0020416	518	500	513	23	6	3.8333333333333335	495
FBgn0020429	511	500	507	15	5	3	496
FBgn0020440	511	500	495	27	7	3.857142857142857	484
FBgn0020443	521	500	458	84	7	12	437
FBgn0020445	501	500	493	9	2	4.5	492
FBgn0020493	541	500	539	43	7	6.142857142857143	498
FBgn0020496	507	500	495	19	5	3.8	488
FBgn0020503	528	500	504	52	7	7.428571428571429	476
FBgn0020506	500	500	211	289	2	144.5	211
FBgn0020508	507	500	475	39	8	4.875	468
FBgn0020509	508	500	502	14	2	7	494
FBgn0020510	509	500	490	28	6	4.666666666666667	481
FBgn0020521	500	500	483	17	3	5.666666666666667	483
FBgn0020545	500	500	494	6	3	2	494
FBgn0020546	500	500	497	3	2	1.5	497
FBgn0020556	501	500	492	10	4	2.5	491
FBgn0020616	500	500	484	16	2	8	484
FBgn0020617	500	500	496	4	3	1.3333333333333333	496
FBgn0020620	525	500	508	42	7	6	483
FBgn0020622	511	500	473	49	7	7	462
FBgn0020633	530	500	504	56	7	8	474
FBgn0020640	553	500	551	55	6	9.166666666666666	498
FBgn0020641	500	500	405	95	4	23.75	405
FBgn0020642	500	500	477	23	2	11.5	477
FBgn0020645	527	500	515	39	9	4.333333333333333	488
FBgn0020647	500	500	497	3	2	1.5	497
FBgn0020653	513	500	509	17	6	2.8333333333333335	496
FBgn0020765	500	500	498	2	2	1	498
FBgn0020880	501	500	489	13	5	2.6	488
FBgn0020887	500	500	500	0	0	NA	500
FBgn0020906	500	500	475	25	4	6.25	475
FBgn0020907	500	500	495	5	1	5	495
FBgn0020910	501	500	134	368	3	122.66666666666667	133
FBgn0020912	500	500	498	2	1	2	498
FBgn0020930	431	431	424	7	2	3.5	424
FBgn0021742	518	500	464	72	12	6	446
FBgn0021750	518	500	479	57	8	7.125	461
FBgn0021760	540	500	435	145	8	18.125	395
FBgn0021761	541	500	504	78	9	8.666666666666666	463
FBgn0021764	508	500	507	9	4	2.25	499
FBgn0021767	501	500	474	28	5	5.6	473
FBgn0021768	517	500	514	20	6	3.3333333333333335	497
FBgn0021795	502	500	221	283	6	47.166666666666664	219
FBgn0021796	534	500	527	41	7	5.857142857142857	493
FBgn0021800	510	500	509	11	3	3.6666666666666665	499
FBgn0021814	500	500	488	12	5	2.4	488
FBgn0021825	546	500	517	75	10	7.5	471
FBgn0021847	532	500	527	37	4	9.25	495
FBgn0021856	500	500	30	470	1	470	30
FBgn0021872	350	347	349	4	3	1.3333333333333333	346
FBgn0021874	548	500	546	50	7	7.142857142857143	498
FBgn0021875	501	500	499	3	2	1.5	498
FBgn0021895	500	500	500	0	0	NA	500
FBgn0021906	500	500	423	77	4	19.25	423
FBgn0021944	507	500	505	9	4	2.25	498
FBgn0021967	504	500	495	13	5	2.6	491
FBgn0021995	500	500	499	1	1	1	499
FBgn0022023	500	500	497	3	1	3	497
FBgn0022027	517	500	506	28	7	4	489
FBgn0022029	505	500	495	15	3	5	490
FBgn0022069	510	500	495	25	7	3.5714285714285716	485
FBgn0022153	503	500	295	211	2	105.5	292
FBgn0022160	518	500	517	19	4	4.75	499
FBgn0022213	527	500	520	34	5	6.8	493
FBgn0022238	500	500	500	0	0	NA	500
FBgn0022338	500	500	498	2	1	2	498
FBgn0022343	500	500	498	2	2	1	498
FBgn0022344	504	500	428	80	9	8.88888888888889	424
FBgn0022349	500	500	498	2	1	2	498
FBgn0022355	525	500	488	62	8	7.75	463
FBgn0022359	503	500	496	10	4	2.5	493
FBgn0022361	504	500	504	4	1	4	500
FBgn0022699	510	500	498	22	7	3.142857142857143	488
FBgn0022700	503	500	485	21	4	5.25	482
FBgn0022702	512	500	495	29	4	7.25	483
FBgn0022710	501	500	416	86	2	43	415
FBgn0022724	507	500	501	13	6	2.1666666666666665	494
FBgn0022740	500	500	492	8	2	4	492
FBgn0022768	530	500	475	85	11	7.7272727272727275	445
FBgn0022770	520	500	410	130	8	16.25	390
FBgn0022774	501	500	488	14	5	2.8	487
FBgn0022786	507	500	495	19	6	3.1666666666666665	488
FBgn0022787	509	500	506	12	3	4	497
FBgn0022800	505	500	496	14	6	2.3333333333333335	491
FBgn0022893	520	500	410	130	9	14.444444444444445	390
FBgn0022935	515	500	491	39	9	4.333333333333333	476
FBgn0022936	517	500	348	186	12	15.5	331
FBgn0022942	525	500	518	32	7	4.571428571428571	493
FBgn0022943	504	500	489	19	4	4.75	485
FBgn0022959	336	336	300	36	6	6	300
FBgn0022981	502	500	321	183	4	45.75	319
FBgn0022984	505	500	504	6	4	1.5	499
FBgn0022985	500	500	500	0	0	NA	500
FBgn0022987	516	500	505	27	5	5.4	489
FBgn0023000	518	500	464	72	11	6.545454545454546	446
FBgn0023001	502	500	498	6	4	1.5	496
FBgn0023023	538	500	515	61	8	7.625	477
FBgn0023076	535	500	527	43	4	10.75	492
FBgn0023090	500	500	82	418	2	209	82
FBgn0023091	501	500	452	50	6	8.333333333333334	451
FBgn0023094	352	343	352	9	2	4.5	343
FBgn0023095	526	500	525	27	5	5.4	499
FBgn0023129	500	500	475	25	1	25	475
FBgn0023130	500	500	499	1	1	1	499
FBgn0023167	510	500	504	16	3	5.333333333333333	494
FBgn0023169	500	500	490	10	5	2	490
FBgn0023170	511	500	492	30	6	5	481
FBgn0023171	500	500	498	2	1	2	498
FBgn0023172	505	500	500	10	3	3.3333333333333335	495
FBgn0023174	516	500	508	24	6	4	492
FBgn0023175	512	500	512	12	3	4	500
FBgn0023177	525	500	510	40	6	6.666666666666667	485
FBgn0023178	509	500	498	20	5	4	489
FBgn0023179	500	500	480	20	3	6.666666666666667	480
FBgn0023181	516	500	485	47	6	7.833333333333333	469
FBgn0023197	520	500	438	102	4	25.5	418
FBgn0023212	500	500	500	0	0	NA	500
FBgn0023214	501	500	480	22	3	7.333333333333333	479
FBgn0023215	501	500	500	2	2	1	499
FBgn0023216	502	500	496	8	5	1.6	494
FBgn0023388	500	500	147	353	2	176.5	147
FBgn0023415	518	500	483	53	3	17.666666666666668	465
FBgn0023416	502	500	413	91	3	30.333333333333332	411
FBgn0023441	519	500	354	184	10	18.4	335
FBgn0023458	511	500	498	24	3	8	487
FBgn0023477	512	500	405	119	8	14.875	393
FBgn0023489	501	500	495	7	3	2.3333333333333335	494
FBgn0023495	542	500	523	61	8	7.625	481
FBgn0023496	500	500	459	41	6	6.833333333333333	459
FBgn0023506	502	500	380	124	6	20.666666666666668	378
FBgn0023507	502	500	446	58	4	14.5	444
FBgn0023508	501	500	499	3	2	1.5	498
FBgn0023509	500	500	489	11	1	11	489
FBgn0023511	507	500	501	13	6	2.1666666666666665	494
FBgn0023512	502	500	496	8	3	2.6666666666666665	494
FBgn0023513	500	500	500	0	0	NA	500
FBgn0023514	502	500	501	3	2	1.5	499
FBgn0023515	504	500	504	4	1	4	500
FBgn0023516	500	500	500	0	0	NA	500
FBgn0023517	500	500	498	2	2	1	498
FBgn0023518	501	500	496	6	4	1.5	495
FBgn0023519	500	500	497	3	3	1	497
FBgn0023520	501	500	496	6	5	1.2	495
FBgn0023521	503	500	497	9	7	1.2857142857142858	494
FBgn0023522	505	500	500	10	4	2.5	495
FBgn0023523	501	500	485	17	3	5.666666666666667	484
FBgn0023524	516	500	513	19	5	3.8	497
FBgn0023525	509	500	509	9	2	4.5	500
FBgn0023526	503	500	486	20	4	5	483
FBgn0023527	500	500	467	33	7	4.714285714285714	467
FBgn0023528	510	500	505	15	3	5	495
FBgn0023529	523	500	510	36	4	9	487
FBgn0023530	500	500	499	1	1	1	499
FBgn0023531	507	500	472	42	6	7	465
FBgn0023534	517	500	516	18	2	9	499
FBgn0023536	509	500	496	22	6	3.6666666666666665	487
FBgn0023540	500	500	491	9	1	9	491
FBgn0023541	513	500	510	16	6	2.6666666666666665	497
FBgn0023542	501	500	497	5	2	2.5	496
FBgn0023549	523	500	513	33	5	6.6	490
FBgn0023550	501	500	497	5	2	2.5	496
FBgn0024150	500	500	490	10	1	10	490
FBgn0024177	500	500	495	5	2	2.5	495
FBgn0024183	500	500	494	6	2	3	494
FBgn0024184	500	500	500	0	0	NA	500
FBgn0024187	512	500	501	23	7	3.2857142857142856	489
FBgn0024189	533	500	524	42	7	6	491
FBgn0024191	516	500	482	50	8	6.25	466
FBgn0024194	459	455	448	15	4	3.75	444
FBgn0024196	507	500	503	11	5	2.2	496
FBgn0024227	549	500	545	53	5	10.6	496
FBgn0024230	506	500	490	22	4	5.5	484
FBgn0024232	500	500	436	64	1	64	436
FBgn0024236	511	500	285	237	6	39.5	274
FBgn0024238	507	500	423	91	7	13	416
FBgn0024244	503	500	503	3	1	3	500
FBgn0024248	502	500	473	31	6	5.166666666666667	471
FBgn0024249	502	500	488	16	2	8	486
FBgn0024250	525	500	522	28	3	9.333333333333334	497
FBgn0024273	500	500	464	36	4	9	464
FBgn0024277	543	500	534	52	7	7.428571428571429	491
FBgn0024285	514	500	493	35	6	5.833333333333333	479
FBgn0024288	505	500	494	16	6	2.6666666666666665	489
FBgn0024291	501	500	491	11	2	5.5	490
FBgn0024294	525	500	494	56	9	6.222222222222222	469
FBgn0024314	427	427	419	8	4	2	419
FBgn0024315	527	500	496	58	11	5.2727272727272725	469
FBgn0024319	509	500	466	52	5	10.4	457
FBgn0024320	501	500	500	2	2	1	499
FBgn0024321	503	500	491	15	3	5	488
FBgn0024326	500	500	498	2	2	1	498
FBgn0024329	506	500	449	63	8	7.875	443
FBgn0024330	500	500	500	0	0	NA	500
FBgn0024352	519	500	519	19	2	9.5	500
FBgn0024360	501	500	495	7	3	2.3333333333333335	494
FBgn0024361	505	500	499	11	3	3.6666666666666665	494
FBgn0024362	504	500	469	39	5	7.8	465
FBgn0024364	503	500	498	8	3	2.6666666666666665	495
FBgn0024365	500	500	497	3	1	3	497
FBgn0024366	504	500	469	39	5	7.8	465
FBgn0024371	501	500	500	2	2	1	499
FBgn0024432	502	500	499	5	4	1.25	497
FBgn0024509	508	500	505	11	3	3.6666666666666665	497
FBgn0024542	507	500	507	7	2	3.5	500
FBgn0024555	500	500	493	7	3	2.3333333333333335	493
FBgn0024689	514	500	514	14	2	7	500
FBgn0024698	518	500	501	35	9	3.888888888888889	483
FBgn0024728	502	500	209	295	3	98.33333333333333	207
FBgn0024732	503	500	493	13	7	1.8571428571428572	490
FBgn0024740	512	500	504	20	2	10	492
FBgn0024754	511	500	480	42	3	14	469
FBgn0024806	516	500	514	18	4	4.5	498
FBgn0024814	535	500	523	47	7	6.714285714285714	488
FBgn0024833	507	500	495	19	5	3.8	488
FBgn0024836	503	500	321	185	6	30.833333333333332	318
FBgn0024846	504	500	448	60	6	10	444
FBgn0024889	441	441	433	8	2	4	433
FBgn0024897	500	500	498	2	2	1	498
FBgn0024909	500	500	500	0	0	NA	500
FBgn0024912	506	500	272	240	4	60	266
FBgn0024920	355	353	344	13	5	2.6	342
FBgn0024921	524	500	426	122	5	24.4	402
FBgn0024941	500	500	479	21	5	4.2	479
FBgn0024943	503	500	466	40	8	5	463
FBgn0024944	500	500	499	1	1	1	499
FBgn0024945	500	500	500	0	0	NA	500
FBgn0024947	501	500	496	6	3	2	495
FBgn0024956	519	500	518	20	4	5	499
FBgn0024957	502	500	499	5	2	2.5	497
FBgn0024958	491	485	487	10	6	1.6666666666666667	481
FBgn0024963	536	500	536	36	3	12	500
FBgn0024973	500	500	490	10	2	5	490
FBgn0024975	552	500	548	56	3	18.666666666666668	496
FBgn0024980	502	500	473	31	2	15.5	471
FBgn0024983	505	500	485	25	6	4.166666666666667	480
FBgn0024984	363	351	359	16	5	3.2	347
FBgn0024985	509	500	503	15	2	7.5	494
FBgn0024986	502	500	478	26	6	4.333333333333333	476
FBgn0024987	501	500	454	48	6	8	453
FBgn0024989	502	500	502	2	2	1	500
FBgn0024991	503	500	485	21	3	7	482
FBgn0024992	508	500	500	16	5	3.2	492
FBgn0024993	508	500	500	16	5	3.2	492
FBgn0024994	515	500	481	49	10	4.9	466
FBgn0024995	503	500	496	10	7	1.4285714285714286	493
FBgn0024997	561	500	544	78	7	11.142857142857142	483
FBgn0024998	500	500	421	79	4	19.75	421
FBgn0025109	519	500	515	23	6	3.8333333333333335	496
FBgn0025115	442	442	392	50	8	6.25	392
FBgn0025186	414	413	391	24	3	8	390
FBgn0025334	500	500	488	12	3	4	488
FBgn0025335	502	500	486	18	3	6	484
FBgn0025336	366	359	364	9	3	3	357
FBgn0025352	506	500	472	40	3	13.333333333333334	466
FBgn0025360	502	500	502	2	1	2	500
FBgn0025378	500	500	479	21	3	7	479
FBgn0025382	503	500	502	4	2	2	499
FBgn0025383	500	500	490	10	2	5	490
FBgn0025388	516	500	507	25	4	6.25	491
FBgn0025391	504	500	501	7	3	2.3333333333333335	497
FBgn0025393	500	500	499	1	1	1	499
FBgn0025394	501	500	499	3	2	1.5	498
FBgn0025455	500	500	184	316	7	45.142857142857146	184
FBgn0025457	501	500	496	6	4	1.5	495
FBgn0025463	511	500	505	17	4	4.25	494
FBgn0025469	506	500	463	49	5	9.8	457
FBgn0025519	500	500	500	0	0	NA	500
FBgn0025525	523	500	489	57	10	5.7	466
FBgn0025558	503	500	486	20	3	6.666666666666667	483
FBgn0025571	501	500	487	15	4	3.75	486
FBgn0025573	502	500	491	13	3	4.333333333333333	489
FBgn0025574	539	500	515	63	6	10.5	476
FBgn0025578	506	500	506	6	2	3	500
FBgn0025583	531	500	530	32	3	10.666666666666666	499
FBgn0025592	515	500	514	16	6	2.6666666666666665	499
FBgn0025595	525	500	499	51	5	10.2	474
FBgn0025608	500	500	499	1	1	1	499
FBgn0025612	522	500	512	32	10	3.2	490
FBgn0025615	507	500	500	14	5	2.8	493
FBgn0025616	502	450	478	76	12	6.333333333333333	426
FBgn0025621	505	500	504	6	3	2	499
FBgn0025624	559	500	485	133	8	16.625	426
FBgn0025625	506	500	500	12	5	2.4	494
FBgn0025627	500	500	500	0	0	NA	500
FBgn0025628	500	500	500	0	0	NA	500
FBgn0025631	520	500	498	42	8	5.25	478
FBgn0025632	500	500	500	0	0	NA	500
FBgn0025637	509	500	504	14	3	4.666666666666667	495
FBgn0025639	512	500	499	25	5	5	487
FBgn0025640	535	500	519	51	12	4.25	484
FBgn0025641	500	500	497	3	1	3	497
FBgn0025642	503	500	502	4	2	2	499
FBgn0025644	500	500	496	4	4	1	496
FBgn0025678	512	500	471	53	6	8.833333333333334	459
FBgn0025679	510	500	496	24	5	4.8	486
FBgn0025681	500	500	499	1	1	1	499
FBgn0025682	349	343	339	16	2	8	333
FBgn0025684	523	500	485	61	6	10.166666666666666	462
FBgn0025692	504	500	486	22	6	3.6666666666666665	482
FBgn0025697	500	500	280	220	2	110	280
FBgn0025700	538	500	499	77	10	7.7	461
FBgn0025702	500	500	500	0	0	NA	500
FBgn0025709	502	500	498	6	3	2	496
FBgn0025712	428	397	427	32	3	10.666666666666666	396
FBgn0025716	504	500	503	5	2	2.5	499
FBgn0025720	500	500	468	32	4	8	468
FBgn0025724	504	500	458	50	7	7.142857142857143	454
FBgn0025725	500	500	500	0	0	NA	500
FBgn0025739	531	500	522	40	6	6.666666666666667	491
FBgn0025743	528	500	523	33	7	4.714285714285714	495
FBgn0025777	504	500	460	48	8	6	456
FBgn0025781	507	500	488	26	7	3.7142857142857144	481
FBgn0025790	508	500	503	13	3	4.333333333333333	495
FBgn0025800	347	336	211	147	7	21	200
FBgn0025802	500	500	499	1	1	1	499
FBgn0025807	515	500	515	15	3	5	500
FBgn0025808	500	500	487	13	4	3.25	487
FBgn0025814	520	500	474	66	10	6.6	454
FBgn0025815	525	500	500	50	6	8.333333333333334	475
FBgn0025820	511	500	499	23	4	5.75	488
FBgn0025830	535	500	507	63	10	6.3	472
FBgn0025833	500	500	496	4	2	2	496
FBgn0025835	500	500	499	1	1	1	499
FBgn0025836	516	500	344	188	9	20.88888888888889	328
FBgn0025837	533	500	531	35	5	7	498
FBgn0025839	537	500	533	41	4	10.25	496
FBgn0025864	500	500	492	8	1	8	492
FBgn0025865	547	500	532	62	7	8.857142857142858	485
FBgn0025866	502	500	478	26	5	5.2	476
FBgn0025874	514	500	483	45	6	7.5	469
FBgn0025878	501	500	493	9	3	3	492
FBgn0025885	500	500	338	162	3	54	338
FBgn0025936	500	500	28	472	2	236	28
FBgn0026015	506	500	493	19	4	4.75	487
FBgn0026058	501	500	269	233	4	58.25	268
FBgn0026060	501	500	496	6	2	3	495
FBgn0026077	500	500	490	10	3	3.3333333333333335	490
FBgn0026079	502	500	489	15	8	1.875	487
FBgn0026080	502	500	487	17	3	5.666666666666667	485
FBgn0026083	502	500	502	2	1	2	500
FBgn0026084	525	500	516	34	8	4.25	491
FBgn0026085	501	500	501	1	1	1	500
FBgn0026088	501	500	496	6	2	3	495
FBgn0026089	507	500	506	8	3	2.6666666666666665	499
FBgn0026090	502	500	485	19	6	3.1666666666666665	483
FBgn0026136	500	500	494	6	1	6	494
FBgn0026141	502	500	403	101	3	33.666666666666664	401
FBgn0026143	502	500	325	179	2	89.5	323
FBgn0026144	504	500	479	29	6	4.833333333333333	475
FBgn0026148	543	500	471	115	7	16.428571428571427	428
FBgn0026149	500	500	496	4	2	2	496
FBgn0026150	501	500	491	11	2	5.5	490
FBgn0026160	500	500	494	6	5	1.2	494
FBgn0026176	500	500	476	24	4	6	476
FBgn0026179	512	500	490	34	9	3.7777777777777777	478
FBgn0026181	504	500	498	10	4	2.5	494
FBgn0026190	500	500	498	2	1	2	498
FBgn0026192	509	500	503	15	5	3	494
FBgn0026199	500	500	128	372	3	124	128
FBgn0026238	530	500	350	210	9	23.333333333333332	320
FBgn0026239	525	500	505	45	8	5.625	480
FBgn0026250	501	500	490	12	3	4	489
FBgn0026252	508	500	496	20	4	5	488
FBgn0026257	508	500	497	19	6	3.1666666666666665	489
FBgn0026259	529	500	467	91	8	11.375	438
FBgn0026261	500	500	500	0	0	NA	500
FBgn0026262	527	500	494	60	4	15	467
FBgn0026263	501	500	487	15	5	3	486
FBgn0026268	511	500	493	29	4	7.25	482
FBgn0026309	527	500	455	99	13	7.615384615384615	428
FBgn0026313	534	500	533	35	6	5.833333333333333	499
FBgn0026314	527	500	523	31	4	7.75	496
FBgn0026315	502	500	434	70	8	8.75	432
FBgn0026316	503	500	488	18	6	3	485
FBgn0026317	500	500	499	1	1	1	499
FBgn0026319	553	500	550	56	6	9.333333333333334	497
FBgn0026320	518	500	501	35	9	3.888888888888889	483
FBgn0026324	500	500	500	0	0	NA	500
FBgn0026326	502	500	502	2	2	1	500
FBgn0026361	500	500	139	361	1	361	139
FBgn0026369	501	500	482	20	3	6.666666666666667	481
FBgn0026371	514	500	490	38	10	3.8	476
FBgn0026373	533	500	522	44	4	11	489
FBgn0026374	504	500	464	44	9	4.888888888888889	460
FBgn0026376	513	500	438	88	8	11	425
FBgn0026378	500	500	487	13	4	3.25	487
FBgn0026379	519	500	504	34	10	3.4	485
FBgn0026380	500	500	475	25	6	4.166666666666667	475
FBgn0026384	500	500	490	10	5	2	490
FBgn0026385	500	500	483	17	4	4.25	483
FBgn0026389	507	500	502	12	3	4	495
FBgn0026390	468	467	453	16	4	4	452
FBgn0026391	464	464	464	0	0	NA	464
FBgn0026392	513	500	497	29	4	7.25	484
FBgn0026394	511	500	494	28	4	7	483
FBgn0026396	514	500	500	28	7	4	486
FBgn0026398	523	500	507	39	5	7.8	484
FBgn0026399	517	500	473	61	4	15.25	456
FBgn0026400	500	500	58	442	3	147.33333333333334	58
FBgn0026402	541	500	528	54	5	10.8	487
FBgn0026403	519	500	396	142	4	35.5	377
FBgn0026404	501	500	440	62	7	8.857142857142858	439
FBgn0026409	459	459	252	207	3	69	252
FBgn0026411	501	500	402	100	3	33.333333333333336	401
FBgn0026415	505	500	489	21	4	5.25	484
FBgn0026418	349	348	309	41	6	6.833333333333333	308
FBgn0026427	508	500	470	46	6	7.666666666666667	462
FBgn0026428	506	500	505	7	2	3.5	499
FBgn0026431	507	450	507	57	5	11.4	450
FBgn0026432	512	500	492	32	9	3.5555555555555554	480
FBgn0026438	500	500	473	27	5	5.4	473
FBgn0026439	500	500	500	0	0	NA	500
FBgn0026533	532	500	514	50	7	7.142857142857143	482
FBgn0026562	510	500	498	22	3	7.333333333333333	488
FBgn0026566	546	500	532	60	9	6.666666666666667	486
FBgn0026570	526	500	498	54	7	7.714285714285714	472
FBgn0026573	545	500	542	48	5	9.6	497
FBgn0026575	500	500	495	5	1	5	495
FBgn0026576	500	500	497	3	1	3	497
FBgn0026577	547	500	511	83	8	10.375	464
FBgn0026582	520	500	504	36	7	5.142857142857143	484
FBgn0026592	516	500	495	37	10	3.7	479
FBgn0026593	544	500	539	49	10	4.9	495
FBgn0026597	501	500	497	5	2	2.5	496
FBgn0026598	509	500	495	23	6	3.8333333333333335	486
FBgn0026602	535	500	526	44	9	4.888888888888889	491
FBgn0026616	511	500	499	23	5	4.6	488
FBgn0026619	500	500	500	0	0	NA	500
FBgn0026634	500	500	496	4	2	2	496
FBgn0026666	500	500	493	7	3	2.3333333333333335	493
FBgn0026679	471	439	439	64	7	9.142857142857142	407
FBgn0026702	501	500	492	10	2	5	491
FBgn0026713	529	500	413	145	10	14.5	384
FBgn0026718	522	500	520	24	4	6	498
FBgn0026721	476	476	464	12	4	3	464
FBgn0026722	504	500	504	4	1	4	500
FBgn0026737	500	500	500	0	0	NA	500
FBgn0026738	500	500	483	17	2	8.5	483
FBgn0026741	501	500	500	2	2	1	499
FBgn0026749	530	500	523	37	7	5.285714285714286	493
FBgn0026751	501	500	477	25	9	2.7777777777777777	476
FBgn0026754	500	500	212	288	4	72	212
FBgn0026755	503	500	458	48	5	9.6	455
FBgn0026756	525	500	494	56	7	8	469
FBgn0026761	513	500	489	37	4	9.25	476
FBgn0026787	529	500	520	38	12	3.1666666666666665	491
FBgn0026872	501	500	500	2	2	1	499
FBgn0026873	507	500	507	7	2	3.5	500
FBgn0026874	500	500	498	2	1	2	498
FBgn0026876	503	500	503	3	2	1.5	500
FBgn0026878	509	500	509	9	3	3	500
FBgn0026879	523	500	523	23	5	4.6	500
FBgn0027052	387	378	379	17	5	3.4	370
FBgn0027053	516	500	474	58	9	6.444444444444445	458
FBgn0027054	541	500	524	58	6	9.666666666666666	483
FBgn0027055	502	500	210	294	2	147	208
FBgn0027057	501	500	127	375	2	187.5	126
FBgn0027066	514	500	478	50	8	6.25	464
FBgn0027070	519	500	505	33	8	4.125	486
FBgn0027074	506	500	501	11	3	3.6666666666666665	495
FBgn0027079	521	500	490	52	12	4.333333333333333	469
FBgn0027081	518	500	516	20	4	5	498
FBgn0027082	501	500	497	5	3	1.6666666666666667	496
FBgn0027084	510	500	508	12	3	4	498
FBgn0027085	500	500	497	3	2	1.5	497
FBgn0027086	550	500	524	76	12	6.333333333333333	474
FBgn0027088	513	500	423	103	11	9.363636363636363	410
FBgn0027090	500	500	490	10	2	5	490
FBgn0027093	500	500	497	3	1	3	497
FBgn0027095	501	500	498	4	2	2	497
FBgn0027106	513	500	510	16	3	5.333333333333333	497
FBgn0027108	501	500	446	56	8	7	445
FBgn0027109	507	500	507	7	1	7	500
FBgn0027111	513	500	512	14	4	3.5	499
FBgn0027259	532	500	512	52	8	6.5	480
FBgn0027280	535	500	532	38	8	4.75	497
FBgn0027287	511	500	504	18	4	4.5	493
FBgn0027291	501	500	501	1	1	1	500
FBgn0027296	513	500	460	66	10	6.6	447
FBgn0027330	502	500	490	14	5	2.8	488
FBgn0027335	500	500	116	384	2	192	116
FBgn0027339	501	500	493	9	4	2.25	492
FBgn0027342	502	500	428	76	11	6.909090909090909	426
FBgn0027343	535	500	520	50	7	7.142857142857143	485
FBgn0027348	514	500	479	49	13	3.769230769230769	465
FBgn0027356	514	500	393	135	10	13.5	379
FBgn0027359	522	500	484	60	6	10	462
FBgn0027363	549	500	545	53	5	10.6	496
FBgn0027364	500	500	498	2	1	2	498
FBgn0027375	512	500	321	203	8	25.375	309
FBgn0027376	340	340	333	7	3	2.3333333333333335	333
FBgn0027490	501	500	501	1	1	1	500
FBgn0027491	373	373	343	30	4	7.5	343
FBgn0027493	500	500	226	274	7	39.142857142857146	226
FBgn0027494	522	500	488	56	4	14	466
FBgn0027496	518	500	513	23	7	3.2857142857142856	495
FBgn0027497	503	500	470	36	5	7.2	467
FBgn0027498	527	489	512	53	7	7.571428571428571	474
FBgn0027499	509	500	490	28	7	4	481
FBgn0027503	527	500	518	36	6	6	491
FBgn0027504	505	500	501	9	3	3	496
FBgn0027506	405	367	396	47	4	11.75	358
FBgn0027508	432	425	383	56	10	5.6	376
FBgn0027509	509	500	497	21	7	3	488
FBgn0027513	438	438	435	3	1	3	435
FBgn0027514	508	500	506	10	3	3.3333333333333335	498
FBgn0027515	521	500	512	30	6	5	491
FBgn0027521	525	500	501	49	13	3.769230769230769	476
FBgn0027524	530	500	505	55	12	4.583333333333333	475
FBgn0027525	538	500	505	71	10	7.1	467
FBgn0027526	508	500	505	11	5	2.2	497
FBgn0027527	508	500	505	11	4	2.75	497
FBgn0027528	502	500	484	20	4	5	482
FBgn0027535	523	500	522	24	5	4.8	499
FBgn0027538	456	451	443	18	7	2.5714285714285716	438
FBgn0027539	524	500	520	28	6	4.666666666666667	496
FBgn0027546	508	500	471	45	5	9	463
FBgn0027548	500	500	178	322	2	161	178
FBgn0027549	463	433	452	41	7	5.857142857142857	422
FBgn0027550	525	500	513	37	7	5.285714285714286	488
FBgn0027552	529	500	523	35	6	5.833333333333333	494
FBgn0027553	509	500	509	9	2	4.5	500
FBgn0027554	525	500	509	41	5	8.2	484
FBgn0027556	500	500	499	1	1	1	499
FBgn0027560	500	500	496	4	2	2	496
FBgn0027561	505	500	379	131	10	13.1	374
FBgn0027562	509	500	498	20	6	3.3333333333333335	489
FBgn0027563	514	500	453	75	5	15	439
FBgn0027564	500	500	497	3	2	1.5	497
FBgn0027565	525	500	523	27	5	5.4	498
FBgn0027567	551	500	511	91	5	18.2	460
FBgn0027568	500	500	481	19	6	3.1666666666666665	481
FBgn0027569	535	500	516	54	9	6	481
FBgn0027572	505	500	505	5	2	2.5	500
FBgn0027575	500	500	500	0	0	NA	500
FBgn0027578	535	500	530	40	5	8	495
FBgn0027579	400	400	389	11	2	5.5	389
FBgn0027580	509	500	496	22	5	4.4	487
FBgn0027582	437	423	418	33	4	8.25	404
FBgn0027583	501	500	492	10	2	5	491
FBgn0027584	504	500	471	37	4	9.25	467
FBgn0027585	500	500	500	0	0	NA	500
FBgn0027586	502	500	487	17	3	5.666666666666667	485
FBgn0027588	507	500	276	238	9	26.444444444444443	269
FBgn0027589	500	500	500	0	0	NA	500
FBgn0027590	501	500	491	11	4	2.75	490
FBgn0027592	512	500	491	33	6	5.5	479
FBgn0027596	543	500	479	107	12	8.916666666666666	436
FBgn0027597	513	500	506	20	4	5	493
FBgn0027598	506	500	350	162	6	27	344
FBgn0027599	501	500	494	8	5	1.6	493
FBgn0027600	501	500	452	50	10	5	451
FBgn0027602	525	500	502	48	6	8	477
FBgn0027607	521	500	376	166	5	33.2	355
FBgn0027608	500	500	483	17	3	5.666666666666667	483
FBgn0027609	500	500	491	9	1	9	491
FBgn0027610	511	500	457	65	4	16.25	446
FBgn0027611	544	500	536	52	11	4.7272727272727275	492
FBgn0027616	500	500	500	0	0	NA	500
FBgn0027619	518	500	360	176	8	22	342
FBgn0027620	504	500	489	19	4	4.75	485
FBgn0027654	501	500	496	6	2	3	495
FBgn0027655	507	500	497	17	3	5.666666666666667	490
FBgn0027657	542	500	538	46	6	7.666666666666667	496
FBgn0027660	560	500	549	71	7	10.142857142857142	489
FBgn0027780	504	500	504	4	1	4	500
FBgn0027783	502	500	491	13	5	2.6	489
FBgn0027784	515	500	496	34	7	4.857142857142857	481
FBgn0027785	503	500	503	3	1	3	500
FBgn0027786	502	500	477	27	3	9	475
FBgn0027788	500	500	495	5	1	5	495
FBgn0027790	500	500	363	137	2	68.5	363
FBgn0027793	417	417	414	3	1	3	414
FBgn0027835	514	500	473	55	6	9.166666666666666	459
FBgn0027836	519	500	434	104	14	7.428571428571429	415
FBgn0027841	503	500	496	10	2	5	493
FBgn0027843	513	500	505	21	6	3.5	492
FBgn0027844	506	500	498	14	7	2	492
FBgn0027864	536	500	491	81	10	8.1	455
FBgn0027873	476	474	467	11	4	2.75	465
FBgn0027889	500	500	490	10	2	5	490
FBgn0027903	519	500	473	65	8	8.125	454
FBgn0027929	536	500	510	62	11	5.636363636363637	474
FBgn0027930	500	500	487	13	3	4.333333333333333	487
FBgn0027932	500	500	180	320	1	320	180
FBgn0027934	506	500	492	20	4	5	486
FBgn0027945	531	500	518	44	5	8.8	487
FBgn0027949	516	500	499	33	4	8.25	483
FBgn0027950	501	500	489	13	3	4.333333333333333	488
FBgn0027951	522	500	482	62	7	8.857142857142858	460
FBgn0028292	516	500	496	36	4	9	480
FBgn0028325	515	500	515	15	3	5	500
FBgn0028327	509	500	501	17	5	3.4	492
FBgn0028343	570	500	538	102	8	12.75	468
FBgn0028360	515	500	502	28	8	3.5	487
FBgn0028369	546	500	495	97	8	12.125	449
FBgn0028370	501	500	492	10	3	3.3333333333333335	491
FBgn0028371	501	500	481	21	4	5.25	480
FBgn0028372	501	500	442	60	4	15	441
FBgn0028374	536	500	516	56	7	8	480
FBgn0028379	495	493	489	8	4	2	487
FBgn0028381	500	500	494	6	4	1.5	494
FBgn0028387	535	500	530	40	6	6.666666666666667	495
FBgn0028394	511	500	426	96	7	13.714285714285714	415
FBgn0028397	504	500	334	174	5	34.8	330
FBgn0028398	500	500	488	12	2	6	488
FBgn0028400	529	500	525	33	6	5.5	496
FBgn0028402	543	500	504	82	12	6.833333333333333	461
FBgn0028406	514	500	514	14	4	3.5	500
FBgn0028408	502	500	499	5	3	1.6666666666666667	497
FBgn0028411	453	451	442	13	3	4.333333333333333	440
FBgn0028412	500	500	491	9	1	9	491
FBgn0028418	500	500	499	1	1	1	499
FBgn0028421	521	500	517	25	4	6.25	496
FBgn0028424	518	500	507	29	7	4.142857142857143	489
FBgn0028425	505	500	503	7	3	2.3333333333333335	498
FBgn0028426	502	500	422	82	5	16.4	420
FBgn0028427	500	500	450	50	1	50	450
FBgn0028429	431	373	403	86	7	12.285714285714286	345
FBgn0028430	519	500	488	50	9	5.555555555555555	469
FBgn0028434	502	500	492	12	4	3	490
FBgn0028436	504	500	501	7	4	1.75	497
FBgn0028467	518	500	516	20	2	10	498
FBgn0028468	521	500	512	30	7	4.285714285714286	491
FBgn0028471	405	396	404	10	5	2	395
FBgn0028473	521	500	509	33	9	3.6666666666666665	488
FBgn0028474	460	446	451	23	5	4.6	437
FBgn0028475	500	500	497	3	1	3	497
FBgn0028476	547	500	533	61	8	7.625	486
FBgn0028479	506	500	471	41	8	5.125	465
FBgn0028480	510	500	497	23	5	4.6	487
FBgn0028481	513	500	512	14	3	4.666666666666667	499
FBgn0028482	559	500	543	75	7	10.714285714285714	484
FBgn0028484	528	500	527	29	7	4.142857142857143	499
FBgn0028487	500	500	500	0	0	NA	500
FBgn0028490	580	500	524	136	13	10.461538461538462	444
FBgn0028491	530	500	530	30	5	6	500
FBgn0028496	503	500	497	9	5	1.8	494
FBgn0028499	500	500	498	2	1	2	498
FBgn0028500	505	500	243	267	7	38.142857142857146	238
FBgn0028504	501	500	501	1	1	1	500
FBgn0028506	501	500	444	58	4	14.5	443
FBgn0028507	500	500	240	260	3	86.66666666666667	240
FBgn0028509	500	500	494	6	4	1.5	494
FBgn0028513	500	500	458	42	7	6	458
FBgn0028515	503	500	478	28	5	5.6	475
FBgn0028516	501	500	180	322	4	80.5	179
FBgn0028518	492	491	490	3	3	1	489
FBgn0028520	528	500	520	36	4	9	492
FBgn0028525	505	500	469	41	6	6.833333333333333	464
FBgn0028527	530	500	487	73	8	9.125	457
FBgn0028530	467	441	466	27	7	3.857142857142857	440
FBgn0028538	397	385	371	38	6	6.333333333333333	359
FBgn0028540	504	500	448	60	6	10	444
FBgn0028542	509	500	487	31	4	7.75	478
FBgn0028543	491	468	475	39	6	6.5	452
FBgn0028544	503	500	503	3	1	3	500
FBgn0028546	502	500	494	10	4	2.5	492
FBgn0028550	502	500	491	13	5	2.6	489
FBgn0028552	502	500	498	6	3	2	496
FBgn0028554	504	500	477	31	11	2.8181818181818183	473
FBgn0028560	501	500	397	105	4	26.25	396
FBgn0028562	500	500	499	1	1	1	499
FBgn0028563	505	500	326	184	8	23	321
FBgn0028567	515	500	507	23	6	3.8333333333333335	492
FBgn0028569	501	500	479	23	3	7.666666666666667	478
FBgn0028570	517	500	517	17	1	17	500
FBgn0028572	510	500	510	10	1	10	500
FBgn0028573	506	500	501	11	4	2.75	495
FBgn0028579	537	500	529	45	8	5.625	492
FBgn0028582	506	500	491	21	9	2.3333333333333335	485
FBgn0028583	514	500	484	44	5	8.8	470
FBgn0028644	556	500	555	57	7	8.142857142857142	499
FBgn0028645	510	500	413	107	4	26.75	403
FBgn0028646	515	500	491	39	5	7.8	476
FBgn0028647	501	500	495	7	4	1.75	494
FBgn0028648	501	500	461	41	6	6.833333333333333	460
FBgn0028658	500	500	500	0	0	NA	500
FBgn0028662	500	500	479	21	1	21	479
FBgn0028667	519	500	491	47	9	5.222222222222222	472
FBgn0028669	500	500	455	45	2	22.5	455
FBgn0028671	500	500	497	3	2	1.5	497
FBgn0028675	501	500	464	38	4	9.5	463
FBgn0028684	500	500	498	2	1	2	498
FBgn0028685	500	500	499	1	1	1	499
FBgn0028686	505	500	496	14	6	2.3333333333333335	491
FBgn0028688	501	500	493	9	3	3	492
FBgn0028689	505	500	481	29	7	4.142857142857143	476
FBgn0028690	508	500	463	53	5	10.6	455
FBgn0028691	513	500	512	14	4	3.5	499
FBgn0028692	504	500	499	9	3	3	495
FBgn0028695	508	500	296	220	5	44	288
FBgn0028699	500	500	500	0	0	NA	500
FBgn0028700	501	500	482	20	3	6.666666666666667	481
FBgn0028704	500	500	477	23	2	11.5	477
FBgn0028707	514	500	500	28	5	5.6	486
FBgn0028708	519	500	480	58	7	8.285714285714286	461
FBgn0028717	529	500	511	47	6	7.833333333333333	482
FBgn0028734	510	500	509	11	3	3.6666666666666665	499
FBgn0028737	547	500	519	75	8	9.375	472
FBgn0028738	380	370	368	22	7	3.142857142857143	358
FBgn0028740	518	500	494	42	9	4.666666666666667	476
FBgn0028743	501	500	501	1	1	1	500
FBgn0028744	505	500	494	16	6	2.6666666666666665	489
FBgn0028789	501	500	501	1	1	1	500
FBgn0028836	537	500	515	59	8	7.375	478
FBgn0028837	552	500	509	95	8	11.875	457
FBgn0028841	501	500	280	222	3	74	279
FBgn0028844	506	500	491	21	3	7	485
FBgn0028847	504	500	466	42	5	8.4	462
FBgn0028848	509	500	459	59	5	11.8	450
FBgn0028850	504	500	298	210	3	70	294
FBgn0028852	510	500	497	23	4	5.75	487
FBgn0028853	550	500	545	55	8	6.875	495
FBgn0028855	500	500	486	14	2	7	486
FBgn0028857	523	500	515	31	3	10.333333333333334	492
FBgn0028858	501	500	495	7	3	2.3333333333333335	494
FBgn0028863	533	500	517	49	9	5.444444444444445	484
FBgn0028866	514	500	497	31	7	4.428571428571429	483
FBgn0028868	501	500	473	29	5	5.8	472
FBgn0028870	523	500	498	48	9	5.333333333333333	475
FBgn0028871	500	500	483	17	3	5.666666666666667	483
FBgn0028872	466	466	462	4	2	2	462
FBgn0028875	500	500	483	17	2	8.5	483
FBgn0028878	508	500	506	10	4	2.5	498
FBgn0028879	573	500	566	80	12	6.666666666666667	493
FBgn0028882	501	500	473	29	3	9.666666666666666	472
FBgn0028884	510	500	479	41	8	5.125	469
FBgn0028887	528	500	497	59	6	9.833333333333334	469
FBgn0028888	503	500	497	9	3	3	494
FBgn0028889	510	500	508	12	4	3	498
FBgn0028892	505	500	504	6	3	2	499
FBgn0028893	507	500	497	17	5	3.4	490
FBgn0028894	535	500	505	65	6	10.833333333333334	470
FBgn0028895	507	500	477	37	7	5.285714285714286	470
FBgn0028896	521	500	505	37	8	4.625	484
FBgn0028897	525	500	509	41	6	6.833333333333333	484
FBgn0028900	532	500	509	55	7	7.857142857142857	477
FBgn0028901	500	500	494	6	3	2	494
FBgn0028903	502	500	496	8	3	2.6666666666666665	494
FBgn0028909	525	500	508	42	9	4.666666666666667	483
FBgn0028912	508	500	450	66	6	11	442
FBgn0028913	500	500	490	10	4	2.5	490
FBgn0028916	393	382	178	226	5	45.2	167
FBgn0028919	500	500	499	1	1	1	499
FBgn0028920	505	500	495	15	6	2.5	490
FBgn0028931	527	500	428	126	10	12.6	401
FBgn0028932	376	374	324	54	5	10.8	322
FBgn0028935	500	500	489	11	3	3.6666666666666665	489
FBgn0028936	500	500	488	12	1	12	488
FBgn0028938	503	500	421	85	5	17	418
FBgn0028939	517	500	498	36	6	6	481
FBgn0028940	507	500	498	16	6	2.6666666666666665	491
FBgn0028941	500	500	465	35	5	7	465
FBgn0028942	500	500	476	24	6	4	476
FBgn0028944	526	500	522	30	6	5	496
FBgn0028945	506	500	415	97	9	10.777777777777779	409
FBgn0028946	505	500	481	29	3	9.666666666666666	476
FBgn0028947	533	500	503	63	6	10.5	470
FBgn0028948	532	500	501	63	7	9	469
FBgn0028949	550	500	529	71	9	7.888888888888889	479
FBgn0028950	501	500	498	4	2	2	497
FBgn0028952	500	500	497	3	1	3	497
FBgn0028956	503	500	210	296	8	37	207
FBgn0028962	501	500	501	1	1	1	500
FBgn0028963	500	500	485	15	3	5	485
FBgn0028965	565	500	544	86	8	10.75	479
FBgn0028968	504	500	467	41	10	4.1	463
FBgn0028969	506	500	466	46	9	5.111111111111111	460
FBgn0028978	506	500	506	6	2	3	500
FBgn0028981	543	500	524	62	11	5.636363636363637	481
FBgn0028983	511	500	509	13	5	2.6	498
FBgn0028987	541	500	514	68	7	9.714285714285714	473
FBgn0028992	525	500	524	26	4	6.5	499
FBgn0028996	515	500	414	116	6	19.333333333333332	399
FBgn0028997	509	500	467	51	7	7.285714285714286	458
FBgn0028999	501	500	490	12	4	3	489
FBgn0029002	500	500	483	17	5	3.4	483
FBgn0029003	500	500	494	6	1	6	494
FBgn0029006	501	500	486	16	2	8	485
FBgn0029067	522	500	520	24	4	6	498
FBgn0029079	505	500	498	12	6	2	493
FBgn0029088	504	500	501	7	4	1.75	497
FBgn0029093	504	500	500	8	6	1.3333333333333333	496
FBgn0029094	506	500	479	33	5	6.6	473
FBgn0029095	404	384	401	23	5	4.6	381
FBgn0029105	516	500	493	39	3	13	477
FBgn0029113	534	500	519	49	7	7	485
FBgn0029114	501	500	495	7	3	2.3333333333333335	494
FBgn0029117	502	500	498	6	3	2	496
FBgn0029118	500	500	497	3	1	3	497
FBgn0029121	500	500	497	3	1	3	497
FBgn0029123	500	500	490	10	1	10	490
FBgn0029133	509	500	491	27	6	4.5	482
FBgn0029134	500	500	496	4	1	4	496
FBgn0029137	518	500	516	20	4	5	498
FBgn0029147	517	500	494	40	7	5.714285714285714	477
FBgn0029152	522	500	449	95	16	5.9375	427
FBgn0029157	501	500	487	15	3	5	486
FBgn0029158	535	500	522	48	6	8	487
FBgn0029167	502	500	497	7	3	2.3333333333333335	495
FBgn0029174	537	500	518	56	8	7	481
FBgn0029176	522	500	513	31	6	5.166666666666667	491
FBgn0029503	514	500	483	45	6	7.5	469
FBgn0029504	500	500	469	31	5	6.2	469
FBgn0029506	558	500	481	135	13	10.384615384615385	423
FBgn0029507	557	500	481	133	11	12.090909090909092	424
FBgn0029508	528	500	486	70	9	7.777777777777778	458
FBgn0029512	501	500	474	28	3	9.333333333333334	473
FBgn0029518	514	500	497	31	6	5.166666666666667	483
FBgn0029522	518	500	291	245	4	61.25	273
FBgn0029529	546	500	541	51	7	7.285714285714286	495
FBgn0029531	500	500	498	2	2	1	498
FBgn0029532	502	500	471	33	7	4.714285714285714	469
FBgn0029535	543	500	534	52	6	8.666666666666666	491
FBgn0029539	515	500	511	19	2	9.5	496
FBgn0029552	520	500	503	37	5	7.4	483
FBgn0029568	501	500	481	21	5	4.2	480
FBgn0029573	500	500	500	0	0	NA	500
FBgn0029587	500	500	497	3	2	1.5	497
FBgn0029588	515	500	515	15	2	7.5	500
FBgn0029594	501	500	501	1	1	1	500
FBgn0029596	363	349	354	23	3	7.666666666666667	340
FBgn0029603	520	500	473	67	5	13.4	453
FBgn0029606	517	500	516	18	3	6	499
FBgn0029608	500	500	475	25	4	6.25	475
FBgn0029639	514	500	499	29	6	4.833333333333333	485
FBgn0029649	524	500	504	44	7	6.285714285714286	480
FBgn0029657	554	500	488	120	9	13.333333333333334	434
FBgn0029659	514	500	447	81	11	7.363636363636363	433
FBgn0029662	508	500	449	67	10	6.7	441
FBgn0029663	514	500	497	31	8	3.875	483
FBgn0029665	500	500	489	11	4	2.75	489
FBgn0029667	519	500	495	43	7	6.142857142857143	476
FBgn0029681	501	500	486	16	5	3.2	485
FBgn0029686	501	500	490	12	3	4	489
FBgn0029688	564	492	549	87	8	10.875	477
FBgn0029690	521	500	513	29	6	4.833333333333333	492
FBgn0029693	516	500	496	36	6	6	480
FBgn0029694	511	500	475	47	8	5.875	464
FBgn0029696	504	500	496	12	6	2	492
FBgn0029697	507	500	500	14	6	2.3333333333333335	493
FBgn0029700	521	500	515	27	6	4.5	494
FBgn0029701	515	500	331	199	5	39.8	316
FBgn0029702	516	500	516	16	4	4	500
FBgn0029703	505	500	288	222	6	37	283
FBgn0029705	519	500	506	32	9	3.5555555555555554	487
FBgn0029706	508	500	419	97	9	10.777777777777779	411
FBgn0029708	505	500	481	29	7	4.142857142857143	476
FBgn0029709	500	500	486	14	6	2.3333333333333335	486
FBgn0029710	504	500	472	36	5	7.2	468
FBgn0029712	501	500	489	13	5	2.6	488
FBgn0029714	500	500	493	7	2	3.5	493
FBgn0029716	512	500	451	73	7	10.428571428571429	439
FBgn0029718	501	500	468	34	5	6.8	467
FBgn0029719	535	500	502	68	8	8.5	467
FBgn0029720	530	500	495	65	9	7.222222222222222	465
FBgn0029722	514	500	491	37	7	5.285714285714286	477
FBgn0029723	542	500	475	109	14	7.785714285714286	433
FBgn0029724	448	444	416	36	5	7.2	412
FBgn0029725	515	500	512	18	4	4.5	497
FBgn0029726	500	500	488	12	2	6	488
FBgn0029727	557	500	518	96	8	12	461
FBgn0029728	524	500	522	26	3	8.666666666666666	498
FBgn0029729	516	500	491	41	6	6.833333333333333	475
FBgn0029733	520	500	519	21	3	7	499
FBgn0029736	508	500	465	51	13	3.923076923076923	457
FBgn0029737	500	500	477	23	7	3.2857142857142856	477
FBgn0029747	532	500	501	63	7	9	469
FBgn0029750	507	500	461	53	8	6.625	454
FBgn0029751	344	344	56	288	2	144	56
FBgn0029752	500	500	296	204	3	68	296
FBgn0029753	494	474	463	51	16	3.1875	443
FBgn0029754	506	500	479	33	3	11	473
FBgn0029756	501	500	477	25	9	2.7777777777777777	476
FBgn0029762	516	500	472	60	8	7.5	456
FBgn0029768	502	500	470	34	7	4.857142857142857	468
FBgn0029769	524	500	499	49	8	6.125	475
FBgn0029770	515	500	454	76	9	8.444444444444445	439
FBgn0029771	517	500	486	48	5	9.6	469
FBgn0029778	505	500	500	10	4	2.5	495
FBgn0029783	500	500	463	37	2	18.5	463
FBgn0029789	378	378	367	11	3	3.6666666666666665	367
FBgn0029795	531	500	512	50	9	5.555555555555555	481
FBgn0029798	512	500	504	20	3	6.666666666666667	492
FBgn0029799	508	500	464	52	6	8.666666666666666	456
FBgn0029800	500	500	492	8	1	8	492
FBgn0029801	508	500	500	16	3	5.333333333333333	492
FBgn0029804	500	500	462	38	4	9.5	462
FBgn0029807	509	500	491	27	5	5.4	482
FBgn0029809	500	500	492	8	5	1.6	492
FBgn0029810	500	500	500	0	0	NA	500
FBgn0029811	508	500	485	31	8	3.875	477
FBgn0029812	500	500	371	129	6	21.5	371
FBgn0029813	523	500	508	38	5	7.6	485
FBgn0029816	500	500	395	105	5	21	395
FBgn0029819	534	500	508	60	11	5.454545454545454	474
FBgn0029820	503	500	500	6	3	2	497
FBgn0029821	503	500	455	51	7	7.285714285714286	452
FBgn0029823	521	500	517	25	5	5	496
FBgn0029824	521	500	507	35	5	7	486
FBgn0029827	504	500	471	37	6	6.166666666666667	467
FBgn0029828	509	500	482	36	6	6	473
FBgn0029830	501	500	483	19	5	3.8	482
FBgn0029831	500	500	498	2	2	1	498
FBgn0029834	502	500	489	15	5	3	487
FBgn0029835	500	500	481	19	5	3.8	481
FBgn0029836	500	500	436	64	4	16	436
FBgn0029837	521	500	510	32	6	5.333333333333333	489
FBgn0029838	510	500	503	17	8	2.125	493
FBgn0029839	510	500	398	122	3	40.666666666666664	388
FBgn0029843	500	500	466	34	1	34	466
FBgn0029848	504	500	489	19	2	9.5	485
FBgn0029849	504	500	486	22	3	7.333333333333333	482
FBgn0029851	539	500	512	66	6	11	473
FBgn0029853	505	500	463	47	7	6.714285714285714	458
FBgn0029854	428	419	405	32	9	3.5555555555555554	396
FBgn0029856	502	500	132	372	3	124	130
FBgn0029857	500	500	499	1	1	1	499
FBgn0029858	501	500	498	4	2	2	497
FBgn0029860	500	500	500	0	0	NA	500
FBgn0029861	502	500	482	22	5	4.4	480
FBgn0029863	501	500	491	11	7	1.5714285714285714	490
FBgn0029864	517	500	482	52	10	5.2	465
FBgn0029867	513	500	498	28	5	5.6	485
FBgn0029868	521	500	502	40	5	8	481
FBgn0029870	502	500	484	20	3	6.666666666666667	482
FBgn0029873	500	500	459	41	8	5.125	459
FBgn0029874	521	500	514	28	6	4.666666666666667	493
FBgn0029877	500	500	450	50	8	6.25	450
FBgn0029881	502	500	469	35	6	5.833333333333333	467
FBgn0029882	511	500	499	23	6	3.8333333333333335	488
FBgn0029885	500	500	494	6	2	3	494
FBgn0029887	525	500	500	50	6	8.333333333333334	475
FBgn0029888	531	500	517	45	14	3.2142857142857144	486
FBgn0029894	575	500	574	76	7	10.857142857142858	499
FBgn0029895	502	500	486	18	4	4.5	484
FBgn0029896	502	500	477	27	4	6.75	475
FBgn0029898	500	500	459	41	4	10.25	459
FBgn0029903	505	500	505	5	2	2.5	500
FBgn0029905	507	500	498	16	2	8	491
FBgn0029906	500	500	491	9	1	9	491
FBgn0029907	390	390	381	9	1	9	381
FBgn0029909	500	500	497	3	2	1.5	497
FBgn0029911	521	500	514	28	7	4	493
FBgn0029912	521	500	512	30	8	3.75	491
FBgn0029913	513	500	507	19	5	3.8	494
FBgn0029914	513	500	511	15	4	3.75	498
FBgn0029915	500	500	500	0	0	NA	500
FBgn0029922	502	500	440	64	13	4.923076923076923	438
FBgn0029924	500	500	494	6	3	2	494
FBgn0029925	500	500	486	14	6	2.3333333333333335	486
FBgn0029928	500	500	500	0	0	NA	500
FBgn0029929	506	500	501	11	3	3.6666666666666665	495
FBgn0029930	500	500	496	4	1	4	496
FBgn0029931	501	500	495	7	4	1.75	494
FBgn0029932	535	500	517	53	7	7.571428571428571	482
FBgn0029935	513	500	432	94	9	10.444444444444445	419
FBgn0029936	525	500	519	31	9	3.4444444444444446	494
FBgn0029937	525	500	519	31	9	3.4444444444444446	494
FBgn0029939	519	500	479	59	7	8.428571428571429	460
FBgn0029940	500	500	495	5	3	1.6666666666666667	495
FBgn0029942	501	500	491	11	6	1.8333333333333333	490
FBgn0029944	508	500	476	40	6	6.666666666666667	468
FBgn0029945	505	500	472	38	8	4.75	467
FBgn0029947	513	500	430	96	5	19.2	417
FBgn0029948	504	500	502	6	3	2	498
FBgn0029950	506	500	499	13	2	6.5	493
FBgn0029951	500	500	487	13	2	6.5	487
FBgn0029952	500	500	489	11	2	5.5	489
FBgn0029955	500	500	497	3	1	3	497
FBgn0029957	509	500	509	9	2	4.5	500
FBgn0029958	502	500	498	6	4	1.5	496
FBgn0029959	501	500	498	4	3	1.3333333333333333	497
FBgn0029961	500	500	499	1	1	1	499
FBgn0029962	500	500	478	22	4	5.5	478
FBgn0029963	517	500	505	29	5	5.8	488
FBgn0029964	521	500	336	206	9	22.88888888888889	315
FBgn0029965	521	500	521	21	2	10.5	500
FBgn0029966	521	500	497	45	6	7.5	476
FBgn0029968	504	500	434	74	4	18.5	430
FBgn0029969	506	500	487	25	6	4.166666666666667	481
FBgn0029970	537	500	528	46	6	7.666666666666667	491
FBgn0029974	514	500	507	21	5	4.2	493
FBgn0029975	515	500	509	21	6	3.5	494
FBgn0029977	500	500	496	4	3	1.3333333333333333	496
FBgn0029979	512	500	459	65	9	7.222222222222222	447
FBgn0029980	503	500	496	10	5	2	493
FBgn0029986	503	500	467	39	6	6.5	464
FBgn0029990	505	500	482	28	8	3.5	477
FBgn0029992	515	500	513	17	7	2.4285714285714284	498
FBgn0029993	509	500	501	17	6	2.8333333333333335	492
FBgn0029994	501	500	479	23	6	3.8333333333333335	478
FBgn0029995	536	500	529	43	8	5.375	493
FBgn0029996	534	500	533	35	4	8.75	499
FBgn0029997	500	500	495	5	3	1.6666666666666667	495
FBgn0029999	523	500	522	24	3	8	499
FBgn0030000	501	496	493	13	4	3.25	488
FBgn0030001	503	500	490	16	2	8	487
FBgn0030003	500	500	350	150	5	30	350
FBgn0030004	517	500	501	33	6	5.5	484
FBgn0030005	510	500	487	33	8	4.125	477
FBgn0030007	506	500	500	12	4	3	494
FBgn0030008	506	500	500	12	4	3	494
FBgn0030009	500	500	500	0	0	NA	500
FBgn0030013	503	500	503	3	2	1.5	500
FBgn0030014	509	500	466	52	11	4.7272727272727275	457
FBgn0030015	505	500	433	77	7	11	428
FBgn0030016	513	500	502	24	5	4.8	489
FBgn0030017	504	500	483	25	5	5	479
FBgn0030018	511	500	449	73	8	9.125	438
FBgn0030025	517	500	514	20	7	2.857142857142857	497
FBgn0030026	506	500	505	7	2	3.5	499
FBgn0030027	535	500	512	58	12	4.833333333333333	477
FBgn0030028	518	500	462	74	6	12.333333333333334	444
FBgn0030029	501	500	484	18	3	6	483
FBgn0030030	512	500	512	12	2	6	500
FBgn0030033	511	500	489	33	6	5.5	478
FBgn0030034	502	500	447	57	6	9.5	445
FBgn0030037	505	500	491	19	4	4.75	486
FBgn0030038	504	500	504	4	1	4	500
FBgn0030039	512	500	498	26	6	4.333333333333333	486
FBgn0030040	504	500	454	54	9	6	450
FBgn0030048	512	500	511	13	4	3.25	499
FBgn0030049	504	500	491	17	5	3.4	487
FBgn0030050	410	389	384	47	8	5.875	363
FBgn0030051	500	500	144	356	1	356	144
FBgn0030052	500	500	166	334	3	111.33333333333333	166
FBgn0030053	514	500	487	41	5	8.2	473
FBgn0030054	516	500	387	145	6	24.166666666666668	371
FBgn0030055	500	500	499	1	1	1	499
FBgn0030056	503	500	481	25	8	3.125	478
FBgn0030057	500	500	406	94	1	94	406
FBgn0030058	502	500	416	88	6	14.666666666666666	414
FBgn0030060	500	500	497	3	1	3	497
FBgn0030061	531	500	525	37	4	9.25	494
FBgn0030063	502	500	493	11	3	3.6666666666666665	491
FBgn0030065	537	500	517	57	9	6.333333333333333	480
FBgn0030066	522	500	491	53	13	4.076923076923077	469
FBgn0030067	507	500	493	21	7	3	486
FBgn0030071	514	500	511	17	4	4.25	497
FBgn0030077	535	500	501	69	9	7.666666666666667	466
FBgn0030081	505	500	498	12	3	4	493
FBgn0030082	500	500	500	0	0	NA	500
FBgn0030085	357	357	144	213	1	213	144
FBgn0030087	517	500	516	18	6	3	499
FBgn0030089	500	500	395	105	1	105	395
FBgn0030090	503	500	495	11	6	1.8333333333333333	492
FBgn0030091	562	500	525	99	6	16.5	463
FBgn0030092	500	500	495	5	1	5	495
FBgn0030093	500	500	493	7	2	3.5	493
FBgn0030097	502	500	438	66	5	13.2	436
FBgn0030098	534	500	480	88	14	6.285714285714286	446
FBgn0030100	342	342	321	21	4	5.25	321
FBgn0030101	504	476	493	39	8	4.875	465
FBgn0030102	545	500	488	102	11	9.272727272727273	443
FBgn0030103	510	500	469	51	8	6.375	459
FBgn0030105	534	500	482	86	15	5.733333333333333	448
FBgn0030107	505	500	472	38	7	5.428571428571429	467
FBgn0030108	513	500	485	41	7	5.857142857142857	472
FBgn0030109	347	347	323	24	3	8	323
FBgn0030121	543	500	486	100	8	12.5	443
FBgn0030122	543	500	438	148	9	16.444444444444443	395
FBgn0030136	523	500	522	24	7	3.4285714285714284	499
FBgn0030141	510	500	492	28	6	4.666666666666667	482
FBgn0030148	500	500	475	25	4	6.25	475
FBgn0030151	500	500	477	23	6	3.8333333333333335	477
FBgn0030156	554	500	535	73	8	9.125	481
FBgn0030157	503	500	489	17	7	2.4285714285714284	486
FBgn0030158	501	500	492	10	4	2.5	491
FBgn0030159	500	500	326	174	4	43.5	326
FBgn0030160	507	500	414	100	5	20	407
FBgn0030161	515	500	372	158	6	26.333333333333332	357
FBgn0030162	504	500	464	44	7	6.285714285714286	460
FBgn0030167	500	500	498	2	2	1	498
FBgn0030170	522	500	515	29	6	4.833333333333333	493
FBgn0030174	510	500	389	131	7	18.714285714285715	379
FBgn0030177	506	500	472	40	9	4.444444444444445	466
FBgn0030178	500	500	498	2	2	1	498
FBgn0030181	523	500	506	40	9	4.444444444444445	483
FBgn0030186	504	500	448	60	8	7.5	444
FBgn0030187	505	500	499	11	5	2.2	494
FBgn0030196	509	500	504	14	4	3.5	495
FBgn0030204	500	500	458	42	3	14	458
FBgn0030206	508	500	508	8	3	2.6666666666666665	500
FBgn0030207	511	500	454	68	8	8.5	443
FBgn0030208	508	500	499	17	4	4.25	491
FBgn0030217	514	500	491	37	8	4.625	477
FBgn0030218	502	500	502	2	2	1	500
FBgn0030224	508	500	488	28	4	7	480
FBgn0030228	504	500	503	5	4	1.25	499
FBgn0030230	537	500	522	52	5	10.4	485
FBgn0030234	503	500	469	37	4	9.25	466
FBgn0030237	512	500	489	35	7	5	477
FBgn0030239	521	500	470	72	6	12	449
FBgn0030241	516	500	510	22	5	4.4	494
FBgn0030242	502	500	459	45	5	9	457
FBgn0030243	500	500	456	44	4	11	456
FBgn0030244	523	500	503	43	9	4.777777777777778	480
FBgn0030245	530	500	498	62	6	10.333333333333334	468
FBgn0030246	547	500	454	140	8	17.5	407
FBgn0030251	546	500	486	106	17	6.235294117647059	440
FBgn0030257	504	500	482	26	6	4.333333333333333	478
FBgn0030258	500	500	486	14	3	4.666666666666667	486
FBgn0030259	520	500	505	35	6	5.833333333333333	485
FBgn0030260	507	500	456	58	5	11.6	449
FBgn0030262	514	500	483	45	4	11.25	469
FBgn0030266	514	500	509	19	7	2.7142857142857144	495
FBgn0030268	526	500	521	31	3	10.333333333333334	495
FBgn0030269	525	500	520	30	3	10	495
FBgn0030270	505	500	486	24	5	4.8	481
FBgn0030271	505	500	471	39	6	6.5	466
FBgn0030272	510	500	469	51	10	5.1	459
FBgn0030277	510	500	479	41	7	5.857142857142857	469
FBgn0030278	535	500	516	54	10	5.4	481
FBgn0030283	511	500	490	32	5	6.4	479
FBgn0030286	507	500	501	13	7	1.8571428571428572	494
FBgn0030289	503	500	487	19	5	3.8	484
FBgn0030290	511	500	507	15	3	5	496
FBgn0030296	501	500	477	25	6	4.166666666666667	476
FBgn0030297	469	468	456	14	3	4.666666666666667	455
FBgn0030300	516	500	450	82	12	6.833333333333333	434
FBgn0030301	519	500	479	59	7	8.428571428571429	460
FBgn0030305	500	500	497	3	3	1	497
FBgn0030310	536	500	463	109	11	9.909090909090908	427
FBgn0030311	501	500	488	14	7	2	487
FBgn0030313	511	500	495	27	5	5.4	484
FBgn0030316	503	500	485	21	8	2.625	482
FBgn0030317	505	500	504	6	2	3	499
FBgn0030319	501	500	499	3	2	1.5	498
FBgn0030320	514	500	486	42	8	5.25	472
FBgn0030321	506	500	488	24	6	4	482
FBgn0030323	505	500	488	22	5	4.4	483
FBgn0030326	512	500	499	25	8	3.125	487
FBgn0030328	497	497	497	0	0	NA	497
FBgn0030329	502	500	501	3	2	1.5	499
FBgn0030334	503	500	431	75	7	10.714285714285714	428
FBgn0030336	503	500	463	43	7	6.142857142857143	460
FBgn0030338	534	500	466	102	8	12.75	432
FBgn0030339	510	500	467	53	13	4.076923076923077	457
FBgn0030342	502	500	493	11	3	3.6666666666666665	491
FBgn0030343	511	500	501	21	6	3.5	490
FBgn0030344	504	500	504	4	2	2	500
FBgn0030345	504	500	504	4	2	2	500
FBgn0030346	517	500	513	21	6	3.5	496
FBgn0030347	517	500	507	27	8	3.375	490
FBgn0030348	509	500	492	26	6	4.333333333333333	483
FBgn0030349	502	500	498	6	3	2	496
FBgn0030350	512	500	506	18	6	3	494
FBgn0030351	497	492	488	14	5	2.8	483
FBgn0030357	501	500	489	13	5	2.6	488
FBgn0030358	500	500	467	33	8	4.125	467
FBgn0030359	503	500	481	25	5	5	478
FBgn0030360	520	500	482	58	9	6.444444444444445	462
FBgn0030361	500	500	417	83	1	83	417
FBgn0030362	504	500	465	43	3	14.333333333333334	461
FBgn0030364	501	500	402	100	5	20	401
FBgn0030365	428	404	394	58	11	5.2727272727272725	370
FBgn0030367	505	500	446	64	8	8	441
FBgn0030369	507	500	243	271	7	38.714285714285715	236
FBgn0030370	520	500	498	42	9	4.666666666666667	478
FBgn0030373	552	500	528	76	10	7.6	476
FBgn0030375	529	500	519	39	6	6.5	490
FBgn0030377	516	500	442	90	8	11.25	426
FBgn0030384	504	500	492	16	4	4	488
FBgn0030385	506	500	501	11	4	2.75	495
FBgn0030390	504	500	444	64	5	12.8	440
FBgn0030391	508	500	493	23	6	3.8333333333333335	485
FBgn0030394	505	500	484	26	6	4.333333333333333	479
FBgn0030398	500	500	445	55	5	11	445
FBgn0030400	502	500	496	8	6	1.3333333333333333	494
FBgn0030403	500	500	214	286	4	71.5	214
FBgn0030406	440	440	420	20	4	5	420
FBgn0030407	515	500	495	35	5	7	480
FBgn0030408	508	500	505	11	4	2.75	497
FBgn0030409	509	500	491	27	10	2.7	482
FBgn0030410	500	500	490	10	1	10	490
FBgn0030411	500	500	490	10	1	10	490
FBgn0030412	514	500	499	29	7	4.142857142857143	485
FBgn0030417	506	500	432	80	10	8	426
FBgn0030418	531	500	425	137	7	19.571428571428573	394
FBgn0030425	524	500	484	64	12	5.333333333333333	460
FBgn0030431	519	500	482	56	6	9.333333333333334	463
FBgn0030432	500	500	457	43	2	21.5	457
FBgn0030433	500	500	478	22	5	4.4	478
FBgn0030434	595	500	552	138	10	13.8	457
FBgn0030435	500	500	249	251	2	125.5	249
FBgn0030437	536	500	524	48	8	6	488
FBgn0030438	501	500	496	6	4	1.5	495
FBgn0030439	505	500	494	16	4	4	489
FBgn0030440	508	500	464	52	11	4.7272727272727275	456
FBgn0030443	556	500	518	94	14	6.714285714285714	462
FBgn0030447	500	500	476	24	6	4	476
FBgn0030451	507	500	497	17	4	4.25	490
FBgn0030457	500	500	497	3	1	3	497
FBgn0030459	523	500	488	58	8	7.25	465
FBgn0030465	501	500	497	5	3	1.6666666666666667	496
FBgn0030466	507	500	486	28	7	4	479
FBgn0030467	519	500	517	21	5	4.2	498
FBgn0030468	510	500	477	43	7	6.142857142857143	467
FBgn0030477	500	500	486	14	6	2.3333333333333335	486
FBgn0030479	519	500	505	33	6	5.5	486
FBgn0030480	519	500	495	43	8	5.375	476
FBgn0030481	514	500	508	20	5	4	494
FBgn0030482	522	500	492	52	6	8.666666666666666	470
FBgn0030483	519	500	180	358	5	71.6	161
FBgn0030484	500	500	491	9	3	3	491
FBgn0030485	517	500	485	49	6	8.166666666666666	468
FBgn0030486	516	500	489	43	8	5.375	473
FBgn0030492	567	500	565	69	5	13.8	498
FBgn0030493	521	500	505	37	7	5.285714285714286	484
FBgn0030494	520	500	511	29	5	5.8	491
FBgn0030495	515	500	489	41	7	5.857142857142857	474
FBgn0030500	500	500	500	0	0	NA	500
FBgn0030501	509	500	508	10	3	3.3333333333333335	499
FBgn0030502	522	500	490	54	11	4.909090909090909	468
FBgn0030503	521	500	487	55	11	5	466
FBgn0030504	557	500	550	64	7	9.142857142857142	493
FBgn0030505	559	500	543	75	10	7.5	484
FBgn0030507	505	500	505	5	1	5	500
FBgn0030508	508	500	505	11	5	2.2	497
FBgn0030509	513	500	512	14	3	4.666666666666667	499
FBgn0030510	531	500	491	71	11	6.454545454545454	460
FBgn0030511	525	500	491	59	16	3.6875	466
FBgn0030514	514	500	514	14	1	14	500
FBgn0030518	501	500	489	13	2	6.5	488
FBgn0030519	517	500	498	36	8	4.5	481
FBgn0030521	513	500	513	13	2	6.5	500
FBgn0030522	513	500	508	18	3	6	495
FBgn0030525	521	500	368	174	7	24.857142857142858	347
FBgn0030528	501	500	494	8	2	4	493
FBgn0030530	534	500	432	136	12	11.333333333333334	398
FBgn0030536	543	500	492	94	11	8.545454545454545	449
FBgn0030537	532	500	527	37	6	6.166666666666667	495
FBgn0030539	501	500	441	61	8	7.625	440
FBgn0030540	500	500	497	3	1	3	497
FBgn0030541	504	500	485	23	7	3.2857142857142856	481
FBgn0030542	504	500	482	26	3	8.666666666666666	478
FBgn0030543	518	500	428	108	6	18	410
FBgn0030544	500	500	400	100	5	20	400
FBgn0030545	513	500	466	60	8	7.5	453
FBgn0030551	505	500	488	22	6	3.6666666666666665	483
FBgn0030552	505	500	490	20	6	3.3333333333333335	485
FBgn0030554	501	500	499	3	3	1	498
FBgn0030555	514	500	506	22	8	2.75	492
FBgn0030556	501	479	460	63	7	9	438
FBgn0030559	503	500	476	30	5	6	473
FBgn0030562	513	500	476	50	5	10	463
FBgn0030569	500	500	482	18	4	4.5	482
FBgn0030570	500	500	481	19	3	6.333333333333333	481
FBgn0030571	536	500	506	66	9	7.333333333333333	470
FBgn0030574	515	500	496	34	8	4.25	481
FBgn0030575	507	500	498	16	7	2.2857142857142856	491
FBgn0030576	512	500	490	34	9	3.7777777777777777	478
FBgn0030577	502	500	373	131	6	21.833333333333332	371
FBgn0030581	504	500	128	380	2	190	124
FBgn0030583	534	500	514	54	11	4.909090909090909	480
FBgn0030586	552	500	532	72	8	9	480
FBgn0030587	519	500	513	25	7	3.5714285714285716	494
FBgn0030588	508	500	493	23	9	2.5555555555555554	485
FBgn0030589	500	500	486	14	4	3.5	486
FBgn0030590	564	500	541	87	8	10.875	477
FBgn0030592	558	500	552	64	6	10.666666666666666	494
FBgn0030593	516	500	511	21	5	4.2	495
FBgn0030594	494	493	462	33	7	4.714285714285714	461
FBgn0030595	533	500	533	33	5	6.6	500
FBgn0030596	504	500	494	14	4	3.5	490
FBgn0030597	510	500	508	12	3	4	498
FBgn0030598	502	500	471	33	9	3.6666666666666665	469
FBgn0030599	500	500	379	121	1	121	379
FBgn0030600	501	500	499	3	3	1	498
FBgn0030603	518	500	451	85	7	12.142857142857142	433
FBgn0030605	502	500	500	4	4	1	498
FBgn0030607	545	500	528	62	11	5.636363636363637	483
FBgn0030608	534	500	529	39	10	3.9	495
FBgn0030610	501	481	496	25	5	5	476
FBgn0030611	507	500	497	17	5	3.4	490
FBgn0030612	507	500	501	13	4	3.25	494
FBgn0030613	526	500	485	67	7	9.571428571428571	459
FBgn0030614	504	500	475	33	7	4.714285714285714	471
FBgn0030615	525	500	479	71	5	14.2	454
FBgn0030616	551	500	548	54	4	13.5	497
FBgn0030617	537	500	489	85	8	10.625	452
FBgn0030620	532	500	504	60	5	12	472
FBgn0030622	513	500	499	27	7	3.857142857142857	486
FBgn0030624	537	500	525	49	5	9.8	488
FBgn0030628	508	500	507	9	4	2.25	499
FBgn0030634	520	500	501	39	6	6.5	481
FBgn0030638	516	500	511	21	3	7	495
FBgn0030642	502	500	445	59	2	29.5	443
FBgn0030643	512	500	466	58	7	8.285714285714286	454
FBgn0030647	501	500	472	30	8	3.75	471
FBgn0030648	500	500	73	427	3	142.33333333333334	73
FBgn0030653	543	500	512	74	10	7.4	469
FBgn0030657	510	500	501	19	2	9.5	491
FBgn0030659	516	500	491	41	7	5.857142857142857	475
FBgn0030660	516	500	495	37	5	7.4	479
FBgn0030661	507	500	505	9	3	3	498
FBgn0030662	519	500	511	27	5	5.4	492
FBgn0030663	500	500	442	58	6	9.666666666666666	442
FBgn0030664	528	500	495	61	7	8.714285714285714	467
FBgn0030666	516	500	473	59	9	6.555555555555555	457
FBgn0030667	511	500	259	263	10	26.3	248
FBgn0030670	500	500	472	28	2	14	472
FBgn0030671	502	500	459	45	6	7.5	457
FBgn0030672	520	500	505	35	6	5.833333333333333	485
FBgn0030673	500	500	485	15	4	3.75	485
FBgn0030675	506	500	502	10	3	3.3333333333333335	496
FBgn0030676	500	500	492	8	4	2	492
FBgn0030678	520	500	490	50	3	16.666666666666668	470
FBgn0030679	520	500	498	42	2	21	478
FBgn0030683	409	393	400	25	8	3.125	384
FBgn0030684	500	500	482	18	3	6	482
FBgn0030685	514	500	490	38	6	6.333333333333333	476
FBgn0030686	514	500	488	40	7	5.714285714285714	474
FBgn0030687	366	360	346	26	6	4.333333333333333	340
FBgn0030688	500	500	472	28	3	9.333333333333334	472
FBgn0030691	522	500	516	28	6	4.666666666666667	494
FBgn0030699	500	500	497	3	1	3	497
FBgn0030700	505	500	459	51	5	10.2	454
FBgn0030701	548	500	532	64	7	9.142857142857142	484
FBgn0030703	500	500	252	248	4	62	252
FBgn0030706	526	500	513	39	7	5.571428571428571	487
FBgn0030707	537	500	507	67	10	6.7	470
FBgn0030710	500	500	477	23	5	4.6	477
FBgn0030711	530	500	501	59	6	9.833333333333334	471
FBgn0030715	505	500	248	262	2	131	243
FBgn0030716	500	500	281	219	3	73	281
FBgn0030717	547	500	528	66	11	6	481
FBgn0030718	501	500	494	8	5	1.6	493
FBgn0030720	501	500	495	7	6	1.1666666666666667	494
FBgn0030721	516	500	513	19	7	2.7142857142857144	497
FBgn0030722	518	500	487	49	6	8.166666666666666	469
FBgn0030723	564	500	550	78	7	11.142857142857142	486
FBgn0030724	545	500	535	55	5	11	490
FBgn0030725	529	500	513	45	9	5	484
FBgn0030729	510	500	504	16	2	8	494
FBgn0030731	501	500	458	44	7	6.285714285714286	457
FBgn0030733	509	500	504	14	6	2.3333333333333335	495
FBgn0030734	500	500	500	0	0	NA	500
FBgn0030735	508	500	506	10	3	3.3333333333333335	498
FBgn0030738	502	500	474	30	8	3.75	472
FBgn0030740	513	500	503	23	5	4.6	490
FBgn0030742	536	500	528	44	12	3.6666666666666665	492
FBgn0030743	503	500	501	5	3	1.6666666666666667	498
FBgn0030746	500	500	467	33	6	5.5	467
FBgn0030747	526	500	488	64	7	9.142857142857142	462
FBgn0030748	509	500	283	235	9	26.11111111111111	274
FBgn0030749	500	500	500	0	0	NA	500
FBgn0030752	515	500	503	27	8	3.375	488
FBgn0030753	507	500	499	15	3	5	492
FBgn0030756	504	500	478	30	5	6	474
FBgn0030759	552	500	549	55	6	9.166666666666666	497
FBgn0030763	532	500	446	118	7	16.857142857142858	414
FBgn0030766	547	500	535	59	7	8.428571428571429	488
FBgn0030768	518	500	514	22	5	4.4	496
FBgn0030769	509	500	483	35	7	5	474
FBgn0030770	519	500	512	26	3	8.666666666666666	493
FBgn0030773	548	500	504	92	8	11.5	456
FBgn0030774	508	500	376	140	7	20	368
FBgn0030775	500	500	467	33	2	16.5	467
FBgn0030777	528	500	491	65	8	8.125	463
FBgn0030778	500	500	456	44	4	11	456
FBgn0030780	502	500	498	6	4	1.5	496
FBgn0030786	513	500	465	61	6	10.166666666666666	452
FBgn0030787	521	500	165	377	4	94.25	144
FBgn0030788	521	500	354	188	10	18.8	333
FBgn0030790	528	500	485	71	6	11.833333333333334	457
FBgn0030791	501	500	481	21	5	4.2	480
FBgn0030792	502	500	464	40	6	6.666666666666667	462
FBgn0030793	512	500	458	66	2	33	446
FBgn0030795	501	500	464	38	5	7.6	463
FBgn0030796	500	500	488	12	2	6	488
FBgn0030798	500	500	477	23	3	7.666666666666667	477
FBgn0030799	504	500	493	15	8	1.875	489
FBgn0030800	556	500	553	59	7	8.428571428571429	497
FBgn0030801	557	500	556	58	7	8.285714285714286	499
FBgn0030804	503	500	492	14	3	4.666666666666667	489
FBgn0030805	508	500	478	38	5	7.6	470
FBgn0030806	515	500	440	90	8	11.25	425
FBgn0030807	519	500	502	36	6	6	483
FBgn0030809	520	500	511	29	10	2.9	491
FBgn0030812	513	500	367	159	6	26.5	354
FBgn0030814	500	500	489	11	4	2.75	489
FBgn0030815	507	500	410	104	7	14.857142857142858	403
FBgn0030823	500	500	471	29	4	7.25	471
FBgn0030824	500	500	471	29	4	7.25	471
FBgn0030826	500	500	495	5	2	2.5	495
FBgn0030828	504	500	496	12	2	6	492
FBgn0030829	505	500	499	11	3	3.6666666666666665	494
FBgn0030830	500	500	500	0	0	NA	500
FBgn0030832	500	500	482	18	3	6	482
FBgn0030834	514	500	496	32	6	5.333333333333333	482
FBgn0030836	541	500	524	58	8	7.25	483
FBgn0030837	525	500	518	32	3	10.666666666666666	493
FBgn0030838	500	500	431	69	1	69	431
FBgn0030839	500	500	500	0	0	NA	500
FBgn0030840	367	367	356	11	2	5.5	356
FBgn0030841	516	500	479	53	5	10.6	463
FBgn0030844	511	500	487	35	9	3.888888888888889	476
FBgn0030847	513	500	488	38	5	7.6	475
FBgn0030850	464	460	416	52	9	5.777777777777778	412
FBgn0030851	526	500	485	67	10	6.7	459
FBgn0030853	501	500	495	7	3	2.3333333333333335	494
FBgn0030854	512	500	512	12	4	3	500
FBgn0030855	513	500	513	13	4	3.25	500
FBgn0030859	546	500	532	60	8	7.5	486
FBgn0030863	502	500	498	6	4	1.5	496
FBgn0030864	500	500	494	6	2	3	494
FBgn0030868	500	500	467	33	5	6.6	467
FBgn0030869	531	500	467	95	12	7.916666666666667	436
FBgn0030870	514	500	510	18	3	6	496
FBgn0030872	500	500	433	67	2	33.5	433
FBgn0030873	501	500	495	7	2	3.5	494
FBgn0030874	501	500	501	1	1	1	500
FBgn0030876	501	500	472	30	2	15	471
FBgn0030877	516	500	512	20	4	5	496
FBgn0030878	516	500	510	22	6	3.6666666666666665	494
FBgn0030880	507	500	475	39	8	4.875	468
FBgn0030881	509	500	496	22	5	4.4	487
FBgn0030883	533	500	533	33	4	8.25	500
FBgn0030884	516	500	502	30	8	3.75	486
FBgn0030887	514	500	501	27	3	9	487
FBgn0030889	516	500	516	16	2	8	500
FBgn0030890	502	500	484	20	5	4	482
FBgn0030891	504	500	503	5	4	1.25	499
FBgn0030893	434	434	415	19	4	4.75	415
FBgn0030894	506	500	504	8	4	2	498
FBgn0030895	463	434	461	31	4	7.75	432
FBgn0030897	503	500	482	24	4	6	479
FBgn0030898	504	500	465	43	7	6.142857142857143	461
FBgn0030900	500	500	473	27	3	9	473
FBgn0030904	506	500	482	30	4	7.5	476
FBgn0030905	505	500	498	12	7	1.7142857142857142	493
FBgn0030911	511	500	467	55	8	6.875	456
FBgn0030912	501	500	478	24	6	4	477
FBgn0030913	510	500	460	60	8	7.5	450
FBgn0030914	501	500	463	39	9	4.333333333333333	462
FBgn0030915	506	500	505	7	3	2.3333333333333335	499
FBgn0030918	515	500	373	157	9	17.444444444444443	358
FBgn0030921	500	500	485	15	5	3	485
FBgn0030925	500	500	490	10	5	2	490
FBgn0030926	539	500	534	44	7	6.285714285714286	495
FBgn0030927	407	407	387	20	5	4	387
FBgn0030928	530	500	506	54	7	7.714285714285714	476
FBgn0030929	510	500	506	14	4	3.5	496
FBgn0030930	500	500	500	0	0	NA	500
FBgn0030931	501	500	499	3	3	1	498
FBgn0030933	515	500	478	52	11	4.7272727272727275	463
FBgn0030936	502	500	278	226	4	56.5	276
FBgn0030937	506	500	407	105	5	21	401
FBgn0030941	516	500	497	35	10	3.5	481
FBgn0030944	444	382	440	66	3	22	378
FBgn0030945	502	500	482	22	3	7.333333333333333	480
FBgn0030946	543	500	521	65	8	8.125	478
FBgn0030947	500	500	477	23	1	23	477
FBgn0030949	524	500	512	36	6	6	488
FBgn0030951	500	500	456	44	6	7.333333333333333	456
FBgn0030952	501	500	500	2	2	1	499
FBgn0030954	500	500	476	24	2	12	476
FBgn0030955	500	500	358	142	3	47.333333333333336	358
FBgn0030956	526	500	319	233	4	58.25	293
FBgn0030961	533	500	519	47	6	7.833333333333333	486
FBgn0030963	532	500	465	99	3	33	433
FBgn0030964	527	500	474	80	9	8.88888888888889	447
FBgn0030966	538	500	528	48	5	9.6	490
FBgn0030969	545	500	504	86	10	8.6	459
FBgn0030970	500	500	494	6	1	6	494
FBgn0030973	502	500	462	42	6	7	460
FBgn0030976	524	500	459	89	5	17.8	435
FBgn0030979	576	500	530	122	14	8.714285714285714	454
FBgn0030980	534	500	513	55	7	7.857142857142857	479
FBgn0030981	508	500	484	32	9	3.5555555555555554	476
FBgn0030982	500	500	440	60	4	15	440
FBgn0030983	500	500	230	270	4	67.5	230
FBgn0030985	506	500	497	15	4	3.75	491
FBgn0030989	368	368	347	21	7	3	347
FBgn0030990	532	500	501	63	9	7	469
FBgn0030991	532	500	504	60	8	7.5	472
FBgn0030992	502	500	431	73	8	9.125	429
FBgn0030995	515	500	508	22	3	7.333333333333333	493
FBgn0030997	502	500	445	59	8	7.375	443
FBgn0030998	508	500	370	146	7	20.857142857142858	362
FBgn0030999	501	500	464	38	7	5.428571428571429	463
FBgn0031000	568	500	567	69	6	11.5	499
FBgn0031001	527	500	312	242	9	26.88888888888889	285
FBgn0031002	508	500	481	35	6	5.833333333333333	473
FBgn0031004	511	500	480	42	5	8.4	469
FBgn0031005	533	500	514	52	14	3.7142857142857144	481
FBgn0031006	545	500	512	78	11	7.090909090909091	467
FBgn0031008	500	500	488	12	4	3	488
FBgn0031010	512	500	496	28	6	4.666666666666667	484
FBgn0031011	537	500	505	69	8	8.625	468
FBgn0031012	536	500	512	60	7	8.571428571428571	476
FBgn0031018	500	500	330	170	2	85	330
FBgn0031020	500	500	499	1	1	1	499
FBgn0031026	506	500	457	55	7	7.857142857142857	451
FBgn0031030	521	500	508	34	8	4.25	487
FBgn0031031	503	500	370	136	10	13.6	367
FBgn0031032	582	500	562	102	14	7.285714285714286	480
FBgn0031034	505	500	481	29	8	3.625	476
FBgn0031036	500	500	217	283	2	141.5	217
FBgn0031040	500	500	477	23	5	4.6	477
FBgn0031042	419	419	373	46	11	4.181818181818182	373
FBgn0031043	503	500	496	10	3	3.3333333333333335	493
FBgn0031044	509	500	507	11	3	3.6666666666666665	498
FBgn0031045	502	500	464	40	9	4.444444444444445	462
FBgn0031047	516	500	454	78	7	11.142857142857142	438
FBgn0031048	518	500	472	64	11	5.818181818181818	454
FBgn0031049	518	500	472	64	11	5.818181818181818	454
FBgn0031050	503	500	268	238	5	47.6	265
FBgn0031051	524	500	512	36	7	5.142857142857143	488
FBgn0031052	500	500	494	6	1	6	494
FBgn0031053	524	500	507	41	8	5.125	483
FBgn0031054	525	500	501	49	10	4.9	476
FBgn0031055	500	500	466	34	6	5.666666666666667	466
FBgn0031057	500	500	500	0	0	NA	500
FBgn0031058	505	500	501	9	5	1.8	496
FBgn0031061	500	500	499	1	1	1	499
FBgn0031062	500	500	492	8	2	4	492
FBgn0031064	515	500	501	29	4	7.25	486
FBgn0031065	521	500	500	42	4	10.5	479
FBgn0031068	443	443	432	11	2	5.5	432
FBgn0031069	548	500	487	109	8	13.625	439
FBgn0031070	500	500	449	51	4	12.75	449
FBgn0031077	513	500	495	31	5	6.2	482
FBgn0031078	503	500	495	11	4	2.75	492
FBgn0031080	509	500	422	96	9	10.666666666666666	413
FBgn0031086	517	500	504	30	6	5	487
FBgn0031091	500	500	142	358	3	119.33333333333333	142
FBgn0031092	539	500	522	56	5	11.2	483
FBgn0031093	500	500	476	24	4	6	476
FBgn0031094	500	500	480	20	2	10	480
FBgn0031097	510	500	451	69	6	11.5	441
FBgn0031098	526	500	519	33	5	6.6	493
FBgn0031099	501	500	484	18	5	3.6	483
FBgn0031100	500	500	496	4	3	1.3333333333333333	496
FBgn0031101	500	500	479	21	3	7	479
FBgn0031103	525	500	386	164	8	20.5	361
FBgn0031104	509	500	243	275	4	68.75	234
FBgn0031106	506	500	316	196	4	49	310
FBgn0031109	503	500	473	33	5	6.6	470
FBgn0031110	400	388	369	43	3	14.333333333333334	357
FBgn0031111	501	500	417	85	9	9.444444444444445	416
FBgn0031114	524	500	495	53	9	5.888888888888889	471
FBgn0031115	503	500	470	36	6	6	467
FBgn0031116	506	500	384	128	7	18.285714285714285	378
FBgn0031117	522	500	416	128	9	14.222222222222221	394
FBgn0031118	502	500	478	26	6	4.333333333333333	476
FBgn0031119	500	500	177	323	2	161.5	177
FBgn0031126	520	500	491	49	7	7	471
FBgn0031127	504	500	498	10	6	1.6666666666666667	494
FBgn0031128	513	500	511	15	6	2.5	498
FBgn0031129	500	500	495	5	2	2.5	495
FBgn0031130	527	500	519	35	4	8.75	492
FBgn0031135	501	500	478	24	5	4.8	477
FBgn0031141	530	500	440	120	10	12	410
FBgn0031142	543	500	522	64	8	8	479
FBgn0031143	504	500	324	184	11	16.727272727272727	320
FBgn0031144	519	500	248	290	5	58	229
FBgn0031145	500	500	106	394	2	197	106
FBgn0031146	530	500	521	39	3	13	491
FBgn0031148	572	500	550	94	11	8.545454545454545	478
FBgn0031149	503	500	440	66	6	11	437
FBgn0031150	501	500	486	16	3	5.333333333333333	485
FBgn0031155	511	500	467	55	10	5.5	456
FBgn0031157	500	500	257	243	4	60.75	257
FBgn0031161	501	500	479	23	5	4.6	478
FBgn0031170	509	500	494	24	3	8	485
FBgn0031171	506	500	505	7	2	3.5	499
FBgn0031174	501	500	465	37	4	9.25	464
FBgn0031176	508	500	490	26	4	6.5	482
FBgn0031181	500	500	198	302	2	151	198
FBgn0031183	523	500	413	133	7	19	390
FBgn0031187	555	500	525	85	8	10.625	470
FBgn0031189	500	500	260	240	2	120	260
FBgn0031190	507	500	497	17	5	3.4	490
FBgn0031191	528	500	519	37	8	4.625	491
FBgn0031194	516	500	482	50	9	5.555555555555555	466
FBgn0031195	503	500	434	72	7	10.285714285714286	431
FBgn0031209	506	500	496	16	8	2	490
FBgn0031213	506	500	453	59	10	5.9	447
FBgn0031216	501	500	277	225	5	45	276
FBgn0031217	470	461	463	16	4	4	454
FBgn0031220	503	500	354	152	4	38	351
FBgn0031227	534	500	532	36	4	9	498
FBgn0031228	513	500	507	19	5	3.8	494
FBgn0031231	519	500	502	36	9	4	483
FBgn0031232	501	500	498	4	2	2	497
FBgn0031233	511	500	495	27	7	3.857142857142857	484
FBgn0031235	508	500	500	16	6	2.6666666666666665	492
FBgn0031240	537	500	522	52	4	13	485
FBgn0031244	501	500	477	25	3	8.333333333333334	476
FBgn0031245	512	500	503	21	7	3	491
FBgn0031247	506	500	491	21	6	3.5	485
FBgn0031248	525	500	524	26	4	6.5	499
FBgn0031249	501	500	493	9	2	4.5	492
FBgn0031250	500	500	499	1	1	1	499
FBgn0031251	500	500	478	22	2	11	478
FBgn0031252	500	500	498	2	2	1	498
FBgn0031253	500	500	481	19	4	4.75	481
FBgn0031254	501	500	486	16	4	4	485
FBgn0031255	485	437	457	76	7	10.857142857142858	409
FBgn0031256	501	500	492	10	6	1.6666666666666667	491
FBgn0031258	526	500	515	37	4	9.25	489
FBgn0031263	500	500	492	8	1	8	492
FBgn0031264	526	500	480	72	8	9	454
FBgn0031265	528	500	509	47	9	5.222222222222222	481
FBgn0031266	544	500	542	46	5	9.2	498
FBgn0031267	502	500	501	3	2	1.5	499
FBgn0031268	500	500	499	1	1	1	499
FBgn0031270	510	500	482	38	11	3.4545454545454546	472
FBgn0031275	518	500	501	35	5	7	483
FBgn0031276	489	453	485	40	6	6.666666666666667	449
FBgn0031277	500	500	487	13	2	6.5	487
FBgn0031281	500	500	500	0	0	NA	500
FBgn0031282	500	500	499	1	1	1	499
FBgn0031283	500	500	450	50	5	10	450
FBgn0031284	502	500	482	22	5	4.4	480
FBgn0031286	500	500	500	0	0	NA	500
FBgn0031287	500	500	496	4	3	1.3333333333333333	496
FBgn0031288	508	500	431	85	4	21.25	423
FBgn0031292	505	500	483	27	7	3.857142857142857	478
FBgn0031294	500	500	441	59	7	8.428571428571429	441
FBgn0031296	517	500	513	21	4	5.25	496
FBgn0031299	512	500	506	18	4	4.5	494
FBgn0031301	506	500	503	9	2	4.5	497
FBgn0031304	509	500	484	34	5	6.8	475
FBgn0031305	511	500	503	19	7	2.7142857142857144	492
FBgn0031306	508	500	500	16	6	2.6666666666666665	492
FBgn0031309	501	500	491	11	3	3.6666666666666665	490
FBgn0031310	500	500	492	8	1	8	492
FBgn0031312	508	500	440	76	5	15.2	432
FBgn0031313	512	500	427	97	6	16.166666666666668	415
FBgn0031314	512	500	371	153	6	25.5	359
FBgn0031317	503	500	476	30	5	6	473
FBgn0031318	504	500	499	9	4	2.25	495
FBgn0031320	501	500	498	4	2	2	497
FBgn0031321	500	500	500	0	0	NA	500
FBgn0031323	504	500	497	11	5	2.2	493
FBgn0031327	500	500	463	37	3	12.333333333333334	463
FBgn0031331	530	500	528	32	5	6.4	498
FBgn0031335	512	500	458	66	4	16.5	446
FBgn0031337	500	500	473	27	2	13.5	473
FBgn0031343	360	337	337	46	8	5.75	314
FBgn0031344	500	500	492	8	2	4	492
FBgn0031347	501	500	501	1	1	1	500
FBgn0031351	501	500	485	17	6	2.8333333333333335	484
FBgn0031356	522	500	495	49	5	9.8	473
FBgn0031357	500	500	500	0	0	NA	500
FBgn0031359	512	500	495	29	9	3.2222222222222223	483
FBgn0031360	366	359	354	19	6	3.1666666666666665	347
FBgn0031361	500	500	483	17	1	17	483
FBgn0031364	513	500	506	20	4	5	493
FBgn0031365	500	500	491	9	2	4.5	491
FBgn0031367	517	500	507	27	5	5.4	490
FBgn0031372	511	500	481	41	2	20.5	470
FBgn0031373	500	500	247	253	4	63.25	247
FBgn0031374	532	500	290	274	6	45.666666666666664	258
FBgn0031375	500	500	500	0	0	NA	500
FBgn0031377	508	500	508	8	1	8	500
FBgn0031378	508	500	506	10	2	5	498
FBgn0031381	500	500	491	9	4	2.25	491
FBgn0031388	588	500	583	93	6	15.5	495
FBgn0031389	501	500	500	2	2	1	499
FBgn0031390	510	500	503	17	6	2.8333333333333335	493
FBgn0031391	510	500	499	21	8	2.625	489
FBgn0031393	500	500	465	35	8	4.375	465
FBgn0031397	398	398	398	0	0	NA	398
FBgn0031398	525	500	523	27	4	6.75	498
FBgn0031399	500	500	496	4	1	4	496
FBgn0031406	524	500	520	28	4	7	496
FBgn0031407	510	500	491	29	4	7.25	481
FBgn0031409	508	500	502	14	5	2.8	494
FBgn0031410	500	500	387	113	1	113	387
FBgn0031412	500	500	350	150	5	30	350
FBgn0031413	521	500	511	31	5	6.2	490
FBgn0031414	500	500	489	11	2	5.5	489
FBgn0031417	500	500	497	3	1	3	497
FBgn0031419	544	500	539	49	6	8.166666666666666	495
FBgn0031423	526	500	517	35	4	8.75	491
FBgn0031424	500	500	500	0	0	NA	500
FBgn0031428	521	500	510	32	7	4.571428571428571	489
FBgn0031430	522	500	522	22	2	11	500
FBgn0031431	503	500	490	16	3	5.333333333333333	487
FBgn0031434	501	500	418	84	6	14	417
FBgn0031435	535	500	529	41	7	5.857142857142857	494
FBgn0031436	500	500	482	18	3	6	482
FBgn0031437	537	500	523	51	6	8.5	486
FBgn0031440	520	500	520	20	3	6.666666666666667	500
FBgn0031441	511	500	484	38	6	6.333333333333333	473
FBgn0031442	500	500	496	4	2	2	496
FBgn0031444	500	500	491	9	3	3	491
FBgn0031446	503	500	478	28	8	3.5	475
FBgn0031449	512	500	501	23	5	4.6	489
FBgn0031450	499	485	472	41	6	6.833333333333333	458
FBgn0031451	501	500	433	69	2	34.5	432
FBgn0031452	500	500	476	24	2	12	476
FBgn0031453	512	500	505	19	5	3.8	493
FBgn0031456	512	500	507	17	4	4.25	495
FBgn0031457	500	500	461	39	2	19.5	461
FBgn0031458	501	500	466	36	3	12	465
FBgn0031459	500	500	484	16	5	3.2	484
FBgn0031461	511	500	495	27	6	4.5	484
FBgn0031462	501	500	448	54	3	18	447
FBgn0031463	516	500	516	16	1	16	500
FBgn0031466	505	500	505	5	2	2.5	500
FBgn0031467	502	500	496	8	2	4	494
FBgn0031468	537	500	516	58	7	8.285714285714286	479
FBgn0031470	370	349	317	74	8	9.25	296
FBgn0031471	500	500	183	317	2	158.5	183
FBgn0031473	500	500	490	10	4	2.5	490
FBgn0031476	500	500	492	8	3	2.6666666666666665	492
FBgn0031478	503	500	465	41	6	6.833333333333333	462
FBgn0031479	504	500	502	6	3	2	498
FBgn0031483	500	500	484	16	2	8	484
FBgn0031484	500	500	494	6	2	3	494
FBgn0031485	506	500	489	23	7	3.2857142857142856	483
FBgn0031489	611	500	611	111	8	13.875	500
FBgn0031491	500	500	500	0	0	NA	500
FBgn0031492	501	500	501	1	1	1	500
FBgn0031493	502	500	502	2	2	1	500
FBgn0031494	501	500	489	13	2	6.5	488
FBgn0031497	501	500	497	5	3	1.6666666666666667	496
FBgn0031498	500	500	500	0	0	NA	500
FBgn0031500	500	500	499	1	1	1	499
FBgn0031501	524	500	523	25	3	8.333333333333334	499
FBgn0031504	502	500	228	276	3	92	226
FBgn0031505	502	500	352	152	6	25.333333333333332	350
FBgn0031512	500	500	500	0	0	NA	500
FBgn0031513	535	500	525	45	5	9	490
FBgn0031514	504	500	494	14	4	3.5	490
FBgn0031516	505	500	494	16	5	3.2	489
FBgn0031519	507	500	506	8	2	4	499
FBgn0031520	502	500	497	7	3	2.3333333333333335	495
FBgn0031522	517	500	428	106	8	13.25	411
FBgn0031528	399	398	383	17	3	5.666666666666667	382
FBgn0031529	501	500	498	4	3	1.3333333333333333	497
FBgn0031531	506	500	495	17	4	4.25	489
FBgn0031533	501	500	465	37	5	7.4	464
FBgn0031534	508	500	494	22	7	3.142857142857143	486
FBgn0031535	502	500	461	43	5	8.6	459
FBgn0031536	520	500	520	20	4	5	500
FBgn0031538	509	500	491	27	6	4.5	482
FBgn0031540	520	500	507	33	3	11	487
FBgn0031542	500	500	491	9	3	3	491
FBgn0031544	502	500	498	6	4	1.5	496
FBgn0031545	513	500	489	37	3	12.333333333333334	476
FBgn0031546	500	500	493	7	2	3.5	493
FBgn0031547	503	500	492	14	4	3.5	489
FBgn0031548	500	500	455	45	6	7.5	455
FBgn0031549	535	500	498	72	12	6	463
FBgn0031550	519	500	409	129	9	14.333333333333334	390
FBgn0031554	500	500	496	4	2	2	496
FBgn0031559	372	372	294	78	3	26	294
FBgn0031560	513	500	441	85	5	17	428
FBgn0031561	526	500	513	39	3	13	487
FBgn0031562	509	500	460	58	4	14.5	451
FBgn0031563	500	500	493	7	2	3.5	493
FBgn0031564	500	500	493	7	3	2.3333333333333335	493
FBgn0031566	508	500	507	9	3	3	499
FBgn0031568	500	500	497	3	2	1.5	497
FBgn0031571	508	500	496	20	4	5	488
FBgn0031573	526	500	503	49	10	4.9	477
FBgn0031575	515	500	492	38	4	9.5	477
FBgn0031579	516	500	449	83	6	13.833333333333334	433
FBgn0031580	504	500	484	24	7	3.4285714285714284	480
FBgn0031585	507	500	471	43	9	4.777777777777778	464
FBgn0031589	519	500	517	21	5	4.2	498
FBgn0031590	503	500	412	94	10	9.4	409
FBgn0031592	501	500	486	16	4	4	485
FBgn0031596	500	500	475	25	3	8.333333333333334	475
FBgn0031597	411	401	386	35	10	3.5	376
FBgn0031600	501	500	256	246	3	82	255
FBgn0031603	517	500	499	35	9	3.888888888888889	482
FBgn0031604	502	500	498	6	2	3	496
FBgn0031607	500	500	495	5	2	2.5	495
FBgn0031608	501	500	451	51	3	17	450
FBgn0031609	517	500	431	103	2	51.5	414
FBgn0031610	500	500	77	423	1	423	77
FBgn0031617	360	353	344	23	5	4.6	337
FBgn0031619	504	500	486	22	7	3.142857142857143	482
FBgn0031620	527	500	355	199	7	28.428571428571427	328
FBgn0031621	411	405	405	12	4	3	399
FBgn0031623	510	500	507	13	4	3.25	497
FBgn0031626	534	500	503	65	4	16.25	469
FBgn0031627	502	500	490	14	4	3.5	488
FBgn0031628	501	500	489	13	3	4.333333333333333	488
FBgn0031630	500	500	362	138	5	27.6	362
FBgn0031631	551	500	492	110	4	27.5	441
FBgn0031632	525	500	509	41	5	8.2	484
FBgn0031634	439	439	431	8	3	2.6666666666666665	431
FBgn0031635	505	500	503	7	3	2.3333333333333335	498
FBgn0031636	505	500	503	7	3	2.3333333333333335	498
FBgn0031637	515	500	510	20	7	2.857142857142857	495
FBgn0031638	515	500	510	20	7	2.857142857142857	495
FBgn0031639	500	500	500	0	0	NA	500
FBgn0031640	500	500	500	0	0	NA	500
FBgn0031643	500	500	498	2	2	1	498
FBgn0031644	537	500	507	67	10	6.7	470
FBgn0031645	524	500	370	178	8	22.25	346
FBgn0031646	544	500	512	76	10	7.6	468
FBgn0031649	526	500	520	32	6	5.333333333333333	494
FBgn0031650	500	500	488	12	3	4	488
FBgn0031651	512	500	512	12	2	6	500
FBgn0031653	523	500	485	61	10	6.1	462
FBgn0031654	500	500	401	99	2	49.5	401
FBgn0031655	500	500	484	16	2	8	484
FBgn0031657	500	500	460	40	2	20	460
FBgn0031659	507	500	507	7	3	2.3333333333333335	500
FBgn0031661	504	500	502	6	5	1.2	498
FBgn0031662	504	500	502	6	5	1.2	498
FBgn0031664	501	500	497	5	2	2.5	496
FBgn0031670	509	500	501	17	6	2.8333333333333335	492
FBgn0031673	610	500	573	147	8	18.375	463
FBgn0031676	500	500	497	3	1	3	497
FBgn0031681	546	500	532	60	7	8.571428571428571	486
FBgn0031682	546	500	531	61	8	7.625	485
FBgn0031683	512	500	240	284	3	94.66666666666667	228
FBgn0031684	503	500	486	20	7	2.857142857142857	483
FBgn0031688	501	500	388	114	8	14.25	387
FBgn0031689	518	500	504	32	5	6.4	486
FBgn0031692	501	500	461	41	3	13.666666666666666	460
FBgn0031693	508	500	453	63	8	7.875	445
FBgn0031696	509	500	477	41	5	8.2	468
FBgn0031697	514	500	493	35	8	4.375	479
FBgn0031698	502	500	493	11	4	2.75	491
FBgn0031700	507	500	467	47	6	7.833333333333333	460
FBgn0031701	520	500	509	31	5	6.2	489
FBgn0031702	502	500	491	13	3	4.333333333333333	489
FBgn0031703	520	500	448	92	13	7.076923076923077	428
FBgn0031707	532	500	511	53	9	5.888888888888889	479
FBgn0031708	501	500	468	34	7	4.857142857142857	467
FBgn0031710	524	500	429	119	3	39.666666666666664	405
FBgn0031711	500	500	290	210	3	70	290
FBgn0031713	505	500	500	10	4	2.5	495
FBgn0031715	516	500	464	68	11	6.181818181818182	448
FBgn0031716	486	448	484	40	5	8	446
FBgn0031717	510	500	508	12	5	2.4	498
FBgn0031718	519	500	470	68	8	8.5	451
FBgn0031719	522	500	499	45	9	5	477
FBgn0031720	502	500	473	31	3	10.333333333333334	471
FBgn0031721	500	500	498	2	1	2	498
FBgn0031722	527	500	527	27	4	6.75	500
FBgn0031723	533	500	499	67	8	8.375	466
FBgn0031724	549	500	546	52	7	7.428571428571429	497
FBgn0031725	505	500	487	23	4	5.75	482
FBgn0031726	502	500	397	107	5	21.4	395
FBgn0031728	500	500	455	45	5	9	455
FBgn0031729	500	500	493	7	1	7	493
FBgn0031730	503	500	498	8	4	2	495
FBgn0031731	505	500	499	11	3	3.6666666666666665	494
FBgn0031732	516	500	508	24	4	6	492
FBgn0031733	502	500	500	4	2	2	498
FBgn0031734	500	500	420	80	1	80	420
FBgn0031736	506	500	194	318	5	63.6	188
FBgn0031737	513	500	487	39	6	6.5	474
FBgn0031738	500	500	472	28	5	5.6	472
FBgn0031739	501	500	279	223	2	111.5	278
FBgn0031740	509	500	367	151	5	30.2	358
FBgn0031741	500	500	481	19	4	4.75	481
FBgn0031745	508	500	487	29	6	4.833333333333333	479
FBgn0031746	516	500	457	75	10	7.5	441
FBgn0031749	500	500	495	5	1	5	495
FBgn0031751	504	500	495	13	6	2.1666666666666665	491
FBgn0031752	510	500	494	26	9	2.888888888888889	484
FBgn0031756	501	500	492	10	5	2	491
FBgn0031757	501	500	492	10	4	2.5	491
FBgn0031760	535	500	506	64	11	5.818181818181818	471
FBgn0031762	504	500	453	55	5	11	449
FBgn0031763	501	500	498	4	3	1.3333333333333333	497
FBgn0031764	509	500	282	236	2	118	273
FBgn0031765	473	473	460	13	1	13	460
FBgn0031766	517	500	510	24	6	4	493
FBgn0031768	500	500	500	0	0	NA	500
FBgn0031769	482	451	465	48	8	6	434
FBgn0031770	501	500	501	1	1	1	500
FBgn0031771	501	500	488	14	6	2.3333333333333335	487
FBgn0031772	501	500	491	11	5	2.2	490
FBgn0031773	500	500	494	6	2	3	494
FBgn0031774	509	500	509	9	1	9	500
FBgn0031776	535	500	512	58	11	5.2727272727272725	477
FBgn0031777	512	500	486	38	9	4.222222222222222	474
FBgn0031778	512	500	508	16	3	5.333333333333333	496
FBgn0031779	513	500	357	169	5	33.8	344
FBgn0031782	500	500	366	134	1	134	366
FBgn0031784	509	500	482	36	8	4.5	473
FBgn0031785	501	500	496	6	3	2	495
FBgn0031786	502	500	487	17	5	3.4	485
FBgn0031792	501	500	501	1	1	1	500
FBgn0031799	504	500	504	4	1	4	500
FBgn0031800	519	500	516	22	4	5.5	497
FBgn0031801	540	500	490	90	12	7.5	450
FBgn0031802	511	500	501	21	3	7	490
FBgn0031803	511	500	501	21	3	7	490
FBgn0031805	519	500	477	61	5	12.2	458
FBgn0031808	520	500	502	38	5	7.6	482
FBgn0031811	500	500	495	5	3	1.6666666666666667	495
FBgn0031813	534	500	464	104	8	13	430
FBgn0031814	521	500	520	22	3	7.333333333333333	499
FBgn0031815	500	500	499	1	1	1	499
FBgn0031816	537	500	513	61	4	15.25	476
FBgn0031818	520	500	519	21	4	5.25	499
FBgn0031820	507	500	506	8	2	4	499
FBgn0031822	500	500	495	5	1	5	495
FBgn0031824	500	500	497	3	2	1.5	497
FBgn0031826	503	500	498	8	3	2.6666666666666665	495
FBgn0031829	507	500	501	13	4	3.25	494
FBgn0031830	506	500	501	11	3	3.6666666666666665	495
FBgn0031831	386	385	325	62	3	20.666666666666668	324
FBgn0031832	500	500	480	20	4	5	480
FBgn0031834	502	500	350	154	7	22	348
FBgn0031835	513	500	502	24	5	4.8	489
FBgn0031836	540	500	524	56	10	5.6	484
FBgn0031837	500	500	491	9	6	1.5	491
FBgn0031844	501	500	488	14	4	3.5	487
FBgn0031848	501	500	494	8	5	1.6	493
FBgn0031850	524	500	522	26	7	3.7142857142857144	498
FBgn0031851	510	500	462	58	14	4.142857142857143	452
FBgn0031853	504	500	497	11	6	1.8333333333333333	493
FBgn0031854	511	500	487	35	4	8.75	476
FBgn0031855	525	500	506	44	9	4.888888888888889	481
FBgn0031856	500	500	472	28	3	9.333333333333334	472
FBgn0031857	554	500	539	69	4	17.25	485
FBgn0031858	500	500	496	4	2	2	496
FBgn0031859	500	500	493	7	4	1.75	493
FBgn0031860	508	500	501	15	6	2.5	493
FBgn0031861	500	500	491	9	3	3	491
FBgn0031865	508	500	490	26	6	4.333333333333333	482
FBgn0031866	502	500	498	6	3	2	496
FBgn0031868	539	500	526	52	4	13	487
FBgn0031869	502	500	490	14	4	3.5	488
FBgn0031871	482	463	479	22	4	5.5	460
FBgn0031873	504	500	489	19	2	9.5	485
FBgn0031874	504	500	500	8	3	2.6666666666666665	496
FBgn0031875	511	500	502	20	5	4	491
FBgn0031876	500	500	493	7	2	3.5	493
FBgn0031877	500	500	500	0	0	NA	500
FBgn0031878	507	500	505	9	4	2.25	498
FBgn0031881	509	500	500	18	2	9	491
FBgn0031883	505	500	468	42	4	10.5	463
FBgn0031885	528	500	503	53	5	10.6	475
FBgn0031888	505	500	195	315	5	63	190
FBgn0031893	550	500	542	58	10	5.8	492
FBgn0031894	522	500	487	57	7	8.142857142857142	465
FBgn0031895	518	500	514	22	5	4.4	496
FBgn0031896	506	500	506	6	2	3	500
FBgn0031897	521	499	505	38	4	9.5	483
FBgn0031900	531	500	507	55	7	7.857142857142857	476
FBgn0031902	517	500	336	198	5	39.6	319
FBgn0031903	503	500	502	4	3	1.3333333333333333	499
FBgn0031904	508	500	504	12	4	3	496
FBgn0031905	508	500	507	9	3	3	499
FBgn0031906	524	500	520	28	2	14	496
FBgn0031907	555	500	534	76	10	7.6	479
FBgn0031909	501	500	458	44	11	4	457
FBgn0031910	514	500	492	36	4	9	478
FBgn0031913	507	500	500	14	4	3.5	493
FBgn0031918	527	500	516	38	5	7.6	489
FBgn0031920	500	500	497	3	1	3	497
FBgn0031925	517	500	465	69	11	6.2727272727272725	448
FBgn0031926	503	500	492	14	4	3.5	489
FBgn0031930	550	500	550	50	3	16.666666666666668	500
FBgn0031935	427	420	398	36	3	12	391
FBgn0031936	545	500	540	50	5	10	495
FBgn0031937	506	500	503	9	3	3	497
FBgn0031940	510	500	498	22	5	4.4	488
FBgn0031941	504	500	497	11	4	2.75	493
FBgn0031942	500	500	469	31	4	7.75	469
FBgn0031945	510	500	510	10	1	10	500
FBgn0031948	544	500	535	53	11	4.818181818181818	491
FBgn0031950	520	500	491	49	5	9.8	471
FBgn0031951	501	500	499	3	3	1	498
FBgn0031952	535	500	475	95	7	13.571428571428571	440
FBgn0031954	536	500	401	171	6	28.5	365
FBgn0031955	511	500	501	21	4	5.25	490
FBgn0031957	510	500	501	19	3	6.333333333333333	491
FBgn0031959	503	500	494	12	3	4	491
FBgn0031969	527	500	502	52	5	10.4	475
FBgn0031970	504	500	478	30	8	3.75	474
FBgn0031972	364	364	364	0	0	NA	364
FBgn0031973	501	500	477	25	6	4.166666666666667	476
FBgn0031975	501	500	417	85	6	14.166666666666666	416
FBgn0031976	503	500	492	14	3	4.666666666666667	489
FBgn0031979	528	500	481	75	9	8.333333333333334	453
FBgn0031980	517	500	481	53	8	6.625	464
FBgn0031981	517	500	481	53	8	6.625	464
FBgn0031985	514	500	514	14	2	7	500
FBgn0031986	514	500	514	14	2	7	500
FBgn0031987	503	500	502	4	3	1.3333333333333333	499
FBgn0031988	509	500	508	10	3	3.3333333333333335	499
FBgn0031990	511	500	492	30	6	5	481
FBgn0031992	519	500	453	85	9	9.444444444444445	434
FBgn0031995	501	500	492	10	2	5	491
FBgn0031999	519	500	435	103	5	20.6	416
FBgn0032000	500	500	493	7	5	1.4	493
FBgn0032001	500	500	499	1	1	1	499
FBgn0032004	393	393	393	0	0	NA	393
FBgn0032005	541	500	522	60	10	6	481
FBgn0032006	518	500	495	41	7	5.857142857142857	477
FBgn0032010	514	500	493	35	4	8.75	479
FBgn0032013	509	500	475	43	10	4.3	466
FBgn0032014	447	422	441	31	4	7.75	416
FBgn0032015	504	500	504	4	1	4	500
FBgn0032016	504	500	503	5	2	2.5	499
FBgn0032017	513	500	506	20	5	4	493
FBgn0032018	513	500	511	15	4	3.75	498
FBgn0032020	521	500	484	58	10	5.8	463
FBgn0032021	539	500	509	69	12	5.75	470
FBgn0032022	501	500	489	13	6	2.1666666666666665	488
FBgn0032023	510	500	495	25	7	3.5714285714285716	485
FBgn0032024	513	500	473	53	8	6.625	460
FBgn0032025	531	500	476	86	10	8.6	445
FBgn0032026	550	500	539	61	5	12.2	489
FBgn0032029	526	500	508	44	6	7.333333333333333	482
FBgn0032031	500	500	490	10	2	5	490
FBgn0032032	500	500	488	12	3	4	488
FBgn0032033	501	500	444	58	3	19.333333333333332	443
FBgn0032034	501	500	438	64	2	32	437
FBgn0032036	500	500	494	6	1	6	494
FBgn0032039	543	500	524	62	7	8.857142857142858	481
FBgn0032040	504	500	478	30	5	6	474
FBgn0032042	501	500	278	224	4	56	277
FBgn0032047	514	500	471	57	6	9.5	457
FBgn0032048	501	500	493	9	5	1.8	492
FBgn0032050	511	500	242	280	3	93.33333333333333	231
FBgn0032051	504	500	500	8	4	2	496
FBgn0032052	516	500	512	20	6	3.3333333333333335	496
FBgn0032053	514	500	509	19	5	3.8	495
FBgn0032054	500	500	498	2	1	2	498
FBgn0032055	508	500	508	8	2	4	500
FBgn0032057	513	500	484	42	8	5.25	471
FBgn0032059	501	500	480	22	4	5.5	479
FBgn0032065	500	500	494	6	5	1.2	494
FBgn0032066	477	464	477	13	1	13	464
FBgn0032067	513	500	509	17	4	4.25	496
FBgn0032068	508	500	502	14	4	3.5	494
FBgn0032069	508	500	507	9	2	4.5	499
FBgn0032074	504	500	471	37	5	7.4	467
FBgn0032075	512	500	499	25	5	5	487
FBgn0032077	502	500	488	16	3	5.333333333333333	486
FBgn0032078	504	500	462	46	11	4.181818181818182	458
FBgn0032079	514	500	496	32	4	8	482
FBgn0032080	502	500	489	15	4	3.75	487
FBgn0032082	514	500	504	24	6	4	490
FBgn0032083	507	500	503	11	3	3.6666666666666665	496
FBgn0032085	511	500	401	121	5	24.2	390
FBgn0032086	504	500	478	30	8	3.75	474
FBgn0032087	522	500	508	36	6	6	486
FBgn0032088	507	500	487	27	5	5.4	480
FBgn0032089	512	500	494	30	7	4.285714285714286	482
FBgn0032094	538	500	508	68	6	11.333333333333334	470
FBgn0032095	500	500	487	13	4	3.25	487
FBgn0032096	500	500	499	1	1	1	499
FBgn0032100	500	500	340	160	1	160	340
FBgn0032101	510	500	506	14	6	2.3333333333333335	496
FBgn0032105	564	500	538	90	12	7.5	474
FBgn0032110	500	500	497	3	1	3	497
FBgn0032111	527	500	519	35	5	7	492
FBgn0032116	500	500	488	12	4	3	488
FBgn0032117	505	500	476	34	7	4.857142857142857	471
FBgn0032119	494	483	482	23	8	2.875	471
FBgn0032120	520	500	514	26	6	4.333333333333333	494
FBgn0032123	504	500	326	182	2	91	322
FBgn0032124	513	500	512	14	5	2.8	499
FBgn0032125	555	500	522	88	9	9.777777777777779	467
FBgn0032126	501	500	490	12	3	4	489
FBgn0032127	506	500	502	10	3	3.3333333333333335	496
FBgn0032129	512	500	502	22	3	7.333333333333333	490
FBgn0032130	535	500	534	36	3	12	499
FBgn0032131	500	500	496	4	3	1.3333333333333333	496
FBgn0032132	501	500	492	10	3	3.3333333333333335	491
FBgn0032135	521	500	510	32	3	10.666666666666666	489
FBgn0032136	508	500	504	12	5	2.4	496
FBgn0032138	532	500	518	46	5	9.2	486
FBgn0032139	506	500	484	28	2	14	478
FBgn0032140	525	500	503	47	8	5.875	478
FBgn0032143	500	500	500	0	0	NA	500
FBgn0032144	509	500	507	11	5	2.2	498
FBgn0032147	503	500	474	32	7	4.571428571428571	471
FBgn0032150	519	500	502	36	8	4.5	483
FBgn0032151	502	500	476	28	5	5.6	474
FBgn0032153	500	500	485	15	2	7.5	485
FBgn0032154	400	358	391	51	4	12.75	349
FBgn0032156	506	500	501	11	4	2.75	495
FBgn0032157	514	500	493	35	6	5.833333333333333	479
FBgn0032160	535	500	499	71	9	7.888888888888889	464
FBgn0032163	500	500	493	7	4	1.75	493
FBgn0032167	521	500	500	42	9	4.666666666666667	479
FBgn0032168	518	500	497	39	7	5.571428571428571	479
FBgn0032169	502	500	484	20	5	4	482
FBgn0032170	500	500	500	0	0	NA	500
FBgn0032171	500	500	500	0	0	NA	500
FBgn0032172	500	500	475	25	7	3.5714285714285716	475
FBgn0032175	501	500	489	13	3	4.333333333333333	488
FBgn0032176	519	500	515	23	3	7.666666666666667	496
FBgn0032178	526	500	485	67	7	9.571428571428571	459
FBgn0032187	509	500	469	49	8	6.125	460
FBgn0032188	501	500	465	37	7	5.285714285714286	464
FBgn0032189	501	500	501	1	1	1	500
FBgn0032191	358	349	358	9	2	4.5	349
FBgn0032194	512	500	439	85	6	14.166666666666666	427
FBgn0032196	509	500	485	33	3	11	476
FBgn0032197	502	500	235	269	3	89.66666666666667	233
FBgn0032198	541	500	500	82	15	5.466666666666667	459
FBgn0032200	500	500	132	368	2	184	132
FBgn0032202	516	500	486	46	10	4.6	470
FBgn0032205	460	445	409	66	8	8.25	394
FBgn0032209	524	500	494	54	8	6.75	470
FBgn0032211	541	500	537	45	8	5.625	496
FBgn0032216	500	500	488	12	3	4	488
FBgn0032217	500	500	488	12	3	4	488
FBgn0032218	502	500	502	2	1	2	500
FBgn0032219	526	500	501	51	8	6.375	475
FBgn0032221	509	500	503	15	4	3.75	494
FBgn0032222	507	500	492	22	4	5.5	485
FBgn0032223	501	500	146	356	2	178	145
FBgn0032225	409	400	408	10	2	5	399
FBgn0032228	500	500	500	0	0	NA	500
FBgn0032229	510	500	469	51	10	5.1	459
FBgn0032230	597	500	584	110	7	15.714285714285714	487
FBgn0032231	500	500	500	0	0	NA	500
FBgn0032233	516	500	513	19	3	6.333333333333333	497
FBgn0032234	500	500	500	0	0	NA	500
FBgn0032235	494	481	488	19	8	2.375	475
FBgn0032236	531	500	517	45	8	5.625	486
FBgn0032242	510	500	497	23	8	2.875	487
FBgn0032243	510	500	499	21	7	3	489
FBgn0032244	506	500	495	17	6	2.8333333333333335	489
FBgn0032246	567	500	556	78	12	6.5	489
FBgn0032247	501	500	495	7	3	2.3333333333333335	494
FBgn0032248	511	500	509	13	4	3.25	498
FBgn0032249	513	500	489	37	4	9.25	476
FBgn0032250	502	500	478	26	3	8.666666666666666	476
FBgn0032252	508	500	417	99	12	8.25	409
FBgn0032253	520	500	496	44	10	4.4	476
FBgn0032256	523	500	467	79	6	13.166666666666666	444
FBgn0032258	517	500	491	43	5	8.6	474
FBgn0032259	506	500	490	22	2	11	484
FBgn0032260	500	500	476	24	3	8	476
FBgn0032262	509	500	491	27	7	3.857142857142857	482
FBgn0032264	540	500	530	50	6	8.333333333333334	490
FBgn0032266	501	500	483	19	3	6.333333333333333	482
FBgn0032269	500	500	486	14	2	7	486
FBgn0032271	500	500	500	0	0	NA	500
FBgn0032280	518	500	508	28	6	4.666666666666667	490
FBgn0032281	510	500	313	207	5	41.4	303
FBgn0032282	504	500	492	16	2	8	488
FBgn0032283	506	500	501	11	5	2.2	495
FBgn0032284	515	500	463	67	7	9.571428571428571	448
FBgn0032285	501	500	460	42	6	7	459
FBgn0032286	500	500	497	3	1	3	497
FBgn0032287	506	500	465	47	6	7.833333333333333	459
FBgn0032289	530	500	529	31	3	10.333333333333334	499
FBgn0032292	504	500	320	188	2	94	316
FBgn0032293	505	500	321	189	3	63	316
FBgn0032294	519	500	515	23	3	7.666666666666667	496
FBgn0032295	525	500	521	29	4	7.25	496
FBgn0032296	500	500	497	3	2	1.5	497
FBgn0032297	503	500	480	26	3	8.666666666666666	477
FBgn0032299	501	500	499	3	3	1	498
FBgn0032303	537	500	536	38	3	12.666666666666666	499
FBgn0032305	557	500	543	71	11	6.454545454545454	486
FBgn0032311	501	500	478	24	4	6	477
FBgn0032312	514	500	473	55	10	5.5	459
FBgn0032313	502	500	295	209	2	104.5	293
FBgn0032314	512	500	481	43	9	4.777777777777778	469
FBgn0032315	519	500	500	38	8	4.75	481
FBgn0032318	507	500	472	42	8	5.25	465
FBgn0032321	512	500	512	12	1	12	500
FBgn0032322	489	475	463	40	7	5.714285714285714	449
FBgn0032330	507	500	498	16	6	2.6666666666666665	491
FBgn0032331	513	500	460	66	6	11	447
FBgn0032335	506	500	489	23	7	3.2857142857142856	483
FBgn0032336	504	500	486	22	4	5.5	482
FBgn0032337	501	500	486	16	3	5.333333333333333	485
FBgn0032338	536	500	534	38	10	3.8	498
FBgn0032339	511	500	489	33	9	3.6666666666666665	478
FBgn0032341	502	500	502	2	2	1	500
FBgn0032343	531	500	485	77	7	11	454
FBgn0032345	501	500	496	6	2	3	495
FBgn0032346	514	500	511	17	4	4.25	497
FBgn0032348	544	500	535	53	5	10.6	491
FBgn0032350	519	500	505	33	6	5.5	486
FBgn0032354	500	500	464	36	6	6	464
FBgn0032358	503	500	446	60	7	8.571428571428571	443
FBgn0032360	517	500	516	18	3	6	499
FBgn0032362	500	500	204	296	4	74	204
FBgn0032363	545	500	509	81	8	10.125	464
FBgn0032364	546	500	524	68	8	8.5	478
FBgn0032368	503	500	498	8	4	2	495
FBgn0032369	500	500	496	4	2	2	496
FBgn0032370	500	500	499	1	1	1	499
FBgn0032371	500	500	486	14	2	7	486
FBgn0032372	508	500	505	11	3	3.6666666666666665	497
FBgn0032373	504	500	465	43	5	8.6	461
FBgn0032374	546	500	540	52	5	10.4	494
FBgn0032377	535	500	535	35	2	17.5	500
FBgn0032378	519	500	516	22	7	3.142857142857143	497
FBgn0032381	518	500	517	19	4	4.75	499
FBgn0032382	513	500	334	192	4	48	321
FBgn0032385	502	500	502	2	1	2	500
FBgn0032387	541	500	540	42	3	14	499
FBgn0032388	511	500	498	24	4	6	487
FBgn0032390	501	500	500	2	2	1	499
FBgn0032394	552	500	545	59	8	7.375	493
FBgn0032395	522	500	522	22	6	3.6666666666666665	500
FBgn0032398	432	419	410	35	5	7	397
FBgn0032399	500	500	494	6	1	6	494
FBgn0032400	501	500	501	1	1	1	500
FBgn0032401	516	500	488	44	10	4.4	472
FBgn0032402	516	500	488	44	10	4.4	472
FBgn0032404	501	500	493	9	2	4.5	492
FBgn0032405	500	500	500	0	0	NA	500
FBgn0032406	552	500	541	63	6	10.5	489
FBgn0032407	581	500	552	110	9	12.222222222222221	471
FBgn0032408	501	500	501	1	1	1	500
FBgn0032414	502	500	486	18	3	6	484
FBgn0032415	527	500	303	251	6	41.833333333333336	276
FBgn0032416	528	500	506	50	8	6.25	478
FBgn0032419	500	500	493	7	3	2.3333333333333335	493
FBgn0032420	516	500	352	180	7	25.714285714285715	336
FBgn0032422	500	500	439	61	7	8.714285714285714	439
FBgn0032428	536	500	520	52	7	7.428571428571429	484
FBgn0032429	500	500	208	292	3	97.33333333333333	208
FBgn0032430	501	500	321	181	4	45.25	320
FBgn0032431	525	500	520	30	5	6	495
FBgn0032433	486	478	473	21	4	5.25	465
FBgn0032434	527	500	494	60	9	6.666666666666667	467
FBgn0032435	523	500	493	53	7	7.571428571428571	470
FBgn0032436	521	500	399	143	10	14.3	378
FBgn0032437	512	500	183	341	4	85.25	171
FBgn0032439	500	500	480	20	3	6.666666666666667	480
FBgn0032442	516	500	512	20	7	2.857142857142857	496
FBgn0032444	500	500	488	12	2	6	488
FBgn0032445	500	500	499	1	1	1	499
FBgn0032446	501	500	501	1	1	1	500
FBgn0032447	500	500	497	3	1	3	497
FBgn0032448	500	500	500	0	0	NA	500
FBgn0032449	525	500	425	125	5	25	400
FBgn0032450	524	500	523	25	3	8.333333333333334	499
FBgn0032451	524	500	523	25	3	8.333333333333334	499
FBgn0032452	500	500	500	0	0	NA	500
FBgn0032453	500	500	469	31	3	10.333333333333334	469
FBgn0032456	516	500	458	74	13	5.6923076923076925	442
FBgn0032457	501	500	497	5	4	1.25	496
FBgn0032462	517	500	484	50	8	6.25	467
FBgn0032464	529	500	523	35	8	4.375	494
FBgn0032465	500	500	466	34	1	34	466
FBgn0032470	500	500	488	12	2	6	488
FBgn0032471	500	500	391	109	2	54.5	391
FBgn0032472	453	403	423	80	7	11.428571428571429	373
FBgn0032474	500	500	497	3	1	3	497
FBgn0032475	521	500	521	21	2	10.5	500
FBgn0032477	444	433	440	15	2	7.5	429
FBgn0032479	501	500	497	5	4	1.25	496
FBgn0032480	500	500	494	6	4	1.5	494
FBgn0032481	535	500	487	83	8	10.375	452
FBgn0032482	535	500	487	83	8	10.375	452
FBgn0032485	517	500	517	17	1	17	500
FBgn0032486	504	500	489	19	4	4.75	485
FBgn0032487	501	500	487	15	3	5	486
FBgn0032488	500	500	486	14	2	7	486
FBgn0032489	500	500	487	13	1	13	487
FBgn0032490	501	500	486	16	4	4	485
FBgn0032491	500	500	487	13	1	13	487
FBgn0032492	506	500	402	110	6	18.333333333333332	396
FBgn0032493	502	500	488	16	3	5.333333333333333	486
FBgn0032494	502	500	502	2	1	2	500
FBgn0032495	558	500	537	79	8	9.875	479
FBgn0032503	500	500	498	2	2	1	498
FBgn0032505	512	500	483	41	7	5.857142857142857	471
FBgn0032506	558	500	530	86	15	5.733333333333333	472
FBgn0032507	542	500	523	61	5	12.2	481
FBgn0032509	510	500	493	27	8	3.375	483
FBgn0032511	400	393	388	19	6	3.1666666666666665	381
FBgn0032512	503	500	488	18	5	3.6	485
FBgn0032513	513	500	504	22	4	5.5	491
FBgn0032514	504	500	460	48	6	8	456
FBgn0032515	499	470	390	138	4	34.5	361
FBgn0032516	503	500	490	16	5	3.2	487
FBgn0032517	501	500	499	3	2	1.5	498
FBgn0032518	393	391	382	13	3	4.333333333333333	380
FBgn0032521	567	500	547	87	7	12.428571428571429	480
FBgn0032522	506	500	482	30	7	4.285714285714286	476
FBgn0032523	500	500	490	10	2	5	490
FBgn0032524	508	500	477	39	7	5.571428571428571	469
FBgn0032536	502	500	490	14	2	7	488
FBgn0032538	500	500	477	23	2	11.5	477
FBgn0032549	530	500	521	39	6	6.5	491
FBgn0032553	500	500	490	10	3	3.3333333333333335	490
FBgn0032554	503	500	486	20	4	5	483
FBgn0032563	528	500	514	42	4	10.5	486
FBgn0032577	510	500	489	31	6	5.166666666666667	479
FBgn0032585	545	500	480	110	5	22	435
FBgn0032586	500	500	241	259	1	259	241
FBgn0032587	531	500	530	32	5	6.4	499
FBgn0032588	500	500	499	1	1	1	499
FBgn0032593	511	500	509	13	3	4.333333333333333	498
FBgn0032596	502	500	465	39	7	5.571428571428571	463
FBgn0032597	502	500	458	46	9	5.111111111111111	456
FBgn0032598	504	500	485	23	4	5.75	481
FBgn0032600	539	500	531	47	6	7.833333333333333	492
FBgn0032601	503	500	499	7	2	3.5	496
FBgn0032602	519	500	507	31	5	6.2	488
FBgn0032603	521	500	485	57	7	8.142857142857142	464
FBgn0032612	501	500	457	45	4	11.25	456
FBgn0032614	463	428	446	52	9	5.777777777777778	411
FBgn0032615	508	500	480	36	7	5.142857142857143	472
FBgn0032624	506	500	418	94	5	18.8	412
FBgn0032625	512	500	491	33	4	8.25	479
FBgn0032626	500	500	491	9	4	2.25	491
FBgn0032629	532	500	521	43	7	6.142857142857143	489
FBgn0032631	534	500	529	39	5	7.8	495
FBgn0032632	501	500	488	14	6	2.3333333333333335	487
FBgn0032633	528	500	478	78	7	11.142857142857142	450
FBgn0032634	508	500	502	14	7	2	494
FBgn0032635	507	500	503	11	4	2.75	496
FBgn0032636	502	500	269	235	2	117.5	267
FBgn0032637	522	500	379	165	10	16.5	357
FBgn0032638	500	500	175	325	3	108.33333333333333	175
FBgn0032640	525	500	421	129	15	8.6	396
FBgn0032642	514	500	514	14	2	7	500
FBgn0032643	536	500	528	44	6	7.333333333333333	492
FBgn0032644	503	500	467	39	3	13	464
FBgn0032645	561	500	545	77	8	9.625	484
FBgn0032646	515	500	511	19	2	9.5	496
FBgn0032647	500	500	495	5	1	5	495
FBgn0032648	350	344	306	50	8	6.25	300
FBgn0032649	506	500	392	120	5	24	386
FBgn0032651	501	500	477	25	4	6.25	476
FBgn0032652	500	500	480	20	1	20	480
FBgn0032654	516	500	503	29	6	4.833333333333333	487
FBgn0032656	579	500	566	92	9	10.222222222222221	487
FBgn0032658	537	500	527	47	7	6.714285714285714	490
FBgn0032660	500	500	28	472	2	236	28
FBgn0032664	501	500	498	4	3	1.3333333333333333	497
FBgn0032666	509	500	496	22	4	5.5	487
FBgn0032668	540	500	356	224	6	37.333333333333336	316
FBgn0032669	441	440	399	43	5	8.6	398
FBgn0032677	508	500	467	49	6	8.166666666666666	459
FBgn0032680	500	500	497	3	1	3	497
FBgn0032681	532	500	530	34	5	6.8	498
FBgn0032682	507	500	489	25	7	3.5714285714285716	482
FBgn0032683	501	500	389	113	3	37.666666666666664	388
FBgn0032684	500	500	492	8	1	8	492
FBgn0032685	500	500	495	5	3	1.6666666666666667	495
FBgn0032688	511	500	497	25	4	6.25	486
FBgn0032689	516	500	508	24	10	2.4	492
FBgn0032690	485	474	483	13	5	2.6	472
FBgn0032691	521	500	451	91	7	13	430
FBgn0032692	536	500	521	51	7	7.285714285714286	485
FBgn0032693	500	500	496	4	2	2	496
FBgn0032694	500	500	246	254	6	42.333333333333336	246
FBgn0032699	500	500	495	5	2	2.5	495
FBgn0032700	507	500	505	9	4	2.25	498
FBgn0032701	506	500	506	6	3	2	500
FBgn0032702	518	500	492	44	12	3.6666666666666665	474
FBgn0032703	512	500	483	41	11	3.727272727272727	471
FBgn0032704	519	500	483	55	7	7.857142857142857	464
FBgn0032705	519	500	513	25	3	8.333333333333334	494
FBgn0032706	518	500	498	38	7	5.428571428571429	480
FBgn0032707	500	500	499	1	1	1	499
FBgn0032709	509	500	465	53	8	6.625	456
FBgn0032713	531	500	514	48	8	6	483
FBgn0032715	500	500	496	4	1	4	496
FBgn0032719	518	500	475	61	12	5.083333333333333	457
FBgn0032723	508	500	499	17	4	4.25	491
FBgn0032724	509	500	508	10	3	3.3333333333333335	499
FBgn0032725	512	500	487	37	6	6.166666666666667	475
FBgn0032726	519	500	514	24	3	8	495
FBgn0032727	517	500	515	19	5	3.8	498
FBgn0032728	521	500	513	29	4	7.25	492
FBgn0032729	501	500	478	24	3	8	477
FBgn0032730	505	500	493	17	2	8.5	488
FBgn0032731	524	500	518	30	4	7.5	494
FBgn0032732	524	500	515	33	5	6.6	491
FBgn0032733	509	500	508	10	2	5	499
FBgn0032734	500	500	499	1	1	1	499
FBgn0032740	514	500	455	73	6	12.166666666666666	441
FBgn0032741	502	500	499	5	2	2.5	497
FBgn0032744	507	500	501	13	4	3.25	494
FBgn0032746	500	500	447	53	7	7.571428571428571	447
FBgn0032748	482	478	466	20	6	3.3333333333333335	462
FBgn0032749	521	500	462	80	7	11.428571428571429	441
FBgn0032752	505	500	481	29	3	9.666666666666666	476
FBgn0032753	500	500	457	43	5	8.6	457
FBgn0032754	507	500	499	15	5	3	492
FBgn0032769	501	500	343	159	2	79.5	342
FBgn0032770	550	500	493	107	11	9.727272727272727	443
FBgn0032771	509	500	500	18	5	3.6	491
FBgn0032772	501	500	498	4	3	1.3333333333333333	497
FBgn0032773	500	500	446	54	2	27	446
FBgn0032774	529	500	508	50	8	6.25	479
FBgn0032781	500	500	467	33	6	5.5	467
FBgn0032783	520	500	520	20	2	10	500
FBgn0032785	501	500	476	26	8	3.25	475
FBgn0032787	502	500	501	3	2	1.5	499
FBgn0032788	502	500	501	3	2	1.5	499
FBgn0032789	504	500	496	12	4	3	492
FBgn0032790	532	500	498	66	6	11	466
FBgn0032791	503	500	476	30	3	10	473
FBgn0032793	509	500	509	9	2	4.5	500
FBgn0032796	406	394	395	23	3	7.666666666666667	383
FBgn0032799	511	500	494	28	8	3.5	483
FBgn0032800	511	500	490	32	10	3.2	479
FBgn0032801	524	500	465	83	14	5.928571428571429	441
FBgn0032804	507	500	476	38	4	9.5	469
FBgn0032805	500	500	496	4	3	1.3333333333333333	496
FBgn0032809	500	500	489	11	2	5.5	489
FBgn0032811	503	500	497	9	4	2.25	494
FBgn0032812	515	500	502	28	8	3.5	487
FBgn0032814	500	500	484	16	2	8	484
FBgn0032815	501	500	501	1	1	1	500
FBgn0032816	500	500	500	0	0	NA	500
FBgn0032818	500	500	497	3	1	3	497
FBgn0032819	500	500	497	3	1	3	497
FBgn0032820	517	500	515	19	6	3.1666666666666665	498
FBgn0032821	525	500	511	39	6	6.5	486
FBgn0032822	500	500	488	12	3	4	488
FBgn0032827	502	500	493	11	7	1.5714285714285714	491
FBgn0032833	500	500	450	50	4	12.5	450
FBgn0032834	500	500	500	0	0	NA	500
FBgn0032835	502	500	499	5	3	1.6666666666666667	497
FBgn0032836	404	404	350	54	2	27	350
FBgn0032840	502	500	447	57	8	7.125	445
FBgn0032843	500	500	487	13	2	6.5	487
FBgn0032845	502	500	446	58	5	11.6	444
FBgn0032846	500	500	461	39	6	6.5	461
FBgn0032847	507	500	500	14	3	4.666666666666667	493
FBgn0032848	500	500	496	4	1	4	496
FBgn0032849	500	500	478	22	3	7.333333333333333	478
FBgn0032850	522	500	500	44	6	7.333333333333333	478
FBgn0032851	506	500	241	271	6	45.166666666666664	235
FBgn0032853	526	500	509	43	5	8.6	483
FBgn0032856	500	500	497	3	2	1.5	497
FBgn0032857	484	467	464	37	4	9.25	447
FBgn0032858	513	500	430	96	4	24	417
FBgn0032860	526	500	515	37	7	5.285714285714286	489
FBgn0032867	521	500	490	52	5	10.4	469
FBgn0032868	500	500	180	320	3	106.66666666666667	180
FBgn0032869	400	400	385	15	2	7.5	385
FBgn0032870	500	500	496	4	2	2	496
FBgn0032873	502	500	489	15	5	3	487
FBgn0032876	504	500	493	15	6	2.5	489
FBgn0032877	504	500	495	13	5	2.6	491
FBgn0032878	508	500	452	64	7	9.142857142857142	444
FBgn0032879	501	500	496	6	4	1.5	495
FBgn0032881	524	500	504	44	6	7.333333333333333	480
FBgn0032882	537	500	529	45	7	6.428571428571429	492
FBgn0032883	502	500	462	42	3	14	460
FBgn0032884	514	500	514	14	2	7	500
FBgn0032888	558	500	536	80	8	10	478
FBgn0032889	522	500	498	46	6	7.666666666666667	476
FBgn0032894	516	500	476	56	4	14	460
FBgn0032895	501	500	454	48	7	6.857142857142857	453
FBgn0032896	512	500	490	34	8	4.25	478
FBgn0032897	510	500	480	40	6	6.666666666666667	470
FBgn0032900	503	500	483	23	3	7.666666666666667	480
FBgn0032908	509	500	478	40	4	10	469
FBgn0032911	504	500	497	11	2	5.5	493
FBgn0032914	391	391	276	115	1	115	276
FBgn0032916	502	500	465	39	7	5.571428571428571	463
FBgn0032921	503	500	503	3	1	3	500
FBgn0032922	525	500	501	49	5	9.8	476
FBgn0032923	500	500	433	67	5	13.4	433
FBgn0032924	500	500	60	440	1	440	60
FBgn0032925	527	500	208	346	4	86.5	181
FBgn0032935	560	500	513	107	16	6.6875	453
FBgn0032938	534	500	494	74	7	10.571428571428571	460
FBgn0032940	513	500	352	174	5	34.8	339
FBgn0032945	535	500	426	144	7	20.571428571428573	391
FBgn0032946	522	500	463	81	12	6.75	441
FBgn0032956	485	485	213	272	3	90.66666666666667	213
FBgn0032957	503	500	458	48	8	6	455
FBgn0032965	508	500	471	45	7	6.428571428571429	463
FBgn0032966	510	500	332	188	5	37.6	322
FBgn0032967	506	500	473	39	5	7.8	467
FBgn0032968	500	500	478	22	7	3.142857142857143	478
FBgn0032969	507	500	470	44	10	4.4	463
FBgn0032971	525	500	472	78	9	8.666666666666666	447
FBgn0032973	519	500	452	86	15	5.733333333333333	433
FBgn0032981	507	500	310	204	3	68	303
FBgn0032986	501	500	463	39	6	6.5	462
FBgn0032988	544	500	371	217	8	27.125	327
FBgn0033005	500	500	106	394	4	98.5	106
FBgn0033010	500	500	148	352	1	352	148
FBgn0033019	500	500	79	421	2	210.5	79
FBgn0033027	506	500	474	38	7	5.428571428571429	468
FBgn0033033	503	500	489	17	4	4.25	486
FBgn0033038	510	500	161	359	2	179.5	151
FBgn0033041	500	500	471	29	2	14.5	471
FBgn0033043	502	500	499	5	3	1.6666666666666667	497
FBgn0033047	515	500	312	218	3	72.66666666666667	297
FBgn0033048	529	500	395	163	4	40.75	366
FBgn0033051	583	500	567	99	12	8.25	484
FBgn0033052	516	500	511	21	6	3.5	495
FBgn0033054	516	500	498	34	7	4.857142857142857	482
FBgn0033055	520	500	429	111	7	15.857142857142858	409
FBgn0033056	502	500	497	7	4	1.75	495
FBgn0033058	500	500	485	15	2	7.5	485
FBgn0033061	504	500	498	10	3	3.3333333333333335	494
FBgn0033063	525	500	504	46	8	5.75	479
FBgn0033067	502	500	501	3	3	1	499
FBgn0033069	500	500	254	246	6	41	254
FBgn0033072	504	500	464	44	6	7.333333333333333	460
FBgn0033076	500	500	495	5	2	2.5	495
FBgn0033079	500	500	474	26	4	6.5	474
FBgn0033081	505	500	256	254	5	50.8	251
FBgn0033085	501	500	500	2	2	1	499
FBgn0033087	508	500	507	9	4	2.25	499
FBgn0033088	512	500	502	22	7	3.142857142857143	490
FBgn0033089	511	500	444	78	13	6	433
FBgn0033093	509	500	502	16	5	3.2	493
FBgn0033096	501	500	294	208	2	104	293
FBgn0033097	507	500	499	15	3	5	492
FBgn0033100	500	500	493	7	2	3.5	493
FBgn0033101	516	500	362	170	6	28.333333333333332	346
FBgn0033108	510	500	500	20	2	10	490
FBgn0033112	514	500	500	28	3	9.333333333333334	486
FBgn0033113	528	500	528	28	2	14	500
FBgn0033117	500	500	500	0	0	NA	500
FBgn0033124	423	419	417	10	3	3.3333333333333335	413
FBgn0033128	500	500	457	43	5	8.6	457
FBgn0033129	510	500	504	16	3	5.333333333333333	494
FBgn0033130	425	421	423	6	2	3	419
FBgn0033131	500	500	174	326	3	108.66666666666667	174
FBgn0033134	528	500	497	59	7	8.428571428571429	469
FBgn0033135	503	500	502	4	3	1.3333333333333333	499
FBgn0033136	527	500	493	61	8	7.625	466
FBgn0033137	501	500	478	24	4	6	477
FBgn0033138	500	500	490	10	3	3.3333333333333335	490
FBgn0033139	514	500	486	42	8	5.25	472
FBgn0033140	504	500	504	4	1	4	500
FBgn0033141	500	500	485	15	2	7.5	485
FBgn0033145	506	500	493	19	5	3.8	487
FBgn0033153	500	500	499	1	1	1	499
FBgn0033154	515	500	515	15	3	5	500
FBgn0033155	500	500	499	1	1	1	499
FBgn0033158	500	500	500	0	0	NA	500
FBgn0033159	500	500	493	7	2	3.5	493
FBgn0033160	504	500	497	11	3	3.6666666666666665	493
FBgn0033164	569	500	523	115	9	12.777777777777779	454
FBgn0033165	425	414	373	63	7	9	362
FBgn0033166	505	500	458	52	7	7.428571428571429	453
FBgn0033167	504	500	452	56	5	11.2	448
FBgn0033168	520	500	506	34	5	6.8	486
FBgn0033169	504	500	140	368	2	184	136
FBgn0033174	534	500	473	95	10	9.5	439
FBgn0033177	501	500	501	1	1	1	500
FBgn0033178	501	500	479	23	6	3.8333333333333335	478
FBgn0033179	511	500	509	13	3	4.333333333333333	498
FBgn0033184	446	434	422	36	8	4.5	410
FBgn0033186	514	500	504	24	8	3	490
FBgn0033187	514	500	498	30	10	3	484
FBgn0033191	510	500	490	30	3	10	480
FBgn0033192	510	500	490	30	3	10	480
FBgn0033194	500	500	500	0	0	NA	500
FBgn0033195	506	500	505	7	2	3.5	499
FBgn0033196	500	500	471	29	4	7.25	471
FBgn0033199	500	500	500	0	0	NA	500
FBgn0033202	555	500	552	58	6	9.666666666666666	497
FBgn0033203	555	500	551	59	7	8.428571428571429	496
FBgn0033204	504	500	243	265	5	53	239
FBgn0033205	550	500	507	93	8	11.625	457
FBgn0033207	500	500	489	11	2	5.5	489
FBgn0033208	500	500	499	1	1	1	499
FBgn0033209	503	500	501	5	2	2.5	498
FBgn0033210	506	500	504	8	2	4	498
FBgn0033212	500	500	490	10	1	10	490
FBgn0033214	543	500	524	62	5	12.4	481
FBgn0033215	500	500	454	46	3	15.333333333333334	454
FBgn0033216	501	500	477	25	5	5	476
FBgn0033221	500	500	486	14	4	3.5	486
FBgn0033222	490	479	451	50	9	5.555555555555555	440
FBgn0033224	505	500	504	6	3	2	499
FBgn0033225	542	500	524	60	11	5.454545454545454	482
FBgn0033226	542	500	533	51	10	5.1	491
FBgn0033232	539	500	519	59	7	8.428571428571429	480
FBgn0033234	509	500	504	14	4	3.5	495
FBgn0033236	518	500	453	83	6	13.833333333333334	435
FBgn0033240	519	500	506	32	7	4.571428571428571	487
FBgn0033241	369	365	238	135	6	22.5	234
FBgn0033243	501	500	501	1	1	1	500
FBgn0033244	550	500	475	125	10	12.5	425
FBgn0033247	507	500	502	12	4	3	495
FBgn0033249	518	500	501	35	6	5.833333333333333	483
FBgn0033250	515	500	404	126	4	31.5	389
FBgn0033252	511	500	508	14	4	3.5	497
FBgn0033257	599	500	581	117	7	16.714285714285715	482
FBgn0033258	500	500	491	9	5	1.8	491
FBgn0033259	500	500	479	21	4	5.25	479
FBgn0033260	520	500	519	21	2	10.5	499
FBgn0033261	500	500	500	0	0	NA	500
FBgn0033264	500	500	500	0	0	NA	500
FBgn0033265	503	500	502	4	2	2	499
FBgn0033266	510	500	509	11	3	3.6666666666666665	499
FBgn0033268	541	500	485	97	11	8.818181818181818	444
FBgn0033271	337	337	258	79	3	26.333333333333332	258
FBgn0033272	501	500	177	325	3	108.33333333333333	176
FBgn0033275	500	500	488	12	2	6	488
FBgn0033277	507	500	420	94	3	31.333333333333332	413
FBgn0033279	501	500	450	52	5	10.4	449
FBgn0033285	500	500	467	33	4	8.25	467
FBgn0033286	504	500	346	162	6	27	342
FBgn0033289	500	500	494	6	1	6	494
FBgn0033292	522	500	506	38	8	4.75	484
FBgn0033294	501	500	488	14	3	4.666666666666667	487
FBgn0033296	500	500	492	8	1	8	492
FBgn0033297	500	500	492	8	1	8	492
FBgn0033302	506	500	490	22	4	5.5	484
FBgn0033303	514	500	375	153	10	15.3	361
FBgn0033307	500	500	493	7	2	3.5	493
FBgn0033308	512	500	502	22	3	7.333333333333333	490
FBgn0033309	532	500	171	393	2	196.5	139
FBgn0033312	508	500	452	64	9	7.111111111111111	444
FBgn0033313	508	500	453	63	8	7.875	445
FBgn0033315	522	500	447	97	6	16.166666666666668	425
FBgn0033317	515	500	323	207	5	41.4	308
FBgn0033322	500	500	500	0	0	NA	500
FBgn0033323	500	500	489	11	1	11	489
FBgn0033326	500	500	480	20	3	6.666666666666667	480
FBgn0033327	500	500	486	14	2	7	486
FBgn0033330	500	500	498	2	1	2	498
FBgn0033337	547	500	517	77	11	7	470
FBgn0033339	369	366	332	40	5	8	329
FBgn0033340	500	500	500	0	0	NA	500
FBgn0033341	504	500	489	19	4	4.75	485
FBgn0033344	500	500	496	4	1	4	496
FBgn0033348	500	500	500	0	0	NA	500
FBgn0033349	500	500	490	10	1	10	490
FBgn0033350	507	500	504	10	4	2.5	497
FBgn0033351	500	500	500	0	0	NA	500
FBgn0033352	500	500	499	1	1	1	499
FBgn0033353	511	500	503	19	5	3.8	492
FBgn0033355	500	500	164	336	2	168	164
FBgn0033357	513	500	505	21	5	4.2	492
FBgn0033358	500	500	484	16	3	5.333333333333333	484
FBgn0033362	500	500	493	7	1	7	493
FBgn0033363	513	500	505	21	4	5.25	492
FBgn0033364	513	500	511	15	3	5	498
FBgn0033365	510	500	402	118	5	23.6	392
FBgn0033367	500	500	496	4	1	4	496
FBgn0033369	500	500	133	367	1	367	133
FBgn0033372	500	500	500	0	0	NA	500
FBgn0033375	500	500	458	42	3	14	458
FBgn0033376	500	500	500	0	0	NA	500
FBgn0033379	515	500	515	15	4	3.75	500
FBgn0033380	515	500	515	15	4	3.75	500
FBgn0033382	509	500	485	33	12	2.75	476
FBgn0033387	502	500	497	7	3	2.3333333333333335	495
FBgn0033388	502	500	490	14	2	7	488
FBgn0033389	505	500	490	20	4	5	485
FBgn0033392	505	500	494	16	4	4	489
FBgn0033395	529	500	502	56	8	7	473
FBgn0033400	500	500	386	114	1	114	386
FBgn0033401	557	500	514	100	7	14.285714285714286	457
FBgn0033402	507	500	500	14	5	2.8	493
FBgn0033404	528	500	520	36	8	4.5	492
FBgn0033405	503	500	371	135	7	19.285714285714285	368
FBgn0033412	500	500	481	19	5	3.8	481
FBgn0033413	500	500	479	21	6	3.5	479
FBgn0033421	500	500	493	7	3	2.3333333333333335	493
FBgn0033422	500	500	475	25	6	4.166666666666667	475
FBgn0033423	511	500	506	16	4	4	495
FBgn0033427	500	500	483	17	2	8.5	483
FBgn0033428	543	500	537	49	7	7	494
FBgn0033431	503	500	502	4	3	1.3333333333333333	499
FBgn0033437	508	500	500	16	2	8	492
FBgn0033438	562	500	554	70	10	7	492
FBgn0033442	500	500	260	240	3	80	260
FBgn0033443	503	500	439	67	5	13.4	436
FBgn0033446	507	500	490	24	6	4	483
FBgn0033447	500	500	495	5	1	5	495
FBgn0033448	500	500	500	0	0	NA	500
FBgn0033449	500	500	491	9	2	4.5	491
FBgn0033450	529	500	520	38	4	9.5	491
FBgn0033451	529	500	520	38	4	9.5	491
FBgn0033453	508	500	502	14	5	2.8	494
FBgn0033454	512	500	512	12	3	4	500
FBgn0033457	500	500	496	4	3	1.3333333333333333	496
FBgn0033460	521	500	517	25	7	3.5714285714285716	496
FBgn0033461	500	500	497	3	1	3	497
FBgn0033463	549	500	520	78	7	11.142857142857142	471
FBgn0033464	539	500	523	55	8	6.875	484
FBgn0033467	501	500	491	11	4	2.75	490
FBgn0033468	507	500	199	315	5	63	192
FBgn0033469	501	500	458	44	3	14.666666666666666	457
FBgn0033471	501	500	468	34	5	6.8	467
FBgn0033473	505	500	288	222	4	55.5	283
FBgn0033474	501	500	476	26	6	4.333333333333333	475
FBgn0033475	501	500	484	18	4	4.5	483
FBgn0033476	532	500	260	304	6	50.666666666666664	228
FBgn0033479	543	500	526	60	8	7.5	483
FBgn0033480	520	500	482	58	4	14.5	462
FBgn0033481	502	500	502	2	1	2	500
FBgn0033482	542	500	529	55	10	5.5	487
FBgn0033483	511	500	472	50	5	10	461
FBgn0033484	509	500	492	26	6	4.333333333333333	483
FBgn0033485	500	500	499	1	1	1	499
FBgn0033486	500	500	500	0	0	NA	500
FBgn0033490	500	500	497	3	2	1.5	497
FBgn0033494	500	500	473	27	3	9	473
FBgn0033498	512	500	461	63	5	12.6	449
FBgn0033499	535	500	518	52	7	7.428571428571429	483
FBgn0033501	515	500	507	23	4	5.75	492
FBgn0033502	523	500	507	39	7	5.571428571428571	484
FBgn0033507	501	500	284	218	3	72.66666666666667	283
FBgn0033508	532	500	531	33	2	16.5	499
FBgn0033523	534	500	492	76	10	7.6	458
FBgn0033524	504	500	498	10	3	3.3333333333333335	494
FBgn0033526	501	500	500	2	2	1	499
FBgn0033527	500	500	500	0	0	NA	500
FBgn0033528	500	500	499	1	1	1	499
FBgn0033529	505	500	502	8	2	4	497
FBgn0033538	509	500	489	29	5	5.8	480
FBgn0033539	505	500	493	17	4	4.25	488
FBgn0033540	505	500	504	6	3	2	499
FBgn0033542	500	500	464	36	4	9	464
FBgn0033543	500	500	496	4	3	1.3333333333333333	496
FBgn0033544	504	500	499	9	6	1.5	495
FBgn0033547	509	500	503	15	6	2.5	494
FBgn0033548	500	500	475	25	3	8.333333333333334	475
FBgn0033549	500	500	440	60	3	20	440
FBgn0033550	501	500	499	3	2	1.5	498
FBgn0033551	500	500	496	4	1	4	496
FBgn0033555	501	500	494	8	2	4	493
FBgn0033556	501	500	499	3	3	1	498
FBgn0033557	500	500	500	0	0	NA	500
FBgn0033558	507	500	480	34	7	4.857142857142857	473
FBgn0033564	501	500	491	11	4	2.75	490
FBgn0033569	521	500	505	37	9	4.111111111111111	484
FBgn0033570	469	446	443	49	8	6.125	420
FBgn0033571	556	500	433	179	11	16.272727272727273	377
FBgn0033572	500	500	478	22	3	7.333333333333333	478
FBgn0033573	501	500	472	30	2	15	471
FBgn0033574	508	500	501	15	7	2.142857142857143	493
FBgn0033578	501	500	495	7	3	2.3333333333333335	494
FBgn0033579	514	500	504	24	8	3	490
FBgn0033580	508	500	486	30	5	6	478
FBgn0033582	502	500	502	2	1	2	500
FBgn0033584	513	500	495	31	6	5.166666666666667	482
FBgn0033587	500	500	500	0	0	NA	500
FBgn0033588	500	500	500	0	0	NA	500
FBgn0033589	505	500	464	46	4	11.5	459
FBgn0033590	501	500	501	1	1	1	500
FBgn0033591	506	500	393	119	2	59.5	387
FBgn0033592	500	500	476	24	4	6	476
FBgn0033593	521	500	502	40	7	5.714285714285714	481
FBgn0033594	501	500	474	28	3	9.333333333333334	473
FBgn0033597	507	500	507	7	1	7	500
FBgn0033598	526	500	515	37	6	6.166666666666667	489
FBgn0033599	500	500	381	119	2	59.5	381
FBgn0033600	504	500	495	13	4	3.25	491
FBgn0033601	504	500	501	7	4	1.75	497
FBgn0033602	500	500	493	7	1	7	493
FBgn0033603	500	500	497	3	1	3	497
FBgn0033605	500	500	500	0	0	NA	500
FBgn0033607	501	500	491	11	3	3.6666666666666665	490
FBgn0033608	501	500	494	8	2	4	493
FBgn0033614	500	500	491	9	4	2.25	491
FBgn0033616	509	500	367	151	6	25.166666666666668	358
FBgn0033623	500	500	500	0	0	NA	500
FBgn0033624	343	342	342	2	2	1	341
FBgn0033627	512	500	508	16	3	5.333333333333333	496
FBgn0033628	504	500	367	141	5	28.2	363
FBgn0033629	502	500	484	20	5	4	482
FBgn0033631	501	500	469	33	6	5.5	468
FBgn0033635	524	500	505	43	6	7.166666666666667	481
FBgn0033636	502	500	478	26	4	6.5	476
FBgn0033638	525	500	510	40	5	8	485
FBgn0033639	500	500	497	3	2	1.5	497
FBgn0033640	516	500	503	29	7	4.142857142857143	487
FBgn0033645	513	500	511	15	5	3	498
FBgn0033648	504	500	499	9	3	3	495
FBgn0033649	512	500	350	174	4	43.5	338
FBgn0033651	518	500	511	25	7	3.5714285714285716	493
FBgn0033652	500	500	500	0	0	NA	500
FBgn0033653	505	500	505	5	1	5	500
FBgn0033654	500	500	328	172	1	172	328
FBgn0033657	458	407	456	53	4	13.25	405
FBgn0033658	500	500	500	0	0	NA	500
FBgn0033659	507	500	186	328	4	82	179
FBgn0033661	533	500	529	37	8	4.625	496
FBgn0033663	501	500	498	4	2	2	497
FBgn0033665	511	500	505	17	4	4.25	494
FBgn0033667	500	500	499	1	1	1	499
FBgn0033668	500	500	487	13	6	2.1666666666666665	487
FBgn0033669	545	500	510	80	6	13.333333333333334	465
FBgn0033672	505	500	489	21	6	3.5	484
FBgn0033673	505	500	495	15	5	3	490
FBgn0033677	500	500	496	4	2	2	496
FBgn0033679	518	500	513	23	6	3.8333333333333335	495
FBgn0033680	508	500	502	14	5	2.8	494
FBgn0033685	500	500	433	67	5	13.4	433
FBgn0033686	540	500	522	58	12	4.833333333333333	482
FBgn0033687	511	500	508	14	4	3.5	497
FBgn0033688	536	500	530	42	10	4.2	494
FBgn0033690	500	500	54	446	2	223	54
FBgn0033696	500	500	487	13	4	3.25	487
FBgn0033697	500	500	489	11	3	3.6666666666666665	489
FBgn0033699	526	500	506	46	7	6.571428571428571	480
FBgn0033701	508	500	409	107	8	13.375	401
FBgn0033702	505	500	496	14	3	4.666666666666667	491
FBgn0033703	520	500	516	24	6	4	496
FBgn0033705	523	500	519	27	5	5.4	496
FBgn0033706	543	500	462	124	7	17.714285714285715	419
FBgn0033708	520	500	499	41	8	5.125	479
FBgn0033710	529	500	516	42	6	7	487
FBgn0033713	500	500	498	2	2	1	498
FBgn0033717	530	500	524	36	3	12	494
FBgn0033720	510	500	493	27	5	5.4	483
FBgn0033723	514	500	500	28	6	4.666666666666667	486
FBgn0033724	503	500	488	18	2	9	485
FBgn0033725	555	500	548	62	5	12.4	493
FBgn0033727	503	500	500	6	4	1.5	497
FBgn0033728	510	500	510	10	2	5	500
FBgn0033729	500	500	474	26	3	8.666666666666666	474
FBgn0033730	501	500	500	2	2	1	499
FBgn0033731	501	500	462	40	4	10	461
FBgn0033732	501	500	495	7	3	2.3333333333333335	494
FBgn0033733	502	500	485	19	4	4.75	483
FBgn0033734	501	500	482	20	4	5	481
FBgn0033736	500	500	499	1	1	1	499
FBgn0033737	502	500	461	43	7	6.142857142857143	459
FBgn0033738	507	500	506	8	2	4	499
FBgn0033739	505	497	502	11	4	2.75	494
FBgn0033740	500	500	500	0	0	NA	500
FBgn0033741	506	500	495	17	7	2.4285714285714284	489
FBgn0033742	376	363	376	13	3	4.333333333333333	363
FBgn0033744	501	500	488	14	3	4.666666666666667	487
FBgn0033749	540	500	535	45	9	5	495
FBgn0033750	543	500	537	49	11	4.454545454545454	494
FBgn0033751	506	500	505	7	2	3.5	499
FBgn0033752	506	500	499	13	2	6.5	493
FBgn0033753	504	500	470	38	6	6.333333333333333	466
FBgn0033756	514	455	487	86	12	7.166666666666667	428
FBgn0033757	505	500	501	9	3	3	496
FBgn0033760	526	500	515	37	5	7.4	489
FBgn0033761	502	500	483	21	5	4.2	481
FBgn0033762	501	500	487	15	3	5	486
FBgn0033763	448	447	445	4	3	1.3333333333333333	444
FBgn0033766	521	500	507	35	2	17.5	486
FBgn0033767	503	500	503	3	1	3	500
FBgn0033769	501	500	258	244	5	48.8	257
FBgn0033770	520	500	505	35	10	3.5	485
FBgn0033773	378	372	377	7	2	3.5	371
FBgn0033774	515	500	497	33	3	11	482
FBgn0033775	504	500	457	51	7	7.285714285714286	453
FBgn0033781	501	500	500	2	2	1	499
FBgn0033783	500	500	498	2	1	2	498
FBgn0033784	517	500	512	22	4	5.5	495
FBgn0033785	517	500	512	22	4	5.5	495
FBgn0033787	510	500	480	40	10	4	470
FBgn0033788	515	500	410	120	7	17.142857142857142	395
FBgn0033789	506	500	502	10	6	1.6666666666666667	496
FBgn0033791	503	500	488	18	4	4.5	485
FBgn0033793	516	500	453	79	8	9.875	437
FBgn0033794	517	500	479	55	9	6.111111111111111	462
FBgn0033799	467	467	406	61	6	10.166666666666666	406
FBgn0033806	517	500	503	31	6	5.166666666666667	486
FBgn0033807	510	500	506	14	5	2.8	496
FBgn0033808	509	500	505	13	5	2.6	496
FBgn0033809	411	398	407	17	4	4.25	394
FBgn0033810	511	500	445	77	6	12.833333333333334	434
FBgn0033812	506	500	482	30	9	3.3333333333333335	476
FBgn0033813	506	500	487	25	8	3.125	481
FBgn0033814	519	500	492	46	14	3.2857142857142856	473
FBgn0033815	518	500	477	59	12	4.916666666666667	459
FBgn0033816	503	500	494	12	3	4	491
FBgn0033817	502	500	501	3	2	1.5	499
FBgn0033820	500	500	424	76	3	25.333333333333332	424
FBgn0033821	500	500	238	262	3	87.33333333333333	238
FBgn0033826	501	500	486	16	2	8	485
FBgn0033827	501	500	459	43	2	21.5	458
FBgn0033828	500	500	496	4	2	2	496
FBgn0033830	537	500	507	67	17	3.9411764705882355	470
FBgn0033834	522	500	507	37	8	4.625	485
FBgn0033842	520	500	520	20	4	5	500
FBgn0033844	522	500	520	24	2	12	498
FBgn0033845	517	500	462	72	8	9	445
FBgn0033846	517	500	516	18	3	6	499
FBgn0033848	502	500	497	7	4	1.75	495
FBgn0033850	509	500	471	47	5	9.4	462
FBgn0033851	508	500	458	58	8	7.25	450
FBgn0033853	500	500	463	37	6	6.166666666666667	463
FBgn0033855	501	500	496	6	4	1.5	495
FBgn0033856	512	500	475	49	8	6.125	463
FBgn0033859	501	500	500	2	2	1	499
FBgn0033861	506	500	496	16	6	2.6666666666666665	490
FBgn0033862	502	500	498	6	3	2	496
FBgn0033864	503	486	498	22	4	5.5	481
FBgn0033865	544	500	461	127	7	18.142857142857142	417
FBgn0033866	518	500	493	43	8	5.375	475
FBgn0033867	510	500	480	40	9	4.444444444444445	470
FBgn0033868	503	500	499	7	2	3.5	496
FBgn0033869	505	500	505	5	2	2.5	500
FBgn0033871	509	500	506	12	5	2.4	497
FBgn0033872	504	500	496	12	6	2	492
FBgn0033873	511	500	511	11	3	3.6666666666666665	500
FBgn0033874	527	500	527	27	3	9	500
FBgn0033875	541	500	502	80	5	16	461
FBgn0033876	518	500	515	21	3	7	497
FBgn0033879	412	405	355	64	7	9.142857142857142	348
FBgn0033880	523	500	518	28	6	4.666666666666667	495
FBgn0033883	501	500	497	5	2	2.5	496
FBgn0033884	500	500	494	6	2	3	494
FBgn0033885	501	500	489	13	5	2.6	488
FBgn0033886	514	500	513	15	3	5	499
FBgn0033887	409	409	378	31	6	5.166666666666667	378
FBgn0033888	522	500	499	45	8	5.625	477
FBgn0033889	385	382	369	19	6	3.1666666666666665	366
FBgn0033890	505	500	503	7	3	2.3333333333333335	498
FBgn0033891	500	500	500	0	0	NA	500
FBgn0033897	500	500	500	0	0	NA	500
FBgn0033899	500	500	486	14	3	4.666666666666667	486
FBgn0033900	513	500	511	15	3	5	498
FBgn0033901	503	500	486	20	4	5	483
FBgn0033902	500	500	494	6	4	1.5	494
FBgn0033903	501	500	481	21	8	2.625	480
FBgn0033906	394	352	376	60	6	10	334
FBgn0033907	501	500	501	1	1	1	500
FBgn0033911	363	363	352	11	4	2.75	352
FBgn0033913	504	500	497	11	4	2.75	493
FBgn0033915	501	500	487	15	4	3.75	486
FBgn0033916	500	500	490	10	2	5	490
FBgn0033917	500	500	480	20	2	10	480
FBgn0033918	589	500	581	97	6	16.166666666666668	492
FBgn0033919	522	500	498	46	5	9.2	476
FBgn0033921	506	500	236	276	6	46	230
FBgn0033924	535	500	520	50	9	5.555555555555555	485
FBgn0033925	593	500	579	107	7	15.285714285714286	486
FBgn0033927	526	500	526	26	4	6.5	500
FBgn0033931	502	500	500	4	3	1.3333333333333333	498
FBgn0033932	503	500	501	5	3	1.6666666666666667	498
FBgn0033933	502	500	498	6	3	2	496
FBgn0033936	503	500	486	20	3	6.666666666666667	483
FBgn0033942	503	500	503	3	2	1.5	500
FBgn0033943	507	500	461	53	6	8.833333333333334	454
FBgn0033945	422	395	377	72	5	14.4	350
FBgn0033948	512	500	510	14	5	2.8	498
FBgn0033950	500	500	458	42	3	14	458
FBgn0033951	517	500	500	34	8	4.25	483
FBgn0033952	506	500	483	29	6	4.833333333333333	477
FBgn0033954	506	500	489	23	5	4.6	483
FBgn0033955	501	500	487	15	4	3.75	486
FBgn0033958	513	500	485	41	8	5.125	472
FBgn0033960	500	500	469	31	3	10.333333333333334	469
FBgn0033961	500	500	483	17	3	5.666666666666667	483
FBgn0033963	502	500	501	3	3	1	499
FBgn0033968	522	500	514	30	4	7.5	492
FBgn0033969	507	500	498	16	5	3.2	491
FBgn0033970	509	500	499	19	4	4.75	490
FBgn0033972	552	500	509	95	10	9.5	457
FBgn0033973	552	500	506	98	11	8.909090909090908	454
FBgn0033979	371	351	360	31	7	4.428571428571429	340
FBgn0033980	503	500	208	298	3	99.33333333333333	205
FBgn0033982	511	500	461	61	10	6.1	450
FBgn0033983	506	500	504	8	2	4	498
FBgn0033984	504	500	486	22	6	3.6666666666666665	482
FBgn0033985	526	500	505	47	5	9.4	479
FBgn0033987	500	500	488	12	2	6	488
FBgn0033989	520	500	495	45	8	5.625	475
FBgn0033990	538	500	506	70	6	11.666666666666666	468
FBgn0033993	504	500	503	5	2	2.5	499
FBgn0033994	500	500	485	15	3	5	485
FBgn0033995	524	500	489	59	7	8.428571428571429	465
FBgn0033996	503	500	493	13	3	4.333333333333333	490
FBgn0033997	500	500	499	1	1	1	499
FBgn0033998	505	500	488	22	8	2.75	483
FBgn0033999	500	500	500	0	0	NA	500
FBgn0034000	500	500	500	0	0	NA	500
FBgn0034001	379	377	194	187	4	46.75	192
FBgn0034005	502	500	493	11	5	2.2	491
FBgn0034008	529	500	510	48	9	5.333333333333333	481
FBgn0034009	502	500	416	88	4	22	414
FBgn0034010	507	500	495	19	5	3.8	488
FBgn0034011	505	500	501	9	6	1.5	496
FBgn0034012	501	500	501	1	1	1	500
FBgn0034013	554	500	525	83	9	9.222222222222221	471
FBgn0034021	513	500	385	141	3	47	372
FBgn0034022	501	500	492	10	3	3.3333333333333335	491
FBgn0034023	500	500	500	0	0	NA	500
FBgn0034025	546	500	528	64	10	6.4	482
FBgn0034029	383	383	379	4	2	2	379
FBgn0034030	524	500	524	24	2	12	500
FBgn0034032	512	500	366	158	6	26.333333333333332	354
FBgn0034035	538	500	522	54	9	6	484
FBgn0034045	500	500	491	9	5	1.8	491
FBgn0034049	500	500	495	5	3	1.6666666666666667	495
FBgn0034050	500	500	494	6	1	6	494
FBgn0034051	502	500	487	17	5	3.4	485
FBgn0034052	500	500	467	33	2	16.5	467
FBgn0034053	507	500	505	9	2	4.5	498
FBgn0034054	501	500	497	5	3	1.6666666666666667	496
FBgn0034058	500	500	499	1	1	1	499
FBgn0034059	501	500	495	7	2	3.5	494
FBgn0034060	502	500	494	10	5	2	492
FBgn0034062	500	500	500	0	0	NA	500
FBgn0034063	500	500	243	257	3	85.66666666666667	243
FBgn0034065	513	500	511	15	5	3	498
FBgn0034066	511	500	393	129	10	12.9	382
FBgn0034067	510	500	367	153	10	15.3	357
FBgn0034068	500	500	494	6	1	6	494
FBgn0034069	500	500	491	9	3	3	491
FBgn0034070	520	500	431	109	6	18.166666666666668	411
FBgn0034072	510	500	506	14	4	3.5	496
FBgn0034073	500	500	500	0	0	NA	500
FBgn0034075	516	500	502	30	7	4.285714285714286	486
FBgn0034076	515	500	512	18	3	6	497
FBgn0034081	507	500	487	27	5	5.4	480
FBgn0034082	545	500	512	78	9	8.666666666666666	467
FBgn0034083	507	500	499	15	4	3.75	492
FBgn0034084	394	380	391	17	4	4.25	377
FBgn0034085	502	500	499	5	4	1.25	497
FBgn0034086	500	500	490	10	3	3.3333333333333335	490
FBgn0034092	512	500	507	17	5	3.4	495
FBgn0034093	500	500	497	3	1	3	497
FBgn0034094	532	500	521	43	10	4.3	489
FBgn0034095	421	418	414	10	3	3.3333333333333335	411
FBgn0034096	500	500	492	8	4	2	492
FBgn0034097	504	500	478	30	6	5	474
FBgn0034099	501	500	479	23	6	3.8333333333333335	478
FBgn0034103	524	500	499	49	11	4.454545454545454	475
FBgn0034104	518	500	509	27	7	3.857142857142857	491
FBgn0034109	510	500	505	15	5	3	495
FBgn0034110	510	500	506	14	5	2.8	496
FBgn0034113	411	394	357	71	8	8.875	340
FBgn0034114	500	500	499	1	1	1	499
FBgn0034117	504	500	503	5	2	2.5	499
FBgn0034118	521	500	520	22	3	7.333333333333333	499
FBgn0034120	500	500	270	230	2	115	270
FBgn0034121	504	500	503	5	3	1.6666666666666667	499
FBgn0034122	505	500	505	5	1	5	500
FBgn0034126	508	500	502	14	5	2.8	494
FBgn0034127	500	500	475	25	5	5	475
FBgn0034128	535	500	531	39	6	6.5	496
FBgn0034129	508	500	493	23	7	3.2857142857142856	485
FBgn0034131	504	500	488	20	7	2.857142857142857	484
FBgn0034132	515	500	505	25	4	6.25	490
FBgn0034135	510	500	493	27	7	3.857142857142857	483
FBgn0034136	502	500	498	6	2	3	496
FBgn0034137	554	500	552	56	6	9.333333333333334	498
FBgn0034139	511	500	412	110	9	12.222222222222221	401
FBgn0034141	448	437	410	49	4	12.25	399
FBgn0034143	504	500	485	23	5	4.6	481
FBgn0034144	505	500	502	8	4	2	497
FBgn0034151	513	500	513	13	2	6.5	500
FBgn0034152	376	376	371	5	2	2.5	371
FBgn0034153	430	395	428	37	4	9.25	393
FBgn0034156	514	500	477	51	7	7.285714285714286	463
FBgn0034157	517	500	513	21	4	5.25	496
FBgn0034158	572	500	437	207	10	20.7	365
FBgn0034159	502	500	501	3	2	1.5	499
FBgn0034160	501	500	472	30	8	3.75	471
FBgn0034166	501	500	500	2	2	1	499
FBgn0034168	517	500	516	18	3	6	499
FBgn0034172	370	362	366	12	4	3	358
FBgn0034173	519	500	505	33	5	6.6	486
FBgn0034176	500	500	497	3	1	3	497
FBgn0034177	500	500	497	3	1	3	497
FBgn0034179	547	500	534	60	7	8.571428571428571	487
FBgn0034180	540	500	531	49	7	7	491
FBgn0034182	422	422	420	2	2	1	420
FBgn0034187	502	500	501	3	3	1	499
FBgn0034191	500	500	499	1	1	1	499
FBgn0034194	511	500	505	17	5	3.4	494
FBgn0034195	519	500	518	20	2	10	499
FBgn0034196	529	500	492	66	7	9.428571428571429	463
FBgn0034197	500	500	500	0	0	NA	500
FBgn0034198	468	465	451	20	5	4	448
FBgn0034200	413	385	409	32	4	8	381
FBgn0034201	500	500	495	5	2	2.5	495
FBgn0034204	500	500	493	7	1	7	493
FBgn0034205	508	500	494	22	5	4.4	486
FBgn0034206	542	500	526	58	7	8.285714285714286	484
FBgn0034210	518	500	492	44	7	6.285714285714286	474
FBgn0034214	519	500	514	24	5	4.8	495
FBgn0034215	519	500	516	22	4	5.5	497
FBgn0034217	508	500	494	22	7	3.142857142857143	486
FBgn0034218	521	500	520	22	4	5.5	499
FBgn0034221	500	500	128	372	2	186	128
FBgn0034223	516	500	505	27	5	5.4	489
FBgn0034224	535	500	470	100	8	12.5	435
FBgn0034225	520	500	481	59	11	5.363636363636363	461
FBgn0034229	511	500	471	51	7	7.285714285714286	460
FBgn0034230	464	461	455	12	6	2	452
FBgn0034231	504	500	504	4	1	4	500
FBgn0034232	500	500	500	0	0	NA	500
FBgn0034237	502	500	484	20	4	5	482
FBgn0034240	500	500	497	3	3	1	497
FBgn0034243	500	500	496	4	1	4	496
FBgn0034245	500	500	490	10	2	5	490
FBgn0034246	552	500	515	89	10	8.9	463
FBgn0034247	500	500	466	34	5	6.8	466
FBgn0034248	378	376	368	12	5	2.4	366
FBgn0034249	501	500	482	20	3	6.666666666666667	481
FBgn0034253	519	500	460	78	6	13	441
FBgn0034258	503	500	499	7	5	1.4	496
FBgn0034259	550	500	546	54	4	13.5	496
FBgn0034261	500	500	484	16	1	16	484
FBgn0034262	505	500	498	12	5	2.4	493
FBgn0034263	502	500	486	18	6	3	484
FBgn0034265	500	500	498	2	1	2	498
FBgn0034270	504	500	479	29	2	14.5	475
FBgn0034271	504	500	478	30	3	10	474
FBgn0034272	512	500	503	21	3	7	491
FBgn0034274	530	500	509	51	5	10.2	479
FBgn0034276	537	500	506	68	5	13.6	469
FBgn0034279	416	415	191	226	2	113	190
FBgn0034281	522	500	463	81	8	10.125	441
FBgn0034282	500	500	499	1	1	1	499
FBgn0034283	500	500	495	5	3	1.6666666666666667	495
FBgn0034286	503	500	481	25	5	5	478
FBgn0034288	509	500	498	20	3	6.666666666666667	489
FBgn0034289	536	500	536	36	3	12	500
FBgn0034290	516	500	489	43	11	3.909090909090909	473
FBgn0034291	503	500	372	134	3	44.666666666666664	369
FBgn0034292	502	500	493	11	4	2.75	491
FBgn0034293	401	383	393	26	3	8.666666666666666	375
FBgn0034294	530	500	513	47	6	7.833333333333333	483
FBgn0034295	500	500	493	7	2	3.5	493
FBgn0034296	516	500	516	16	2	8	500
FBgn0034299	500	500	499	1	1	1	499
FBgn0034300	500	500	499	1	1	1	499
FBgn0034301	515	500	503	27	8	3.375	488
FBgn0034304	538	500	532	44	6	7.333333333333333	494
FBgn0034307	500	500	499	1	1	1	499
FBgn0034308	500	500	494	6	2	3	494
FBgn0034310	501	500	501	1	1	1	500
FBgn0034315	521	500	519	23	5	4.6	498
FBgn0034317	509	500	448	70	6	11.666666666666666	439
FBgn0034321	506	500	480	32	5	6.4	474
FBgn0034326	449	435	428	35	9	3.888888888888889	414
FBgn0034328	539	500	525	53	10	5.3	486
FBgn0034331	516	500	476	56	12	4.666666666666667	460
FBgn0034345	502	500	502	2	2	1	500
FBgn0034346	529	500	522	36	4	9	493
FBgn0034351	503	500	361	145	4	36.25	358
FBgn0034352	504	500	493	15	5	3	489
FBgn0034354	506	500	421	91	10	9.1	415
FBgn0034356	512	500	508	16	5	3.2	496
FBgn0034360	520	500	494	46	4	11.5	474
FBgn0034361	504	500	497	11	5	2.2	493
FBgn0034362	500	500	500	0	0	NA	500
FBgn0034364	500	500	470	30	2	15	470
FBgn0034365	510	500	510	10	1	10	500
FBgn0034366	500	500	439	61	3	20.333333333333332	439
FBgn0034368	510	500	462	58	6	9.666666666666666	452
FBgn0034371	427	426	411	17	3	5.666666666666667	410
FBgn0034379	503	500	484	22	6	3.6666666666666665	481
FBgn0034380	597	500	590	104	15	6.933333333333334	493
FBgn0034381	500	500	496	4	2	2	496
FBgn0034383	500	500	489	11	3	3.6666666666666665	489
FBgn0034387	501	500	488	14	6	2.3333333333333335	487
FBgn0034389	502	500	251	253	3	84.33333333333333	249
FBgn0034390	537	500	507	67	7	9.571428571428571	470
FBgn0034391	500	500	499	1	1	1	499
FBgn0034392	530	500	522	38	8	4.75	492
FBgn0034394	519	500	517	21	3	7	498
FBgn0034396	503	500	493	13	7	1.8571428571428572	490
FBgn0034397	502	500	444	60	6	10	442
FBgn0034398	500	500	85	415	1	415	85
FBgn0034399	500	500	72	428	2	214	72
FBgn0034400	484	463	473	32	4	8	452
FBgn0034401	519	500	515	23	6	3.8333333333333335	496
FBgn0034402	518	500	512	24	5	4.8	494
FBgn0034403	424	417	191	240	6	40	184
FBgn0034406	536	500	300	272	9	30.22222222222222	264
FBgn0034408	500	500	483	17	2	8.5	483
FBgn0034411	505	500	485	25	7	3.5714285714285716	480
FBgn0034413	504	500	485	23	6	3.8333333333333335	481
FBgn0034415	510	500	498	22	3	7.333333333333333	488
FBgn0034416	521	500	517	25	4	6.25	496
FBgn0034417	523	500	523	23	4	5.75	500
FBgn0034418	515	500	503	27	5	5.4	488
FBgn0034419	517	500	514	20	6	3.3333333333333335	497
FBgn0034422	500	500	494	6	3	2	494
FBgn0034423	515	500	477	53	9	5.888888888888889	462
FBgn0034425	531	500	482	80	10	8	451
FBgn0034427	526	500	255	297	3	99	229
FBgn0034429	482	457	452	55	3	18.333333333333332	427
FBgn0034430	507	500	496	18	9	2	489
FBgn0034432	527	500	495	59	9	6.555555555555555	468
FBgn0034433	503	500	492	14	5	2.8	489
FBgn0034435	521	500	501	41	10	4.1	480
FBgn0034436	500	500	499	1	1	1	499
FBgn0034437	504	500	501	7	4	1.75	497
FBgn0034438	521	500	512	30	5	6	491
FBgn0034439	507	500	495	19	6	3.1666666666666665	488
FBgn0034440	503	496	491	19	7	2.7142857142857144	484
FBgn0034441	504	500	487	21	8	2.625	483
FBgn0034443	507	500	500	14	5	2.8	493
FBgn0034447	500	500	120	380	2	190	120
FBgn0034452	507	500	490	24	4	6	483
FBgn0034454	500	500	415	85	2	42.5	415
FBgn0034456	500	500	496	4	1	4	496
FBgn0034458	515	500	511	19	5	3.8	496
FBgn0034459	503	500	499	7	2	3.5	496
FBgn0034460	513	500	506	20	3	6.666666666666667	493
FBgn0034461	518	500	431	105	5	21	413
FBgn0034462	514	500	514	14	1	14	500
FBgn0034464	528	500	396	160	3	53.333333333333336	368
FBgn0034467	511	500	502	20	4	5	491
FBgn0034468	500	500	500	0	0	NA	500
FBgn0034470	501	500	458	44	3	14.666666666666666	457
FBgn0034471	519	500	502	36	3	12	483
FBgn0034473	500	500	494	6	3	2	494
FBgn0034474	504	500	415	93	3	31	411
FBgn0034475	504	500	502	6	3	2	498
FBgn0034476	501	500	483	19	3	6.333333333333333	482
FBgn0034477	516	500	476	56	5	11.2	460
FBgn0034478	500	500	475	25	2	12.5	475
FBgn0034479	500	500	491	9	4	2.25	491
FBgn0034481	502	500	499	5	2	2.5	497
FBgn0034483	504	500	410	98	2	49	406
FBgn0034484	504	500	488	20	6	3.3333333333333335	484
FBgn0034485	378	378	260	118	1	118	260
FBgn0034486	515	500	496	34	5	6.8	481
FBgn0034487	515	500	497	33	4	8.25	482
FBgn0034489	503	500	495	11	4	2.75	492
FBgn0034490	388	375	372	29	7	4.142857142857143	359
FBgn0034491	500	500	468	32	4	8	468
FBgn0034494	502	500	502	2	1	2	500
FBgn0034495	501	500	499	3	2	1.5	498
FBgn0034497	511	500	505	17	4	4.25	494
FBgn0034498	536	500	530	42	6	7	494
FBgn0034499	504	500	504	4	1	4	500
FBgn0034500	509	500	493	25	6	4.166666666666667	484
FBgn0034501	502	500	495	9	5	1.8	493
FBgn0034502	502	500	494	10	6	1.6666666666666667	492
FBgn0034503	551	500	492	110	8	13.75	441
FBgn0034506	523	500	521	25	3	8.333333333333334	498
FBgn0034507	530	500	530	30	4	7.5	500
FBgn0034509	500	500	497	3	2	1.5	497
FBgn0034510	510	500	505	15	6	2.5	495
FBgn0034511	520	500	488	52	10	5.2	468
FBgn0034512	534	500	506	62	7	8.857142857142858	472
FBgn0034520	500	500	496	4	3	1.3333333333333333	496
FBgn0034523	523	500	510	36	8	4.5	487
FBgn0034527	500	500	410	90	3	30	410
FBgn0034528	500	500	497	3	1	3	497
FBgn0034529	500	500	499	1	1	1	499
FBgn0034530	509	500	508	10	2	5	499
FBgn0034532	503	500	489	17	3	5.666666666666667	486
FBgn0034534	501	500	501	1	1	1	500
FBgn0034537	502	500	307	197	5	39.4	305
FBgn0034538	502	500	460	44	6	7.333333333333333	458
FBgn0034539	500	500	497	3	1	3	497
FBgn0034540	500	500	479	21	4	5.25	479
FBgn0034541	501	500	500	2	2	1	499
FBgn0034543	513	500	506	20	3	6.666666666666667	493
FBgn0034546	512	500	504	20	3	6.666666666666667	492
FBgn0034548	502	500	496	8	3	2.6666666666666665	494
FBgn0034551	500	500	494	6	1	6	494
FBgn0034553	528	500	527	29	5	5.8	499
FBgn0034554	500	500	486	14	3	4.666666666666667	486
FBgn0034558	509	500	502	16	3	5.333333333333333	493
FBgn0034560	502	500	499	5	2	2.5	497
FBgn0034563	501	500	499	3	3	1	498
FBgn0034565	522	500	511	33	5	6.6	489
FBgn0034566	500	500	492	8	4	2	492
FBgn0034568	505	500	470	40	5	8	465
FBgn0034569	502	500	257	247	7	35.285714285714285	255
FBgn0034572	501	500	501	1	1	1	500
FBgn0034573	513	500	496	30	9	3.3333333333333335	483
FBgn0034576	509	500	474	44	5	8.8	465
FBgn0034577	503	500	460	46	7	6.571428571428571	457
FBgn0034578	506	500	498	14	3	4.666666666666667	492
FBgn0034579	502	500	492	12	3	4	490
FBgn0034582	501	500	491	11	4	2.75	490
FBgn0034583	504	500	476	32	7	4.571428571428571	472
FBgn0034590	516	500	514	18	2	9	498
FBgn0034592	500	500	486	14	2	7	486
FBgn0034595	504	500	504	4	2	2	500
FBgn0034598	500	500	336	164	2	82	336
FBgn0034601	522	500	517	27	5	5.4	495
FBgn0034602	500	500	492	8	4	2	492
FBgn0034605	503	500	483	23	6	3.8333333333333335	480
FBgn0034606	522	500	511	33	10	3.3	489
FBgn0034611	500	500	492	8	3	2.6666666666666665	492
FBgn0034612	507	500	507	7	4	1.75	500
FBgn0034614	501	500	501	1	1	1	500
FBgn0034617	500	500	497	3	1	3	497
FBgn0034618	513	500	509	17	6	2.8333333333333335	496
FBgn0034622	501	500	473	29	6	4.833333333333333	472
FBgn0034623	500	500	498	2	1	2	498
FBgn0034624	511	500	485	37	4	9.25	474
FBgn0034627	516	500	492	40	4	10	476
FBgn0034628	501	500	496	6	3	2	495
FBgn0034631	503	500	321	185	4	46.25	318
FBgn0034636	518	500	497	39	5	7.8	479
FBgn0034638	501	500	491	11	4	2.75	490
FBgn0034639	506	500	478	34	5	6.8	472
FBgn0034641	504	500	494	14	5	2.8	490
FBgn0034643	500	500	497	3	2	1.5	497
FBgn0034644	510	500	503	17	4	4.25	493
FBgn0034645	509	500	502	16	4	4	493
FBgn0034646	511	500	491	31	6	5.166666666666667	480
FBgn0034647	513	500	505	21	5	4.2	492
FBgn0034650	509	500	505	13	3	4.333333333333333	496
FBgn0034654	469	469	434	35	3	11.666666666666666	434
FBgn0034655	503	500	498	8	4	2	495
FBgn0034657	504	500	498	10	5	2	494
FBgn0034658	500	500	485	15	2	7.5	485
FBgn0034659	506	500	505	7	3	2.3333333333333335	499
FBgn0034660	513	500	500	26	3	8.666666666666666	487
FBgn0034661	507	500	472	42	5	8.4	465
FBgn0034662	513	500	503	23	2	11.5	490
FBgn0034664	501	500	498	4	3	1.3333333333333333	497
FBgn0034665	508	500	478	38	3	12.666666666666666	470
FBgn0034666	500	500	500	0	0	NA	500
FBgn0034667	500	500	495	5	3	1.6666666666666667	495
FBgn0034670	505	500	488	22	4	5.5	483
FBgn0034671	532	500	519	45	7	6.428571428571429	487
FBgn0034674	519	500	510	28	6	4.666666666666667	491
FBgn0034681	500	500	497	3	2	1.5	497
FBgn0034683	518	500	490	46	4	11.5	472
FBgn0034684	500	500	491	9	2	4.5	491
FBgn0034689	517	500	457	77	10	7.7	440
FBgn0034691	501	500	498	4	2	2	497
FBgn0034692	500	500	499	1	1	1	499
FBgn0034693	513	500	502	24	5	4.8	489
FBgn0034694	512	500	502	22	7	3.142857142857143	490
FBgn0034697	517	500	490	44	7	6.285714285714286	473
FBgn0034704	508	500	496	20	5	4	488
FBgn0034705	500	500	469	31	3	10.333333333333334	469
FBgn0034707	529	500	493	65	6	10.833333333333334	464
FBgn0034709	533	500	529	37	6	6.166666666666667	496
FBgn0034710	529	500	526	32	7	4.571428571428571	497
FBgn0034712	520	500	497	43	4	10.75	477
FBgn0034713	500	500	419	81	3	27	419
FBgn0034716	502	500	481	23	5	4.6	479
FBgn0034717	542	500	526	58	4	14.5	484
FBgn0034720	500	500	496	4	3	1.3333333333333333	496
FBgn0034721	500	500	497	3	2	1.5	497
FBgn0034722	508	500	504	12	4	3	496
FBgn0034723	510	500	483	37	7	5.285714285714286	473
FBgn0034724	506	500	501	11	3	3.6666666666666665	495
FBgn0034725	524	500	483	65	6	10.833333333333334	459
FBgn0034729	500	500	493	7	2	3.5	493
FBgn0034730	500	500	493	7	3	2.3333333333333335	493
FBgn0034731	500	500	486	14	2	7	486
FBgn0034733	537	500	511	63	9	7	474
FBgn0034736	510	500	492	28	8	3.5	482
FBgn0034737	509	500	508	10	2	5	499
FBgn0034741	501	500	412	90	6	15	411
FBgn0034742	500	500	472	28	4	7	472
FBgn0034743	500	500	499	1	1	1	499
FBgn0034744	451	409	402	91	9	10.11111111111111	360
FBgn0034745	508	500	503	13	5	2.6	495
FBgn0034750	516	498	490	44	5	8.8	472
FBgn0034753	403	348	278	180	6	30	223
FBgn0034755	504	500	467	41	8	5.125	463
FBgn0034761	502	500	429	75	7	10.714285714285714	427
FBgn0034766	500	500	499	1	1	1	499
FBgn0034768	518	500	495	41	3	13.666666666666666	477
FBgn0034769	500	500	499	1	1	1	499
FBgn0034770	500	500	495	5	2	2.5	495
FBgn0034774	503	500	396	110	3	36.666666666666664	393
FBgn0034776	526	500	521	31	3	10.333333333333334	495
FBgn0034783	503	500	491	15	5	3	488
FBgn0034784	526	500	525	27	3	9	499
FBgn0034786	531	500	499	63	8	7.875	468
FBgn0034788	508	500	403	113	3	37.666666666666664	395
FBgn0034789	502	500	453	51	9	5.666666666666667	451
FBgn0034791	471	471	463	8	3	2.6666666666666665	463
FBgn0034792	502	500	487	17	6	2.8333333333333335	485
FBgn0034793	500	500	488	12	4	3	488
FBgn0034795	503	500	502	4	2	2	499
FBgn0034800	510	500	508	12	6	2	498
FBgn0034802	505	500	503	7	3	2.3333333333333335	498
FBgn0034803	500	500	493	7	1	7	493
FBgn0034804	502	500	477	27	9	3	475
FBgn0034807	500	500	476	24	5	4.8	476
FBgn0034808	500	500	487	13	3	4.333333333333333	487
FBgn0034814	541	500	509	73	10	7.3	468
FBgn0034816	503	500	502	4	2	2	499
FBgn0034819	515	500	511	19	3	6.333333333333333	496
FBgn0034820	512	500	474	50	6	8.333333333333334	462
FBgn0034821	508	500	497	19	4	4.75	489
FBgn0034822	503	500	295	211	3	70.33333333333333	292
FBgn0034824	515	500	474	56	3	18.666666666666668	459
FBgn0034825	500	500	494	6	2	3	494
FBgn0034826	506	500	498	14	4	3.5	492
FBgn0034827	500	500	427	73	2	36.5	427
FBgn0034828	501	500	476	26	7	3.7142857142857144	475
FBgn0034829	500	500	499	1	1	1	499
FBgn0034833	503	500	450	56	8	7	447
FBgn0034834	501	500	481	21	7	3	480
FBgn0034835	507	500	480	34	8	4.25	473
FBgn0034837	531	500	514	48	5	9.6	483
FBgn0034839	533	500	511	55	7	7.857142857142857	478
FBgn0034840	500	500	488	12	2	6	488
FBgn0034841	517	500	516	18	4	4.5	499
FBgn0034842	504	500	487	21	5	4.2	483
FBgn0034844	500	500	499	1	1	1	499
FBgn0034846	500	500	496	4	2	2	496
FBgn0034849	500	500	500	0	0	NA	500
FBgn0034850	512	500	512	12	1	12	500
FBgn0034853	514	500	482	46	9	5.111111111111111	468
FBgn0034854	526	500	520	32	8	4	494
FBgn0034856	507	500	505	9	3	3	498
FBgn0034858	500	500	500	0	0	NA	500
FBgn0034860	523	500	500	46	8	5.75	477
FBgn0034861	500	500	500	0	0	NA	500
FBgn0034863	501	500	484	18	3	6	483
FBgn0034865	513	500	438	88	6	14.666666666666666	425
FBgn0034866	512	500	479	45	4	11.25	467
FBgn0034867	509	500	504	14	4	3.5	495
FBgn0034869	535	500	533	37	6	6.166666666666667	498
FBgn0034870	512	500	474	50	6	8.333333333333334	462
FBgn0034871	527	500	520	34	4	8.5	493
FBgn0034876	501	500	491	11	4	2.75	490
FBgn0034877	501	500	499	3	3	1	498
FBgn0034878	474	466	432	50	5	10	424
FBgn0034879	541	500	500	82	13	6.3076923076923075	459
FBgn0034880	541	500	505	77	12	6.416666666666667	464
FBgn0034882	504	500	440	68	5	13.6	436
FBgn0034883	529	500	497	61	10	6.1	468
FBgn0034887	500	500	451	49	6	8.166666666666666	451
FBgn0034893	500	500	478	22	5	4.4	478
FBgn0034894	500	500	500	0	0	NA	500
FBgn0034898	383	383	273	110	4	27.5	273
FBgn0034899	500	500	442	58	3	19.333333333333332	442
FBgn0034900	518	500	504	32	7	4.571428571428571	486
FBgn0034903	500	500	463	37	3	12.333333333333334	463
FBgn0034907	500	500	494	6	3	2	494
FBgn0034908	508	500	477	39	6	6.5	469
FBgn0034909	518	500	474	62	5	12.4	456
FBgn0034910	548	500	529	67	5	13.4	481
FBgn0034911	500	500	481	19	6	3.1666666666666665	481
FBgn0034913	501	500	444	58	2	29	443
FBgn0034914	501	500	478	24	2	12	477
FBgn0034919	524	500	521	27	7	3.857142857142857	497
FBgn0034920	500	500	489	11	2	5.5	489
FBgn0034921	523	500	511	35	8	4.375	488
FBgn0034923	500	500	495	5	2	2.5	495
FBgn0034924	504	500	503	5	2	2.5	499
FBgn0034925	522	500	499	45	7	6.428571428571429	477
FBgn0034935	503	500	487	19	4	4.75	484
FBgn0034936	506	500	486	26	4	6.5	480
FBgn0034938	500	500	487	13	1	13	487
FBgn0034939	503	500	471	35	5	7	468
FBgn0034940	516	500	493	39	3	13	477
FBgn0034942	504	500	495	13	4	3.25	491
FBgn0034943	504	500	495	13	4	3.25	491
FBgn0034946	525	500	508	42	6	7	483
FBgn0034948	597	500	550	144	9	16	453
FBgn0034950	511	500	511	11	2	5.5	500
FBgn0034956	507	500	502	12	3	4	495
FBgn0034957	508	500	489	27	7	3.857142857142857	481
FBgn0034958	500	500	500	0	0	NA	500
FBgn0034959	500	500	500	0	0	NA	500
FBgn0034961	508	500	470	46	10	4.6	462
FBgn0034962	500	500	500	0	0	NA	500
FBgn0034963	504	500	504	4	2	2	500
FBgn0034964	509	500	508	10	4	2.5	499
FBgn0034965	500	500	484	16	1	16	484
FBgn0034966	509	500	469	49	6	8.166666666666666	460
FBgn0034968	504	500	483	25	8	3.125	479
FBgn0034970	505	500	465	45	5	9	460
FBgn0034971	503	500	470	36	2	18	467
FBgn0034972	501	500	453	49	8	6.125	452
FBgn0034973	500	500	355	145	3	48.333333333333336	355
FBgn0034975	508	500	437	79	10	7.9	429
FBgn0034976	510	500	475	45	4	11.25	465
FBgn0034978	462	449	453	22	4	5.5	440
FBgn0034982	500	500	458	42	6	7	458
FBgn0034985	506	500	503	9	4	2.25	497
FBgn0034986	509	500	499	19	3	6.333333333333333	490
FBgn0034988	391	364	367	51	4	12.75	340
FBgn0034990	510	500	501	19	2	9.5	491
FBgn0034994	509	500	508	10	2	5	499
FBgn0034996	500	500	497	3	2	1.5	497
FBgn0034997	518	500	501	35	9	3.888888888888889	483
FBgn0034999	504	500	479	29	5	5.8	475
FBgn0035000	503	500	503	3	1	3	500
FBgn0035001	501	500	491	11	2	5.5	490
FBgn0035004	500	500	451	49	2	24.5	451
FBgn0035005	500	500	490	10	1	10	490
FBgn0035006	501	500	488	14	5	2.8	487
FBgn0035010	501	500	487	15	4	3.75	486
FBgn0035014	517	500	512	22	4	5.5	495
FBgn0035016	500	500	496	4	1	4	496
FBgn0035019	501	500	494	8	3	2.6666666666666665	493
FBgn0035020	501	500	500	2	2	1	499
FBgn0035021	507	500	500	14	3	4.666666666666667	493
FBgn0035022	500	500	459	41	1	41	459
FBgn0035023	515	500	508	22	3	7.333333333333333	493
FBgn0035024	501	500	469	33	6	5.5	468
FBgn0035025	534	500	523	45	6	7.5	489
FBgn0035026	500	500	500	0	0	NA	500
FBgn0035027	500	500	491	9	1	9	491
FBgn0035031	500	500	498	2	1	2	498
FBgn0035032	501	500	499	3	2	1.5	498
FBgn0035033	501	500	490	12	3	4	489
FBgn0035034	500	500	454	46	4	11.5	454
FBgn0035036	508	500	498	18	6	3	490
FBgn0035039	513	500	492	34	7	4.857142857142857	479
FBgn0035040	505	500	479	31	4	7.75	474
FBgn0035041	521	500	515	27	4	6.75	494
FBgn0035042	503	500	500	6	2	3	497
FBgn0035043	511	500	511	11	1	11	500
FBgn0035044	500	500	490	10	2	5	490
FBgn0035046	500	500	497	3	1	3	497
FBgn0035047	504	500	504	4	1	4	500
FBgn0035049	500	500	492	8	1	8	492
FBgn0035050	518	500	515	21	5	4.2	497
FBgn0035056	507	500	465	49	8	6.125	458
FBgn0035057	449	449	449	0	0	NA	449
FBgn0035059	500	500	498	2	1	2	498
FBgn0035063	506	500	506	6	2	3	500
FBgn0035064	500	500	500	0	0	NA	500
FBgn0035065	502	500	502	2	1	2	500
FBgn0035068	516	500	478	54	7	7.714285714285714	462
FBgn0035070	532	500	521	43	7	6.142857142857143	489
FBgn0035076	520	500	518	22	4	5.5	498
FBgn0035078	500	500	499	1	1	1	499
FBgn0035082	407	402	399	13	4	3.25	394
FBgn0035083	506	500	495	17	4	4.25	489
FBgn0035084	500	500	497	3	2	1.5	497
FBgn0035085	528	500	477	79	5	15.8	449
FBgn0035086	501	500	499	3	3	1	498
FBgn0035087	494	479	494	15	1	15	479
FBgn0035088	500	500	495	5	2	2.5	495
FBgn0035089	342	342	342	0	0	NA	342
FBgn0035091	506	500	501	11	3	3.6666666666666665	495
FBgn0035092	519	500	517	21	3	7	498
FBgn0035097	511	500	451	71	9	7.888888888888889	440
FBgn0035099	540	500	534	46	9	5.111111111111111	494
FBgn0035101	501	500	490	12	5	2.4	489
FBgn0035102	480	461	337	162	5	32.4	318
FBgn0035103	509	500	472	46	4	11.5	463
FBgn0035104	546	500	528	64	8	8	482
FBgn0035106	525	500	525	25	3	8.333333333333334	500
FBgn0035107	525	500	522	28	4	7	497
FBgn0035109	518	500	517	19	7	2.7142857142857144	499
FBgn0035110	503	500	503	3	1	3	500
FBgn0035111	500	500	499	1	1	1	499
FBgn0035113	529	500	489	69	7	9.857142857142858	460
FBgn0035120	516	500	516	16	3	5.333333333333333	500
FBgn0035121	511	500	477	45	9	5	466
FBgn0035122	511	500	477	45	9	5	466
FBgn0035131	501	500	491	11	2	5.5	490
FBgn0035134	515	500	514	16	3	5.333333333333333	499
FBgn0035137	501	500	496	6	4	1.5	495
FBgn0035138	500	500	494	6	3	2	494
FBgn0035139	509	500	497	21	6	3.5	488
FBgn0035140	505	500	486	24	4	6	481
FBgn0035141	500	500	462	38	6	6.333333333333333	462
FBgn0035142	513	500	497	29	5	5.8	484
FBgn0035143	504	500	497	11	6	1.8333333333333333	493
FBgn0035144	504	500	495	13	6	2.1666666666666665	491
FBgn0035145	532	500	502	62	8	7.75	470
FBgn0035146	513	500	508	18	3	6	495
FBgn0035147	527	500	521	33	6	5.5	494
FBgn0035149	517	500	471	63	7	9	454
FBgn0035150	517	500	479	55	7	7.857142857142857	462
FBgn0035152	578	500	565	91	7	13	487
FBgn0035153	468	441	431	64	8	8	404
FBgn0035154	514	500	458	70	3	23.333333333333332	444
FBgn0035155	523	500	517	29	4	7.25	494
FBgn0035157	531	500	497	65	11	5.909090909090909	466
FBgn0035158	504	500	418	90	7	12.857142857142858	414
FBgn0035159	573	500	568	78	7	11.142857142857142	495
FBgn0035160	502	500	478	26	6	4.333333333333333	476
FBgn0035161	514	500	514	14	4	3.5	500
FBgn0035162	503	500	483	23	7	3.2857142857142856	480
FBgn0035164	503	500	493	13	3	4.333333333333333	490
FBgn0035165	505	500	492	18	4	4.5	487
FBgn0035166	557	500	550	64	8	8	493
FBgn0035167	531	500	523	39	3	13	492
FBgn0035168	519	500	489	49	7	7	470
FBgn0035170	511	500	399	123	8	15.375	388
FBgn0035173	500	500	485	15	3	5	485
FBgn0035176	501	500	493	9	4	2.25	492
FBgn0035181	500	500	480	20	5	4	480
FBgn0035186	510	500	496	24	4	6	486
FBgn0035187	505	500	500	10	3	3.3333333333333335	495
FBgn0035189	500	500	499	1	1	1	499
FBgn0035193	504	500	497	11	3	3.6666666666666665	493
FBgn0035194	501	500	500	2	2	1	499
FBgn0035196	500	500	482	18	6	3	482
FBgn0035199	536	500	427	145	7	20.714285714285715	391
FBgn0035203	501	500	497	5	3	1.6666666666666667	496
FBgn0035204	502	500	409	95	5	19	407
FBgn0035205	500	500	490	10	1	10	490
FBgn0035206	567	500	552	82	5	16.4	485
FBgn0035207	550	500	533	67	6	11.166666666666666	483
FBgn0035211	509	500	498	20	6	3.3333333333333335	489
FBgn0035216	530	500	510	50	8	6.25	480
FBgn0035217	529	500	497	61	8	7.625	468
FBgn0035227	525	500	479	71	7	10.142857142857142	454
FBgn0035228	517	500	486	48	8	6	469
FBgn0035229	528	500	507	49	6	8.166666666666666	479
FBgn0035231	501	500	493	9	5	1.8	492
FBgn0035232	506	500	495	17	5	3.4	489
FBgn0035233	500	500	499	1	1	1	499
FBgn0035234	515	500	493	37	7	5.285714285714286	478
FBgn0035235	522	500	493	51	10	5.1	471
FBgn0035236	522	500	495	49	9	5.444444444444445	473
FBgn0035237	506	500	483	29	6	4.833333333333333	477
FBgn0035238	514	500	506	22	2	11	492
FBgn0035241	527	500	496	58	7	8.285714285714286	469
FBgn0035243	511	500	505	17	6	2.8333333333333335	494
FBgn0035245	500	500	484	16	3	5.333333333333333	484
FBgn0035247	539	500	505	73	7	10.428571428571429	466
FBgn0035248	500	500	500	0	0	NA	500
FBgn0035249	501	500	494	8	4	2	493
FBgn0035251	500	500	500	0	0	NA	500
FBgn0035252	500	500	500	0	0	NA	500
FBgn0035253	510	500	503	17	4	4.25	493
FBgn0035254	500	500	500	0	0	NA	500
FBgn0035255	381	363	318	81	5	16.2	300
FBgn0035256	552	500	537	67	5	13.4	485
FBgn0035258	511	500	479	43	5	8.6	468
FBgn0035260	511	500	471	51	11	4.636363636363637	460
FBgn0035263	500	500	484	16	3	5.333333333333333	484
FBgn0035264	465	463	437	30	3	10	435
FBgn0035265	508	500	494	22	5	4.4	486
FBgn0035266	508	500	492	24	5	4.8	484
FBgn0035267	521	500	497	45	8	5.625	476
FBgn0035268	512	500	505	19	2	9.5	493
FBgn0035270	519	500	473	65	8	8.125	454
FBgn0035271	506	500	506	6	1	6	500
FBgn0035272	462	462	462	0	0	NA	462
FBgn0035279	516	500	513	19	5	3.8	497
FBgn0035280	500	500	482	18	1	18	482
FBgn0035281	500	500	495	5	3	1.6666666666666667	495
FBgn0035282	525	500	523	27	5	5.4	498
FBgn0035283	532	500	512	52	9	5.777777777777778	480
FBgn0035285	504	500	487	21	3	7	483
FBgn0035286	552	500	551	53	3	17.666666666666668	499
FBgn0035287	502	500	494	10	2	5	492
FBgn0035290	505	500	502	8	4	2	497
FBgn0035294	525	500	511	39	4	9.75	486
FBgn0035295	500	500	496	4	1	4	496
FBgn0035299	514	500	499	29	6	4.833333333333333	485
FBgn0035300	514	500	498	30	7	4.285714285714286	484
FBgn0035308	509	500	482	36	10	3.6	473
FBgn0035309	539	500	534	44	7	6.285714285714286	495
FBgn0035312	581	500	576	86	9	9.555555555555555	495
FBgn0035313	500	500	498	2	1	2	498
FBgn0035315	500	500	476	24	2	12	476
FBgn0035316	547	500	537	57	5	11.4	490
FBgn0035317	501	500	485	17	3	5.666666666666667	484
FBgn0035318	517	500	513	21	4	5.25	496
FBgn0035321	501	500	501	1	1	1	500
FBgn0035323	502	500	482	22	7	3.142857142857143	480
FBgn0035325	535	500	501	69	6	11.5	466
FBgn0035328	500	500	484	16	3	5.333333333333333	484
FBgn0035331	503	500	497	9	3	3	494
FBgn0035332	519	500	502	36	3	12	483
FBgn0035333	516	500	493	39	5	7.8	477
FBgn0035334	516	500	487	45	5	9	471
FBgn0035335	500	500	500	0	0	NA	500
FBgn0035336	514	500	514	14	2	7	500
FBgn0035337	502	500	502	2	2	1	500
FBgn0035343	500	500	497	3	1	3	497
FBgn0035344	521	500	508	34	6	5.666666666666667	487
FBgn0035348	501	500	501	1	1	1	500
FBgn0035355	517	500	517	17	3	5.666666666666667	500
FBgn0035358	500	500	499	1	1	1	499
FBgn0035359	522	500	507	37	5	7.4	485
FBgn0035360	500	500	500	0	0	NA	500
FBgn0035370	516	500	502	30	7	4.285714285714286	486
FBgn0035372	548	500	546	50	6	8.333333333333334	498
FBgn0035374	491	485	487	10	3	3.3333333333333335	481
FBgn0035379	500	500	496	4	2	2	496
FBgn0035380	500	500	433	67	2	33.5	433
FBgn0035382	512	500	512	12	2	6	500
FBgn0035383	540	500	536	44	5	8.8	496
FBgn0035384	506	500	484	28	5	5.6	478
FBgn0035385	500	500	499	1	1	1	499
FBgn0035388	526	500	522	30	5	6	496
FBgn0035390	531	500	522	40	4	10	491
FBgn0035392	537	500	501	73	7	10.428571428571429	464
FBgn0035393	400	387	374	39	4	9.75	361
FBgn0035397	500	500	471	29	5	5.8	471
FBgn0035398	520	500	508	32	5	6.4	488
FBgn0035400	512	500	512	12	3	4	500
FBgn0035401	512	500	512	12	3	4	500
FBgn0035402	502	500	502	2	1	2	500
FBgn0035407	505	500	337	173	2	86.5	332
FBgn0035409	509	500	506	12	3	4	497
FBgn0035410	519	500	513	25	6	4.166666666666667	494
FBgn0035412	495	458	474	58	7	8.285714285714286	437
FBgn0035413	500	500	494	6	1	6	494
FBgn0035414	513	500	257	269	7	38.42857142857143	244
FBgn0035415	525	500	504	46	5	9.2	479
FBgn0035420	500	500	497	3	2	1.5	497
FBgn0035421	500	500	498	2	2	1	498
FBgn0035422	520	500	516	24	5	4.8	496
FBgn0035423	520	500	518	22	4	5.5	498
FBgn0035424	382	377	377	10	5	2	372
FBgn0035425	503	500	497	9	7	1.2857142857142858	494
FBgn0035426	507	500	497	17	9	1.8888888888888888	490
FBgn0035427	514	500	507	21	4	5.25	493
FBgn0035428	501	500	488	14	4	3.5	487
FBgn0035429	500	500	497	3	2	1.5	497
FBgn0035430	504	500	497	11	5	2.2	493
FBgn0035431	517	500	264	270	3	90	247
FBgn0035432	517	500	156	378	4	94.5	139
FBgn0035434	531	500	530	32	6	5.333333333333333	499
FBgn0035435	504	500	491	17	4	4.25	487
FBgn0035438	548	500	548	48	9	5.333333333333333	500
FBgn0035439	465	465	454	11	3	3.6666666666666665	454
FBgn0035440	526	500	519	33	4	8.25	493
FBgn0035443	500	500	492	8	2	4	492
FBgn0035445	502	500	500	4	3	1.3333333333333333	498
FBgn0035449	507	500	492	22	5	4.4	485
FBgn0035452	514	500	504	24	9	2.6666666666666665	490
FBgn0035455	506	500	479	33	7	4.714285714285714	473
FBgn0035462	501	500	479	23	4	5.75	478
FBgn0035464	506	500	498	14	3	4.666666666666667	492
FBgn0035468	515	500	512	18	3	6	497
FBgn0035469	500	500	482	18	1	18	482
FBgn0035471	501	500	498	4	3	1.3333333333333333	497
FBgn0035473	500	500	495	5	2	2.5	495
FBgn0035475	526	500	522	30	5	6	496
FBgn0035476	502	500	492	12	3	4	490
FBgn0035477	526	500	506	46	6	7.666666666666667	480
FBgn0035478	507	500	492	22	7	3.142857142857143	485
FBgn0035479	503	500	427	79	3	26.333333333333332	424
FBgn0035480	518	500	490	46	9	5.111111111111111	472
FBgn0035481	500	500	496	4	1	4	496
FBgn0035484	537	500	496	78	7	11.142857142857142	459
FBgn0035488	504	500	504	4	1	4	500
FBgn0035490	503	500	501	5	4	1.25	498
FBgn0035491	508	500	479	37	7	5.285714285714286	471
FBgn0035495	505	500	483	27	6	4.5	478
FBgn0035496	506	500	469	43	12	3.5833333333333335	463
FBgn0035497	505	500	499	11	5	2.2	494
FBgn0035498	503	500	471	35	6	5.833333333333333	468
FBgn0035499	510	500	471	49	7	7	461
FBgn0035501	500	500	481	19	1	19	481
FBgn0035504	506	500	504	8	2	4	498
FBgn0035505	544	500	532	56	7	8	488
FBgn0035508	515	500	515	15	1	15	500
FBgn0035510	511	500	511	11	4	2.75	500
FBgn0035511	500	500	478	22	3	7.333333333333333	478
FBgn0035512	500	500	499	1	1	1	499
FBgn0035515	517	500	506	28	5	5.6	489
FBgn0035517	510	500	452	68	8	8.5	442
FBgn0035518	503	500	495	11	3	3.6666666666666665	492
FBgn0035519	503	500	495	11	3	3.6666666666666665	492
FBgn0035520	501	500	477	25	8	3.125	476
FBgn0035521	500	500	480	20	4	5	480
FBgn0035522	509	500	489	29	6	4.833333333333333	480
FBgn0035523	505	500	472	38	5	7.6	467
FBgn0035526	530	500	420	140	8	17.5	390
FBgn0035528	502	500	500	4	3	1.3333333333333333	498
FBgn0035529	502	500	500	4	3	1.3333333333333333	498
FBgn0035532	530	500	513	47	6	7.833333333333333	483
FBgn0035533	501	500	489	13	4	3.25	488
FBgn0035534	501	500	492	10	3	3.3333333333333335	491
FBgn0035537	506	500	500	12	4	3	494
FBgn0035538	538	500	513	63	4	15.75	475
FBgn0035539	553	500	492	114	12	9.5	439
FBgn0035540	527	500	519	35	7	5	492
FBgn0035541	560	500	553	67	6	11.166666666666666	493
FBgn0035542	518	500	505	31	5	6.2	487
FBgn0035543	508	500	497	19	3	6.333333333333333	489
FBgn0035544	500	500	498	2	1	2	498
FBgn0035546	520	500	517	23	3	7.666666666666667	497
FBgn0035547	428	428	428	0	0	NA	428
FBgn0035548	526	500	518	34	5	6.8	492
FBgn0035551	502	500	491	13	4	3.25	489
FBgn0035552	500	500	500	0	0	NA	500
FBgn0035553	502	500	466	38	5	7.6	464
FBgn0035554	500	500	495	5	2	2.5	495
FBgn0035555	500	500	495	5	2	2.5	495
FBgn0035557	512	500	491	33	6	5.5	479
FBgn0035558	501	500	453	49	10	4.9	452
FBgn0035568	507	500	461	53	8	6.625	454
FBgn0035569	524	500	488	60	6	10	464
FBgn0035570	507	500	482	32	5	6.4	475
FBgn0035571	517	500	507	27	6	4.5	490
FBgn0035574	508	500	492	24	9	2.6666666666666665	484
FBgn0035575	552	500	540	64	5	12.8	488
FBgn0035577	500	500	499	1	1	1	499
FBgn0035578	501	500	369	133	6	22.166666666666668	368
FBgn0035581	509	500	406	112	2	56	397
FBgn0035582	504	500	503	5	2	2.5	499
FBgn0035586	500	500	499	1	1	1	499
FBgn0035587	506	500	506	6	2	3	500
FBgn0035588	501	500	490	12	2	6	489
FBgn0035589	501	500	496	6	3	2	495
FBgn0035590	501	500	493	9	4	2.25	492
FBgn0035592	500	500	495	5	2	2.5	495
FBgn0035593	501	500	496	6	4	1.5	495
FBgn0035594	500	500	500	0	0	NA	500
FBgn0035598	500	500	436	64	6	10.666666666666666	436
FBgn0035600	508	500	470	46	9	5.111111111111111	462
FBgn0035601	500	500	492	8	3	2.6666666666666665	492
FBgn0035603	500	500	89	411	2	205.5	89
FBgn0035604	500	500	432	68	2	34	432
FBgn0035607	500	500	499	1	1	1	499
FBgn0035610	500	500	488	12	4	3	488
FBgn0035611	500	500	500	0	0	NA	500
FBgn0035612	501	500	492	10	3	3.3333333333333335	491
FBgn0035617	503	500	483	23	8	2.875	480
FBgn0035619	500	500	500	0	0	NA	500
FBgn0035620	500	500	500	0	0	NA	500
FBgn0035621	515	500	511	19	2	9.5	496
FBgn0035623	553	500	499	107	12	8.916666666666666	446
FBgn0035624	543	500	531	55	8	6.875	488
FBgn0035625	510	500	499	21	3	7	489
FBgn0035626	505	500	456	54	6	9	451
FBgn0035627	503	500	502	4	2	2	499
FBgn0035630	501	500	479	23	3	7.666666666666667	478
FBgn0035631	513	500	513	13	4	3.25	500
FBgn0035632	501	500	499	3	3	1	498
FBgn0035636	518	500	499	37	7	5.285714285714286	481
FBgn0035638	532	500	514	50	7	7.142857142857143	482
FBgn0035639	500	500	488	12	2	6	488
FBgn0035640	341	340	341	1	1	1	340
FBgn0035641	503	500	490	16	5	3.2	487
FBgn0035643	500	500	432	68	2	34	432
FBgn0035644	501	500	494	8	4	2	493
FBgn0035645	513	500	507	19	5	3.8	494
FBgn0035647	529	500	516	42	5	8.4	487
FBgn0035648	500	500	498	2	1	2	498
FBgn0035649	553	500	543	63	9	7	490
FBgn0035656	500	500	475	25	3	8.333333333333334	475
FBgn0035657	500	500	485	15	2	7.5	485
FBgn0035661	507	500	506	8	2	4	499
FBgn0035665	501	500	498	4	3	1.3333333333333333	497
FBgn0035666	500	500	436	64	9	7.111111111111111	436
FBgn0035667	502	500	454	50	5	10	452
FBgn0035670	520	500	518	22	5	4.4	498
FBgn0035673	518	500	507	29	5	5.8	489
FBgn0035674	519	500	500	38	8	4.75	481
FBgn0035675	519	500	506	32	4	8	487
FBgn0035676	501	500	345	157	3	52.333333333333336	344
FBgn0035677	520	500	520	20	3	6.666666666666667	500
FBgn0035679	515	500	512	18	8	2.25	497
FBgn0035685	510	500	473	47	5	9.4	463
FBgn0035686	506	500	505	7	2	3.5	499
FBgn0035687	500	500	499	1	1	1	499
FBgn0035688	532	500	521	43	10	4.3	489
FBgn0035689	532	500	519	45	10	4.5	487
FBgn0035690	507	500	505	9	4	2.25	498
FBgn0035691	504	500	451	57	9	6.333333333333333	447
FBgn0035692	563	500	542	84	8	10.5	479
FBgn0035693	501	500	495	7	4	1.75	494
FBgn0035695	515	500	514	16	3	5.333333333333333	499
FBgn0035696	512	500	485	39	6	6.5	473
FBgn0035697	502	500	501	3	2	1.5	499
FBgn0035699	500	500	500	0	0	NA	500
FBgn0035702	526	500	523	29	5	5.8	497
FBgn0035703	526	500	526	26	3	8.666666666666666	500
FBgn0035704	502	500	488	16	6	2.6666666666666665	486
FBgn0035708	504	500	490	18	4	4.5	486
FBgn0035709	363	361	359	6	4	1.5	357
FBgn0035710	500	500	500	0	0	NA	500
FBgn0035711	500	500	500	0	0	NA	500
FBgn0035713	504	500	500	8	3	2.6666666666666665	496
FBgn0035714	504	500	501	7	2	3.5	497
FBgn0035715	449	434	418	46	4	11.5	403
FBgn0035718	511	500	500	22	6	3.6666666666666665	489
FBgn0035720	503	500	503	3	1	3	500
FBgn0035721	506	500	478	34	9	3.7777777777777777	472
FBgn0035722	501	500	496	6	3	2	495
FBgn0035726	515	500	482	48	10	4.8	467
FBgn0035727	502	500	497	7	4	1.75	495
FBgn0035730	500	500	332	168	6	28	332
FBgn0035733	500	500	454	46	2	23	454
FBgn0035734	533	500	516	50	4	12.5	483
FBgn0035736	500	500	494	6	3	2	494
FBgn0035737	501	500	498	4	3	1.3333333333333333	497
FBgn0035741	512	500	510	14	4	3.5	498
FBgn0035742	500	500	497	3	1	3	497
FBgn0035743	536	500	531	41	3	13.666666666666666	495
FBgn0035750	510	500	502	18	4	4.5	492
FBgn0035751	530	500	520	40	3	13.333333333333334	490
FBgn0035753	523	500	501	45	5	9	478
FBgn0035754	502	500	501	3	3	1	499
FBgn0035755	502	500	311	193	3	64.33333333333333	309
FBgn0035756	524	500	494	54	3	18	470
FBgn0035761	502	500	484	20	3	6.666666666666667	482
FBgn0035762	502	500	484	20	3	6.666666666666667	482
FBgn0035763	500	500	495	5	2	2.5	495
FBgn0035766	518	500	497	39	10	3.9	479
FBgn0035767	500	500	427	73	6	12.166666666666666	427
FBgn0035770	500	500	476	24	3	8	476
FBgn0035771	500	500	477	23	2	11.5	477
FBgn0035772	500	500	169	331	1	331	169
FBgn0035776	500	500	385	115	5	23	385
FBgn0035777	513	500	510	16	6	2.6666666666666665	497
FBgn0035780	352	345	334	25	5	5	327
FBgn0035781	512	500	474	50	4	12.5	462
FBgn0035782	500	500	479	21	5	4.2	479
FBgn0035785	502	500	500	4	2	2	498
FBgn0035787	502	500	499	5	3	1.6666666666666667	497
FBgn0035788	532	500	532	32	4	8	500
FBgn0035789	504	500	250	258	5	51.6	246
FBgn0035790	544	500	544	44	5	8.8	500
FBgn0035792	500	500	500	0	0	NA	500
FBgn0035793	501	500	454	48	5	9.6	453
FBgn0035795	446	432	415	45	6	7.5	401
FBgn0035797	515	500	421	109	3	36.333333333333336	406
FBgn0035798	500	500	481	19	4	4.75	481
FBgn0035799	548	500	534	62	5	12.4	486
FBgn0035800	522	500	482	62	8	7.75	460
FBgn0035802	505	500	471	39	9	4.333333333333333	466
FBgn0035805	541	500	467	115	12	9.583333333333334	426
FBgn0035807	513	500	474	52	10	5.2	461
FBgn0035812	500	500	366	134	1	134	366
FBgn0035813	500	500	493	7	1	7	493
FBgn0035815	504	500	473	35	7	5	469
FBgn0035823	386	385	370	17	4	4.25	369
FBgn0035824	545	500	512	78	8	9.75	467
FBgn0035827	514	500	507	21	8	2.625	493
FBgn0035829	505	500	473	37	9	4.111111111111111	468
FBgn0035830	511	500	481	41	7	5.857142857142857	470
FBgn0035831	503	500	481	25	7	3.5714285714285716	478
FBgn0035833	503	500	471	35	4	8.75	468
FBgn0035838	502	500	486	18	5	3.6	484
FBgn0035842	501	500	488	14	4	3.5	487
FBgn0035844	520	500	504	36	2	18	484
FBgn0035847	519	500	507	31	5	6.2	488
FBgn0035848	519	500	507	31	5	6.2	488
FBgn0035849	500	500	492	8	3	2.6666666666666665	492
FBgn0035850	506	500	500	12	2	6	494
FBgn0035851	505	500	498	12	4	3	493
FBgn0035852	500	500	500	0	0	NA	500
FBgn0035853	514	500	510	18	5	3.6	496
FBgn0035854	534	500	526	42	7	6	492
FBgn0035856	556	500	552	60	4	15	496
FBgn0035857	500	500	500	0	0	NA	500
FBgn0035858	521	500	413	129	4	32.25	392
FBgn0035859	504	500	493	15	2	7.5	489
FBgn0035861	501	500	475	27	3	9	474
FBgn0035865	500	500	499	1	1	1	499
FBgn0035866	518	500	517	19	4	4.75	499
FBgn0035867	518	500	513	23	6	3.8333333333333335	495
FBgn0035868	529	500	515	43	4	10.75	486
FBgn0035870	405	400	405	5	2	2.5	400
FBgn0035871	410	409	388	23	5	4.6	387
FBgn0035872	535	500	503	67	11	6.090909090909091	468
FBgn0035873	500	500	474	26	4	6.5	474
FBgn0035875	539	500	501	77	10	7.7	462
FBgn0035876	501	500	471	31	3	10.333333333333334	470
FBgn0035878	501	500	426	76	4	19	425
FBgn0035879	513	500	462	64	8	8	449
FBgn0035880	358	358	356	2	1	2	356
FBgn0035886	517	500	506	28	7	4	489
FBgn0035887	503	500	468	38	4	9.5	465
FBgn0035888	508	500	452	64	8	8	444
FBgn0035890	500	500	459	41	4	10.25	459
FBgn0035896	516	500	496	36	6	6	480
FBgn0035900	503	500	500	6	4	1.5	497
FBgn0035901	505	500	492	18	5	3.6	487
FBgn0035902	504	500	493	15	3	5	489
FBgn0035904	511	500	502	20	4	5	491
FBgn0035906	381	365	366	31	5	6.2	350
FBgn0035907	594	500	565	123	15	8.2	471
FBgn0035909	503	500	446	60	5	12	443
FBgn0035911	527	500	511	43	7	6.142857142857143	484
FBgn0035914	512	500	507	17	4	4.25	495
FBgn0035915	503	500	491	15	4	3.75	488
FBgn0035916	552	500	534	70	9	7.777777777777778	482
FBgn0035917	552	500	534	70	9	7.777777777777778	482
FBgn0035918	500	500	499	1	1	1	499
FBgn0035921	503	500	496	10	5	2	493
FBgn0035922	502	500	493	11	5	2.2	491
FBgn0035923	504	500	439	69	5	13.8	435
FBgn0035926	510	500	507	13	6	2.1666666666666665	497
FBgn0035928	500	500	497	3	3	1	497
FBgn0035929	502	500	501	3	2	1.5	499
FBgn0035931	500	500	496	4	1	4	496
FBgn0035933	363	363	316	47	3	15.666666666666666	316
FBgn0035934	500	500	309	191	2	95.5	309
FBgn0035943	507	500	504	10	4	2.5	497
FBgn0035944	507	500	504	10	4	2.5	497
FBgn0035945	501	500	461	41	4	10.25	460
FBgn0035948	507	500	459	55	4	13.75	452
FBgn0035949	506	500	484	28	7	4	478
FBgn0035951	506	500	506	6	3	2	500
FBgn0035952	505	500	505	5	2	2.5	500
FBgn0035953	501	500	501	1	1	1	500
FBgn0035954	507	500	507	7	1	7	500
FBgn0035955	571	500	451	191	9	21.22222222222222	380
FBgn0035956	503	500	493	13	3	4.333333333333333	490
FBgn0035957	500	500	471	29	5	5.8	471
FBgn0035959	543	500	538	48	3	16	495
FBgn0035960	543	500	543	43	2	21.5	500
FBgn0035965	559	500	531	87	10	8.7	472
FBgn0035968	547	500	544	50	8	6.25	497
FBgn0035969	508	500	499	17	6	2.8333333333333335	491
FBgn0035970	515	500	499	31	6	5.166666666666667	484
FBgn0035971	514	500	496	32	5	6.4	482
FBgn0035975	510	500	509	11	5	2.2	499
FBgn0035976	506	500	481	31	6	5.166666666666667	475
FBgn0035977	502	500	492	12	4	3	490
FBgn0035978	521	500	516	26	4	6.5	495
FBgn0035980	500	500	492	8	3	2.6666666666666665	492
FBgn0035981	500	500	500	0	0	NA	500
FBgn0035982	523	500	493	53	9	5.888888888888889	470
FBgn0035983	519	500	500	38	7	5.428571428571429	481
FBgn0035985	506	500	495	17	6	2.8333333333333335	489
FBgn0035986	501	500	500	2	2	1	499
FBgn0035987	501	500	495	7	2	3.5	494
FBgn0035989	503	500	484	22	3	7.333333333333333	481
FBgn0035996	500	500	464	36	4	9	464
FBgn0035998	505	500	498	12	6	2	493
FBgn0035999	500	500	500	0	0	NA	500
FBgn0036000	521	500	447	95	7	13.571428571428571	426
FBgn0036004	500	500	499	1	1	1	499
FBgn0036009	509	500	504	14	3	4.666666666666667	495
FBgn0036010	502	500	466	38	4	9.5	464
FBgn0036015	505	500	503	7	3	2.3333333333333335	498
FBgn0036018	529	500	497	61	10	6.1	468
FBgn0036019	522	500	509	35	5	7	487
FBgn0036020	510	500	506	14	2	7	496
FBgn0036022	516	500	516	16	2	8	500
FBgn0036023	364	364	347	17	6	2.8333333333333335	347
FBgn0036024	500	500	489	11	3	3.6666666666666665	489
FBgn0036028	501	500	495	7	4	1.75	494
FBgn0036029	500	500	475	25	4	6.25	475
FBgn0036031	500	500	172	328	1	328	172
FBgn0036032	510	500	287	233	5	46.6	277
FBgn0036035	513	500	512	14	3	4.666666666666667	499
FBgn0036036	513	500	508	18	5	3.6	495
FBgn0036038	513	500	468	58	7	8.285714285714286	455
FBgn0036040	505	500	492	18	5	3.6	487
FBgn0036043	506	500	483	29	8	3.625	477
FBgn0036044	529	500	506	52	6	8.666666666666666	477
FBgn0036052	540	500	535	45	7	6.428571428571429	495
FBgn0036053	515	500	429	101	5	20.2	414
FBgn0036058	502	500	493	11	5	2.2	491
FBgn0036062	501	500	373	129	4	32.25	372
FBgn0036063	501	500	488	14	3	4.666666666666667	487
FBgn0036070	512	500	477	47	4	11.75	465
FBgn0036075	519	500	516	22	4	5.5	497
FBgn0036078	508	500	459	57	3	19	451
FBgn0036080	507	500	496	18	4	4.5	489
FBgn0036082	516	500	515	17	4	4.25	499
FBgn0036083	412	400	385	39	5	7.8	373
FBgn0036085	507	500	506	8	3	2.6666666666666665	499
FBgn0036089	542	500	538	46	6	7.666666666666667	496
FBgn0036090	508	500	468	48	6	8	460
FBgn0036091	377	370	375	9	4	2.25	368
FBgn0036093	500	500	470	30	5	6	470
FBgn0036094	504	500	501	7	2	3.5	497
FBgn0036099	553	500	498	108	7	15.428571428571429	445
FBgn0036101	546	500	487	105	10	10.5	441
FBgn0036102	502	500	488	16	3	5.333333333333333	486
FBgn0036104	500	500	498	2	1	2	498
FBgn0036105	500	500	487	13	2	6.5	487
FBgn0036106	511	500	508	14	5	2.8	497
FBgn0036107	511	500	505	17	5	3.4	494
FBgn0036108	512	500	444	80	9	8.88888888888889	432
FBgn0036110	501	500	475	27	5	5.4	474
FBgn0036111	569	500	523	115	10	11.5	454
FBgn0036112	502	500	474	30	5	6	472
FBgn0036116	510	500	462	58	11	5.2727272727272725	452
FBgn0036117	523	500	519	27	6	4.5	496
FBgn0036118	523	500	519	27	6	4.5	496
FBgn0036121	576	500	553	99	13	7.615384615384615	477
FBgn0036126	506	500	500	12	2	6	494
FBgn0036131	502	500	251	253	6	42.166666666666664	249
FBgn0036133	527	500	518	36	4	9	491
FBgn0036134	506	500	505	7	2	3.5	499
FBgn0036135	500	500	497	3	2	1.5	497
FBgn0036136	514	500	493	35	11	3.1818181818181817	479
FBgn0036138	500	500	490	10	6	1.6666666666666667	490
FBgn0036139	505	500	490	20	6	3.3333333333333335	485
FBgn0036141	507	500	491	23	5	4.6	484
FBgn0036142	502	500	502	2	1	2	500
FBgn0036143	500	500	463	37	2	18.5	463
FBgn0036144	501	500	461	41	6	6.833333333333333	460
FBgn0036145	508	500	489	27	4	6.75	481
FBgn0036146	519	500	487	51	9	5.666666666666667	468
FBgn0036147	531	500	497	65	10	6.5	466
FBgn0036152	528	500	523	33	5	6.6	495
FBgn0036153	540	500	527	53	5	10.6	487
FBgn0036154	524	500	495	53	9	5.888888888888889	471
FBgn0036155	500	500	498	2	1	2	498
FBgn0036156	502	500	476	28	6	4.666666666666667	474
FBgn0036157	569	500	548	90	8	11.25	479
FBgn0036158	514	500	468	60	5	12	454
FBgn0036159	510	500	399	121	5	24.2	389
FBgn0036160	500	500	498	2	2	1	498
FBgn0036161	504	500	502	6	3	2	498
FBgn0036162	506	500	492	20	6	3.3333333333333335	486
FBgn0036165	504	500	454	54	9	6	450
FBgn0036168	475	473	410	67	4	16.75	408
FBgn0036173	513	500	511	15	6	2.5	498
FBgn0036176	524	500	414	134	8	16.75	390
FBgn0036177	515	500	501	29	5	5.8	486
FBgn0036179	501	500	495	7	2	3.5	494
FBgn0036180	536	500	509	63	12	5.25	473
FBgn0036181	500	500	500	0	0	NA	500
FBgn0036187	501	500	473	29	5	5.8	472
FBgn0036188	501	500	473	29	5	5.8	472
FBgn0036192	500	500	497	3	3	1	497
FBgn0036193	510	500	504	16	6	2.6666666666666665	494
FBgn0036195	500	500	465	35	3	11.666666666666666	465
FBgn0036196	525	500	497	53	10	5.3	472
FBgn0036199	520	500	517	23	4	5.75	497
FBgn0036202	505	500	433	77	5	15.4	428
FBgn0036203	518	500	483	53	4	13.25	465
FBgn0036204	502	500	422	82	6	13.666666666666666	420
FBgn0036205	529	500	527	31	4	7.75	498
FBgn0036206	522	500	504	40	6	6.666666666666667	482
FBgn0036207	523	500	502	44	8	5.5	479
FBgn0036208	502	500	469	35	8	4.375	467
FBgn0036213	520	500	379	161	8	20.125	359
FBgn0036214	508	500	462	54	7	7.714285714285714	454
FBgn0036218	509	500	430	88	5	17.6	421
FBgn0036219	373	366	353	27	3	9	346
FBgn0036221	508	500	467	49	5	9.8	459
FBgn0036224	525	500	518	32	6	5.333333333333333	493
FBgn0036225	557	500	555	59	9	6.555555555555555	498
FBgn0036226	504	500	503	5	2	2.5	499
FBgn0036227	500	500	459	41	5	8.2	459
FBgn0036228	505	500	500	10	4	2.5	495
FBgn0036229	507	500	497	17	3	5.666666666666667	490
FBgn0036230	502	500	477	27	5	5.4	475
FBgn0036232	507	500	471	43	8	5.375	464
FBgn0036235	515	500	493	37	10	3.7	478
FBgn0036236	404	391	383	34	4	8.5	370
FBgn0036239	521	500	521	21	1	21	500
FBgn0036240	523	500	520	26	4	6.5	497
FBgn0036242	515	500	510	20	5	4	495
FBgn0036246	517	500	483	51	8	6.375	466
FBgn0036248	456	407	400	105	11	9.545454545454545	351
FBgn0036249	538	476	515	85	9	9.444444444444445	453
FBgn0036250	502	500	464	40	10	4	462
FBgn0036254	511	500	507	15	4	3.75	496
FBgn0036255	511	500	509	13	3	4.333333333333333	498
FBgn0036257	501	500	472	30	5	6	471
FBgn0036258	505	500	504	6	4	1.5	499
FBgn0036259	516	500	510	22	7	3.142857142857143	494
FBgn0036260	501	500	500	2	2	1	499
FBgn0036262	506	500	494	18	6	3	488
FBgn0036263	508	500	508	8	2	4	500
FBgn0036264	505	500	488	22	5	4.4	483
FBgn0036266	534	500	506	62	5	12.4	472
FBgn0036271	514	500	511	17	6	2.8333333333333335	497
FBgn0036272	546	500	507	85	13	6.538461538461538	461
FBgn0036273	546	500	507	85	13	6.538461538461538	461
FBgn0036274	505	500	500	10	3	3.3333333333333335	495
FBgn0036278	502	500	502	2	2	1	500
FBgn0036279	516	500	515	17	4	4.25	499
FBgn0036282	503	500	490	16	4	4	487
FBgn0036285	502	500	495	9	3	3	493
FBgn0036286	512	500	441	83	8	10.375	429
FBgn0036288	504	500	498	10	4	2.5	494
FBgn0036289	500	500	493	7	3	2.3333333333333335	493
FBgn0036290	531	500	524	38	9	4.222222222222222	493
FBgn0036291	505	500	376	134	4	33.5	371
FBgn0036292	504	500	497	11	7	1.5714285714285714	493
FBgn0036294	508	500	471	45	7	6.428571428571429	463
FBgn0036298	502	500	502	2	2	1	500
FBgn0036299	508	500	501	15	5	3	493
FBgn0036300	346	346	339	7	2	3.5	339
FBgn0036301	507	500	472	42	13	3.230769230769231	465
FBgn0036302	544	500	532	56	12	4.666666666666667	488
FBgn0036305	505	500	493	17	3	5.666666666666667	488
FBgn0036306	509	500	504	14	2	7	495
FBgn0036309	427	423	389	42	5	8.4	385
FBgn0036310	504	500	494	14	4	3.5	490
FBgn0036311	504	500	502	6	2	3	498
FBgn0036314	510	500	485	35	7	5	475
FBgn0036316	505	500	504	6	4	1.5	499
FBgn0036317	500	500	499	1	1	1	499
FBgn0036318	500	500	499	1	1	1	499
FBgn0036319	523	500	480	66	6	11	457
FBgn0036320	501	500	498	4	3	1.3333333333333333	497
FBgn0036321	524	500	524	24	2	12	500
FBgn0036323	532	495	519	50	13	3.8461538461538463	482
FBgn0036325	500	500	500	0	0	NA	500
FBgn0036327	501	500	500	2	2	1	499
FBgn0036328	501	500	497	5	3	1.6666666666666667	496
FBgn0036331	512	500	406	118	6	19.666666666666668	394
FBgn0036332	419	419	214	205	3	68.33333333333333	214
FBgn0036333	505	500	414	96	4	24	409
FBgn0036334	506	500	434	78	9	8.666666666666666	428
FBgn0036335	449	447	428	23	6	3.8333333333333335	426
FBgn0036336	505	500	482	28	8	3.5	477
FBgn0036337	519	500	435	103	6	17.166666666666668	416
FBgn0036340	504	500	484	24	8	3	480
FBgn0036341	537	500	523	51	10	5.1	486
FBgn0036342	500	500	496	4	1	4	496
FBgn0036343	506	500	504	8	3	2.6666666666666665	498
FBgn0036345	501	500	491	11	4	2.75	490
FBgn0036346	522	500	490	54	4	13.5	468
FBgn0036348	519	500	474	64	11	5.818181818181818	455
FBgn0036350	501	500	493	9	5	1.8	492
FBgn0036351	503	500	502	4	2	2	499
FBgn0036352	512	500	436	88	6	14.666666666666666	424
FBgn0036353	558	500	548	68	13	5.230769230769231	490
FBgn0036356	500	500	236	264	1	264	236
FBgn0036359	511	500	381	141	8	17.625	370
FBgn0036360	528	500	473	83	3	27.666666666666668	445
FBgn0036361	508	500	477	39	8	4.875	469
FBgn0036362	501	500	404	98	4	24.5	403
FBgn0036363	502	500	493	11	5	2.2	491
FBgn0036364	502	500	501	3	2	1.5	499
FBgn0036367	505	500	505	5	2	2.5	500
FBgn0036369	503	500	459	47	5	9.4	456
FBgn0036374	500	500	498	2	1	2	498
FBgn0036376	500	500	481	19	3	6.333333333333333	481
FBgn0036377	503	500	492	14	3	4.666666666666667	489
FBgn0036380	442	419	415	50	6	8.333333333333334	392
FBgn0036381	506	500	317	195	2	97.5	311
FBgn0036382	513	500	484	42	5	8.4	471
FBgn0036386	547	500	495	99	9	11	448
FBgn0036390	519	500	421	117	8	14.625	402
FBgn0036391	520	500	469	71	10	7.1	449
FBgn0036393	515	500	510	20	6	3.3333333333333335	495
FBgn0036394	523	500	522	24	7	3.4285714285714284	499
FBgn0036395	525	500	455	95	9	10.555555555555555	430
FBgn0036396	487	483	482	9	4	2.25	478
FBgn0036397	503	500	488	18	5	3.6	485
FBgn0036402	500	500	495	5	2	2.5	495
FBgn0036403	501	500	363	139	4	34.75	362
FBgn0036411	502	500	489	15	4	3.75	487
FBgn0036414	504	500	413	95	5	19	409
FBgn0036416	500	500	499	1	1	1	499
FBgn0036417	500	500	469	31	2	15.5	469
FBgn0036421	500	500	486	14	3	4.666666666666667	486
FBgn0036422	587	500	572	102	8	12.75	485
FBgn0036426	507	500	504	10	2	5	497
FBgn0036428	531	500	497	65	8	8.125	466
FBgn0036433	505	500	501	9	4	2.25	496
FBgn0036436	517	500	477	57	6	9.5	460
FBgn0036446	507	500	503	11	3	3.6666666666666665	496
FBgn0036447	382	382	370	12	3	4	370
FBgn0036448	539	500	529	49	8	6.125	490
FBgn0036449	500	500	254	246	1	246	254
FBgn0036450	543	500	358	228	3	76	315
FBgn0036451	346	346	346	0	0	NA	346
FBgn0036454	502	500	469	35	6	5.833333333333333	467
FBgn0036459	505	500	441	69	2	34.5	436
FBgn0036460	542	491	510	83	12	6.916666666666667	459
FBgn0036461	532	500	519	45	6	7.5	487
FBgn0036462	516	500	504	28	6	4.666666666666667	488
FBgn0036470	511	500	507	15	6	2.5	496
FBgn0036479	532	500	335	229	6	38.166666666666664	303
FBgn0036481	501	500	493	9	4	2.25	492
FBgn0036482	431	426	424	12	4	3	419
FBgn0036483	505	500	505	5	2	2.5	500
FBgn0036486	539	500	529	49	5	9.8	490
FBgn0036487	539	500	529	49	5	9.8	490
FBgn0036488	509	500	505	13	6	2.1666666666666665	496
FBgn0036489	535	500	517	53	10	5.3	482
FBgn0036490	506	500	506	6	3	2	500
FBgn0036492	500	500	482	18	2	9	482
FBgn0036493	523	500	512	34	6	5.666666666666667	489
FBgn0036494	500	500	499	1	1	1	499
FBgn0036495	505	500	501	9	3	3	496
FBgn0036497	525	500	499	51	6	8.5	474
FBgn0036498	510	500	486	34	6	5.666666666666667	476
FBgn0036501	452	429	452	23	4	5.75	429
FBgn0036502	522	500	497	47	7	6.714285714285714	475
FBgn0036503	518	500	468	68	9	7.555555555555555	450
FBgn0036504	507	500	492	22	6	3.6666666666666665	485
FBgn0036509	501	500	482	20	4	5	481
FBgn0036510	501	500	482	20	6	3.3333333333333335	481
FBgn0036512	500	500	280	220	1	220	280
FBgn0036514	506	500	498	14	3	4.666666666666667	492
FBgn0036516	515	500	453	77	9	8.555555555555555	438
FBgn0036518	509	500	454	64	10	6.4	445
FBgn0036522	501	500	493	9	4	2.25	492
FBgn0036527	523	500	500	46	8	5.75	477
FBgn0036528	510	500	510	10	3	3.3333333333333335	500
FBgn0036529	510	500	510	10	3	3.3333333333333335	500
FBgn0036531	505	500	459	51	3	17	454
FBgn0036532	503	500	478	28	3	9.333333333333334	475
FBgn0036534	510	500	504	16	5	3.2	494
FBgn0036537	513	500	510	16	9	1.7777777777777777	497
FBgn0036538	515	500	491	39	6	6.5	476
FBgn0036544	516	500	512	20	5	4	496
FBgn0036545	508	500	497	19	10	1.9	489
FBgn0036547	507	500	489	25	5	5	482
FBgn0036549	523	500	522	24	4	6	499
FBgn0036550	537	500	523	51	5	10.2	486
FBgn0036556	506	500	494	18	6	3	488
FBgn0036557	506	500	493	19	7	2.7142857142857144	487
FBgn0036560	550	500	514	86	7	12.285714285714286	464
FBgn0036563	535	500	510	60	6	10	475
FBgn0036565	504	500	501	7	2	3.5	497
FBgn0036566	500	500	499	1	1	1	499
FBgn0036567	557	500	553	61	8	7.625	496
FBgn0036568	552	500	549	55	6	9.166666666666666	497
FBgn0036570	508	500	497	19	5	3.8	489
FBgn0036571	500	500	469	31	1	31	469
FBgn0036574	532	500	523	41	12	3.4166666666666665	491
FBgn0036575	506	500	505	7	2	3.5	499
FBgn0036577	505	500	502	8	4	2	497
FBgn0036579	519	500	510	28	3	9.333333333333334	491
FBgn0036580	500	500	499	1	1	1	499
FBgn0036581	510	500	509	11	2	5.5	499
FBgn0036583	502	500	444	60	5	12	442
FBgn0036584	500	500	497	3	2	1.5	497
FBgn0036585	526	500	525	27	5	5.4	499
FBgn0036587	516	500	513	19	6	3.1666666666666665	497
FBgn0036588	500	500	497	3	1	3	497
FBgn0036589	503	500	497	9	3	3	494
FBgn0036590	545	500	500	90	11	8.181818181818182	455
FBgn0036591	512	500	510	14	4	3.5	498
FBgn0036592	510	500	502	18	3	6	492
FBgn0036593	508	500	498	18	4	4.5	490
FBgn0036594	511	500	482	40	6	6.666666666666667	471
FBgn0036595	502	500	494	10	4	2.5	492
FBgn0036596	521	500	463	79	6	13.166666666666666	442
FBgn0036597	500	500	474	26	2	13	474
FBgn0036598	500	500	472	28	4	7	472
FBgn0036599	500	500	493	7	2	3.5	493
FBgn0036600	506	500	489	23	5	4.6	483
FBgn0036601	506	500	482	30	6	5	476
FBgn0036602	500	500	489	11	4	2.75	489
FBgn0036603	500	500	326	174	2	87	326
FBgn0036606	500	500	496	4	1	4	496
FBgn0036607	500	500	499	1	1	1	499
FBgn0036609	515	500	466	64	7	9.142857142857142	451
FBgn0036610	500	500	378	122	3	40.666666666666664	378
FBgn0036612	517	500	512	22	5	4.4	495
FBgn0036614	500	500	500	0	0	NA	500
FBgn0036617	541	500	529	53	8	6.625	488
FBgn0036618	500	500	462	38	5	7.6	462
FBgn0036619	506	500	414	98	3	32.666666666666664	408
FBgn0036620	522	500	519	25	6	4.166666666666667	497
FBgn0036622	515	500	515	15	2	7.5	500
FBgn0036624	515	500	506	24	8	3	491
FBgn0036639	501	500	495	7	4	1.75	494
FBgn0036652	516	500	511	21	3	7	495
FBgn0036654	516	500	483	49	5	9.8	467
FBgn0036655	502	500	492	12	5	2.4	490
FBgn0036656	500	500	496	4	1	4	496
FBgn0036659	500	500	499	1	1	1	499
FBgn0036661	501	500	492	10	3	3.3333333333333335	491
FBgn0036663	512	500	465	59	11	5.363636363636363	453
FBgn0036665	505	500	490	20	6	3.3333333333333335	485
FBgn0036667	536	500	304	268	4	67	268
FBgn0036668	500	500	176	324	2	162	176
FBgn0036671	520	500	517	23	4	5.75	497
FBgn0036676	505	500	480	30	7	4.285714285714286	475
FBgn0036677	514	500	514	14	1	14	500
FBgn0036678	500	500	500	0	0	NA	500
FBgn0036680	506	500	501	11	3	3.6666666666666665	495
FBgn0036681	501	500	500	2	2	1	499
FBgn0036684	515	500	477	53	5	10.6	462
FBgn0036685	606	500	587	125	8	15.625	481
FBgn0036686	505	500	311	199	3	66.33333333333333	306
FBgn0036688	549	500	524	74	10	7.4	475
FBgn0036689	505	500	460	50	7	7.142857142857143	455
FBgn0036691	557	500	553	61	9	6.777777777777778	496
FBgn0036695	502	500	468	36	4	9	466
FBgn0036697	528	500	482	74	10	7.4	454
FBgn0036698	500	500	499	1	1	1	499
FBgn0036702	528	500	459	97	12	8.083333333333334	431
FBgn0036704	517	500	511	23	9	2.5555555555555554	494
FBgn0036706	502	500	502	2	2	1	500
FBgn0036707	500	500	484	16	1	16	484
FBgn0036708	530	500	530	30	3	10	500
FBgn0036709	503	500	501	5	3	1.6666666666666667	498
FBgn0036711	501	500	501	1	1	1	500
FBgn0036712	500	500	476	24	1	24	476
FBgn0036713	506	500	504	8	3	2.6666666666666665	498
FBgn0036714	530	500	530	30	2	15	500
FBgn0036715	567	500	547	87	8	10.875	480
FBgn0036716	500	500	493	7	4	1.75	493
FBgn0036717	500	500	494	6	2	3	494
FBgn0036723	500	500	500	0	0	NA	500
FBgn0036725	507	500	499	15	5	3	492
FBgn0036727	544	500	534	54	6	9	490
FBgn0036728	384	382	382	4	4	1	380
FBgn0036730	500	500	405	95	2	47.5	405
FBgn0036731	503	500	467	39	6	6.5	464
FBgn0036732	524	500	501	47	6	7.833333333333333	477
FBgn0036733	572	500	563	81	10	8.1	491
FBgn0036734	572	500	563	81	10	8.1	491
FBgn0036738	508	500	474	42	4	10.5	466
FBgn0036740	511	500	475	47	2	23.5	464
FBgn0036742	501	500	372	130	6	21.666666666666668	371
FBgn0036745	503	500	457	49	5	9.8	454
FBgn0036747	503	500	496	10	3	3.3333333333333335	493
FBgn0036750	587	500	583	91	9	10.11111111111111	496
FBgn0036751	515	500	493	37	3	12.333333333333334	478
FBgn0036756	501	500	499	3	2	1.5	498
FBgn0036760	501	500	490	12	4	3	489
FBgn0036761	502	500	466	38	8	4.75	464
FBgn0036762	502	500	470	34	7	4.857142857142857	468
FBgn0036763	554	500	538	70	10	7	484
FBgn0036764	517	500	470	64	10	6.4	453
FBgn0036765	507	500	362	152	9	16.88888888888889	355
FBgn0036766	536	500	487	85	9	9.444444444444445	451
FBgn0036767	501	500	226	276	3	92	225
FBgn0036768	500	500	492	8	4	2	492
FBgn0036769	516	500	506	26	8	3.25	490
FBgn0036770	501	500	494	8	4	2	493
FBgn0036771	501	500	494	8	4	2	493
FBgn0036772	515	500	515	15	3	5	500
FBgn0036773	510	500	487	33	6	5.5	477
FBgn0036774	510	500	486	34	6	5.666666666666667	476
FBgn0036775	544	500	513	75	4	18.75	469
FBgn0036778	500	500	442	58	6	9.666666666666666	442
FBgn0036780	505	500	472	38	13	2.923076923076923	467
FBgn0036781	510	500	348	172	6	28.666666666666668	338
FBgn0036782	514	500	488	40	8	5	474
FBgn0036783	514	500	475	53	6	8.833333333333334	461
FBgn0036784	502	500	297	207	4	51.75	295
FBgn0036785	501	500	500	2	2	1	499
FBgn0036786	507	500	482	32	5	6.4	475
FBgn0036789	502	500	477	27	4	6.75	475
FBgn0036790	502	500	477	27	5	5.4	475
FBgn0036791	508	500	504	12	4	3	496
FBgn0036801	542	500	522	62	9	6.888888888888889	480
FBgn0036804	500	500	230	270	4	67.5	230
FBgn0036805	511	480	487	55	9	6.111111111111111	456
FBgn0036806	559	500	548	70	8	8.75	489
FBgn0036807	500	500	421	79	6	13.166666666666666	421
FBgn0036809	516	500	392	140	8	17.5	376
FBgn0036810	513	500	491	35	8	4.375	478
FBgn0036812	504	500	500	8	3	2.6666666666666665	496
FBgn0036813	505	500	501	9	4	2.25	496
FBgn0036814	502	500	502	2	2	1	500
FBgn0036815	502	500	502	2	2	1	500
FBgn0036816	511	500	494	28	8	3.5	483
FBgn0036817	502	500	495	9	3	3	493
FBgn0036818	500	500	107	393	1	393	107
FBgn0036819	484	421	484	63	5	12.6	421
FBgn0036820	426	425	399	28	4	7	398
FBgn0036822	504	500	490	18	5	3.6	486
FBgn0036824	505	500	319	191	10	19.1	314
FBgn0036826	500	500	500	0	0	NA	500
FBgn0036827	521	500	520	22	2	11	499
FBgn0036830	507	500	475	39	4	9.75	468
FBgn0036831	508	500	495	21	4	5.25	487
FBgn0036833	502	500	494	10	4	2.5	492
FBgn0036834	514	500	496	32	5	6.4	482
FBgn0036835	500	500	499	1	1	1	499
FBgn0036836	500	500	490	10	2	5	490
FBgn0036838	473	473	120	353	2	176.5	120
FBgn0036839	502	500	463	41	5	8.2	461
FBgn0036842	561	500	557	65	9	7.222222222222222	496
FBgn0036843	561	500	556	66	10	6.6	495
FBgn0036844	505	500	492	18	6	3	487
FBgn0036847	439	434	366	78	8	9.75	361
FBgn0036848	555	500	545	65	10	6.5	490
FBgn0036849	527	500	483	71	9	7.888888888888889	456
FBgn0036850	544	500	512	76	13	5.846153846153846	468
FBgn0036851	500	500	491	9	2	4.5	491
FBgn0036853	593	500	585	101	9	11.222222222222221	492
FBgn0036857	519	500	494	44	5	8.8	475
FBgn0036859	515	500	490	40	4	10	475
FBgn0036860	500	500	480	20	2	10	480
FBgn0036861	500	500	433	67	4	16.75	433
FBgn0036868	526	500	517	35	8	4.375	491
FBgn0036870	502	500	496	8	3	2.6666666666666665	494
FBgn0036875	503	500	495	11	5	2.2	492
FBgn0036876	347	346	334	14	3	4.666666666666667	333
FBgn0036877	511	500	506	16	6	2.6666666666666665	495
FBgn0036878	507	500	507	7	2	3.5	500
FBgn0036879	500	500	498	2	2	1	498
FBgn0036880	509	500	444	74	3	24.666666666666668	435
FBgn0036881	500	500	460	40	3	13.333333333333334	460
FBgn0036886	500	500	500	0	0	NA	500
FBgn0036887	502	500	491	13	5	2.6	489
FBgn0036888	503	500	492	14	6	2.3333333333333335	489
FBgn0036889	506	500	501	11	7	1.5714285714285714	495
FBgn0036891	511	500	510	12	5	2.4	499
FBgn0036893	500	500	299	201	1	201	299
FBgn0036895	511	500	395	127	11	11.545454545454545	384
FBgn0036896	532	500	520	44	8	5.5	488
FBgn0036897	557	500	549	65	11	5.909090909090909	492
FBgn0036899	510	500	479	41	7	5.857142857142857	469
FBgn0036900	509	500	509	9	3	3	500
FBgn0036906	501	500	489	13	3	4.333333333333333	488
FBgn0036909	501	500	499	3	2	1.5	498
FBgn0036910	502	500	499	5	2	2.5	497
FBgn0036911	512	500	506	18	2	9	494
FBgn0036913	500	500	500	0	0	NA	500
FBgn0036918	500	500	500	0	0	NA	500
FBgn0036919	509	500	486	32	9	3.5555555555555554	477
FBgn0036920	510	500	506	14	4	3.5	496
FBgn0036921	510	500	500	20	6	3.3333333333333335	490
FBgn0036922	500	500	187	313	1	313	187
FBgn0036924	515	500	513	17	4	4.25	498
FBgn0036925	515	500	513	17	4	4.25	498
FBgn0036927	511	500	487	35	7	5	476
FBgn0036928	503	500	496	10	6	1.6666666666666667	493
FBgn0036929	511	500	499	23	4	5.75	488
FBgn0036932	525	500	491	59	6	9.833333333333334	466
FBgn0036934	542	500	540	44	6	7.333333333333333	498
FBgn0036935	514	500	494	34	4	8.5	480
FBgn0036936	502	500	295	209	7	29.857142857142858	293
FBgn0036937	501	500	496	6	4	1.5	495
FBgn0036938	558	500	557	59	7	8.428571428571429	499
FBgn0036939	500	500	494	6	1	6	494
FBgn0036940	396	396	347	49	2	24.5	347
FBgn0036941	502	500	463	41	2	20.5	461
FBgn0036942	567	500	547	87	8	10.875	480
FBgn0036945	511	500	502	20	6	3.3333333333333335	491
FBgn0036947	525	500	504	46	6	7.666666666666667	479
FBgn0036948	500	500	479	21	2	10.5	479
FBgn0036949	511	500	459	63	11	5.7272727272727275	448
FBgn0036950	501	500	452	50	7	7.142857142857143	451
FBgn0036951	519	500	374	164	4	41	355
FBgn0036952	511	500	418	104	4	26	407
FBgn0036953	572	500	566	78	5	15.6	494
FBgn0036958	517	500	494	40	6	6.666666666666667	477
FBgn0036964	492	488	480	16	7	2.2857142857142856	476
FBgn0036973	505	500	501	9	6	1.5	496
FBgn0036974	505	500	502	8	5	1.6	497
FBgn0036977	373	370	372	4	2	2	369
FBgn0036978	509	500	477	41	6	6.833333333333333	468
FBgn0036979	390	387	358	35	5	7	355
FBgn0036980	510	500	488	32	4	8	478
FBgn0036984	506	500	490	22	7	3.142857142857143	484
FBgn0036985	521	500	496	46	4	11.5	475
FBgn0036987	540	500	510	70	6	11.666666666666666	470
FBgn0036990	500	500	451	49	3	16.333333333333332	451
FBgn0036991	500	500	485	15	1	15	485
FBgn0036992	505	500	503	7	4	1.75	498
FBgn0036993	520	500	502	38	7	5.428571428571429	482
FBgn0036994	552	500	525	79	12	6.583333333333333	473
FBgn0036996	511	500	467	55	9	6.111111111111111	456
FBgn0036997	525	500	514	36	5	7.2	489
FBgn0036998	617	500	610	124	8	15.5	493
FBgn0037000	502	500	493	11	5	2.2	491
FBgn0037001	511	500	456	66	6	11	445
FBgn0037008	519	500	495	43	5	8.6	476
FBgn0037009	519	500	489	49	5	9.8	470
FBgn0037011	523	500	520	26	7	3.7142857142857144	497
FBgn0037012	504	500	471	37	5	7.4	467
FBgn0037013	504	500	440	68	8	8.5	436
FBgn0037014	543	500	539	47	8	5.875	496
FBgn0037015	560	500	537	83	10	8.3	477
FBgn0037016	504	500	460	48	3	16	456
FBgn0037017	500	500	498	2	1	2	498
FBgn0037018	533	500	527	39	5	7.8	494
FBgn0037019	528	500	465	91	9	10.11111111111111	437
FBgn0037020	536	500	480	92	10	9.2	444
FBgn0037023	500	500	496	4	2	2	496
FBgn0037024	500	500	496	4	2	2	496
FBgn0037025	476	419	470	63	6	10.5	413
FBgn0037026	500	500	496	4	2	2	496
FBgn0037027	500	500	499	1	1	1	499
FBgn0037028	525	500	525	25	3	8.333333333333334	500
FBgn0037030	500	500	490	10	3	3.3333333333333335	490
FBgn0037031	515	500	397	133	6	22.166666666666668	382
FBgn0037035	500	500	494	6	1	6	494
FBgn0037036	527	500	526	28	4	7	499
FBgn0037037	502	500	476	28	3	9.333333333333334	474
FBgn0037038	396	396	384	12	2	6	384
FBgn0037042	562	500	556	68	13	5.230769230769231	494
FBgn0037044	507	500	473	41	6	6.833333333333333	466
FBgn0037046	541	500	528	54	11	4.909090909090909	487
FBgn0037050	502	500	490	14	5	2.8	488
FBgn0037051	507	500	497	17	5	3.4	490
FBgn0037057	517	500	517	17	4	4.25	500
FBgn0037059	502	500	502	2	1	2	500
FBgn0037060	500	500	419	81	3	27	419
FBgn0037061	501	500	491	11	2	5.5	490
FBgn0037064	504	500	498	10	5	2	494
FBgn0037065	500	500	497	3	1	3	497
FBgn0037067	501	500	496	6	2	3	495
FBgn0037069	529	500	509	49	5	9.8	480
FBgn0037070	500	500	495	5	1	5	495
FBgn0037071	508	500	483	33	7	4.714285714285714	475
FBgn0037073	502	500	502	2	1	2	500
FBgn0037074	502	500	483	21	3	7	481
FBgn0037076	500	500	487	13	2	6.5	487
FBgn0037078	500	500	272	228	2	114	272
FBgn0037081	508	500	497	19	7	2.7142857142857144	489
FBgn0037084	501	500	462	40	5	8	461
FBgn0037085	506	500	360	152	4	38	354
FBgn0037086	519	500	516	22	6	3.6666666666666665	497
FBgn0037087	519	500	516	22	6	3.6666666666666665	497
FBgn0037090	541	500	442	140	8	17.5	401
FBgn0037092	552	500	551	53	5	10.6	499
FBgn0037093	514	500	489	39	11	3.5454545454545454	475
FBgn0037094	532	500	527	37	9	4.111111111111111	495
FBgn0037098	530	500	529	31	5	6.2	499
FBgn0037099	509	500	484	34	3	11.333333333333334	475
FBgn0037100	512	500	487	37	8	4.625	475
FBgn0037101	508	500	508	8	3	2.6666666666666665	500
FBgn0037102	505	500	494	16	3	5.333333333333333	489
FBgn0037105	500	500	482	18	7	2.5714285714285716	482
FBgn0037106	500	500	497	3	2	1.5	497
FBgn0037107	501	500	429	73	6	12.166666666666666	428
FBgn0037108	501	500	492	10	4	2.5	491
FBgn0037109	544	500	507	81	10	8.1	463
FBgn0037110	555	500	251	359	7	51.285714285714285	196
FBgn0037114	512	500	512	12	1	12	500
FBgn0037115	525	500	354	196	12	16.333333333333332	329
FBgn0037116	511	500	473	49	10	4.9	462
FBgn0037117	337	336	298	40	6	6.666666666666667	297
FBgn0037120	501	500	496	6	2	3	495
FBgn0037121	518	500	499	37	7	5.285714285714286	481
FBgn0037122	479	479	307	172	3	57.333333333333336	307
FBgn0037123	500	500	498	2	1	2	498
FBgn0037124	513	500	504	22	4	5.5	491
FBgn0037125	513	500	504	22	4	5.5	491
FBgn0037126	542	500	534	50	5	10	492
FBgn0037127	501	500	501	1	1	1	500
FBgn0037128	500	500	499	1	1	1	499
FBgn0037129	500	500	352	148	2	74	352
FBgn0037130	503	500	234	272	2	136	231
FBgn0037131	500	500	500	0	0	NA	500
FBgn0037133	503	500	500	6	2	3	497
FBgn0037135	564	500	533	95	11	8.636363636363637	469
FBgn0037139	500	500	496	4	1	4	496
FBgn0037140	523	500	507	39	6	6.5	484
FBgn0037141	524	500	479	69	10	6.9	455
FBgn0037142	524	500	493	55	8	6.875	469
FBgn0037143	494	482	481	25	5	5	469
FBgn0037146	517	500	516	18	2	9	499
FBgn0037149	500	500	64	436	2	218	64
FBgn0037151	510	500	509	11	2	5.5	499
FBgn0037162	500	500	490	10	4	2.5	490
FBgn0037163	507	500	493	21	4	5.25	486
FBgn0037166	546	500	514	78	11	7.090909090909091	468
FBgn0037167	504	500	503	5	2	2.5	499
FBgn0037170	502	500	468	36	6	6	466
FBgn0037171	542	500	531	53	5	10.6	489
FBgn0037172	505	500	500	10	4	2.5	495
FBgn0037174	505	500	494	16	4	4	489
FBgn0037175	500	500	500	0	0	NA	500
FBgn0037176	500	500	500	0	0	NA	500
FBgn0037178	506	500	489	23	5	4.6	483
FBgn0037181	500	500	496	4	4	1	496
FBgn0037182	512	500	485	39	7	5.571428571428571	473
FBgn0037184	519	500	497	41	3	13.666666666666666	478
FBgn0037185	519	500	492	46	4	11.5	473
FBgn0037186	503	500	484	22	3	7.333333333333333	481
FBgn0037188	527	500	516	38	8	4.75	489
FBgn0037191	500	500	28	472	2	236	28
FBgn0037195	516	500	512	20	3	6.666666666666667	496
FBgn0037197	500	500	424	76	5	15.2	424
FBgn0037199	501	500	501	1	1	1	500
FBgn0037202	501	500	501	1	1	1	500
FBgn0037204	517	500	512	22	4	5.5	495
FBgn0037206	505	500	477	33	4	8.25	472
FBgn0037207	451	449	450	3	2	1.5	448
FBgn0037213	517	500	348	186	7	26.571428571428573	331
FBgn0037217	510	500	469	51	3	17	459
FBgn0037223	525	500	468	82	5	16.4	443
FBgn0037224	500	500	495	5	2	2.5	495
FBgn0037225	520	500	326	214	9	23.77777777777778	306
FBgn0037227	516	500	514	18	3	6	498
FBgn0037230	547	500	537	57	4	14.25	490
FBgn0037231	595	500	544	146	10	14.6	449
FBgn0037232	620	500	618	122	11	11.090909090909092	498
FBgn0037234	522	500	515	29	7	4.142857142857143	493
FBgn0037235	503	500	493	13	2	6.5	490
FBgn0037236	500	500	499	1	1	1	499
FBgn0037240	358	358	358	0	0	NA	358
FBgn0037241	502	500	304	200	6	33.333333333333336	302
FBgn0037242	503	500	322	184	3	61.333333333333336	319
FBgn0037244	513	500	488	38	7	5.428571428571429	475
FBgn0037248	503	500	286	220	5	44	283
FBgn0037249	554	500	552	56	5	11.2	498
FBgn0037250	502	500	502	2	1	2	500
FBgn0037251	500	500	488	12	1	12	488
FBgn0037255	554	500	518	90	13	6.923076923076923	464
FBgn0037260	517	500	513	21	6	3.5	496
FBgn0037261	508	500	482	34	4	8.5	474
FBgn0037265	535	500	527	43	6	7.166666666666667	492
FBgn0037275	501	500	491	11	4	2.75	490
FBgn0037276	517	500	499	35	7	5	482
FBgn0037279	533	500	519	47	9	5.222222222222222	486
FBgn0037280	500	500	228	272	1	272	228
FBgn0037282	502	500	458	46	6	7.666666666666667	456
FBgn0037283	474	456	470	22	9	2.4444444444444446	452
FBgn0037288	506	500	447	65	4	16.25	441
FBgn0037290	504	500	458	50	5	10	454
FBgn0037292	503	500	503	3	1	3	500
FBgn0037295	502	500	497	7	4	1.75	495
FBgn0037296	514	500	513	15	3	5	499
FBgn0037297	507	500	378	136	7	19.428571428571427	371
FBgn0037299	500	500	91	409	1	409	91
FBgn0037301	523	500	521	25	7	3.5714285714285716	498
FBgn0037305	525	500	509	41	5	8.2	484
FBgn0037307	517	500	493	41	8	5.125	476
FBgn0037310	527	500	510	44	10	4.4	483
FBgn0037312	522	500	522	22	7	3.142857142857143	500
FBgn0037313	522	500	519	25	8	3.125	497
FBgn0037315	500	500	126	374	2	187	126
FBgn0037322	505	500	504	6	3	2	499
FBgn0037323	500	500	496	4	1	4	496
FBgn0037324	501	500	464	38	6	6.333333333333333	463
FBgn0037325	504	500	488	20	5	4	484
FBgn0037326	513	500	466	60	6	10	453
FBgn0037327	547	500	508	86	11	7.818181818181818	461
FBgn0037328	509	500	493	25	4	6.25	484
FBgn0037329	518	500	497	39	8	4.875	479
FBgn0037330	505	500	472	38	9	4.222222222222222	467
FBgn0037332	560	500	516	104	12	8.666666666666666	456
FBgn0037336	510	500	361	159	10	15.9	351
FBgn0037340	500	500	499	1	1	1	499
FBgn0037341	500	500	500	0	0	NA	500
FBgn0037342	507	500	499	15	5	3	492
FBgn0037344	501	500	177	325	3	108.33333333333333	176
FBgn0037345	501	500	183	319	4	79.75	182
FBgn0037347	510	500	495	25	5	5	485
FBgn0037351	516	500	505	27	4	6.75	489
FBgn0037354	492	457	459	68	9	7.555555555555555	424
FBgn0037356	551	500	535	67	8	8.375	484
FBgn0037358	500	500	493	7	4	1.75	493
FBgn0037359	500	500	494	6	3	2	494
FBgn0037363	501	500	454	48	4	12	453
FBgn0037364	543	500	520	66	9	7.333333333333333	477
FBgn0037369	509	500	454	64	7	9.142857142857142	445
FBgn0037371	510	500	506	14	3	4.666666666666667	496
FBgn0037372	395	383	380	27	6	4.5	368
FBgn0037375	500	500	483	17	3	5.666666666666667	483
FBgn0037376	508	500	508	8	1	8	500
FBgn0037377	483	473	472	21	5	4.2	462
FBgn0037378	501	500	500	2	2	1	499
FBgn0037379	501	500	500	2	2	1	499
FBgn0037382	559	500	530	88	10	8.8	471
FBgn0037383	522	500	522	22	2	11	500
FBgn0037384	500	500	500	0	0	NA	500
FBgn0037387	507	500	461	53	5	10.6	454
FBgn0037389	500	500	99	401	3	133.66666666666666	99
FBgn0037391	500	500	121	379	2	189.5	121
FBgn0037395	509	500	509	9	6	1.5	500
FBgn0037398	515	500	510	20	6	3.3333333333333335	495
FBgn0037399	517	500	237	297	3	99	220
FBgn0037402	500	500	497	3	1	3	497
FBgn0037406	528	500	502	54	3	18	474
FBgn0037408	505	500	488	22	5	4.4	483
FBgn0037409	519	500	501	37	7	5.285714285714286	482
FBgn0037410	500	500	500	0	0	NA	500
FBgn0037411	500	500	497	3	1	3	497
FBgn0037412	507	500	464	50	7	7.142857142857143	457
FBgn0037413	509	500	477	41	2	20.5	468
FBgn0037414	500	500	496	4	1	4	496
FBgn0037415	501	500	500	2	2	1	499
FBgn0037416	500	500	498	2	1	2	498
FBgn0037419	504	500	436	72	7	10.285714285714286	432
FBgn0037420	500	500	472	28	6	4.666666666666667	472
FBgn0037421	563	500	542	84	8	10.5	479
FBgn0037422	528	500	481	75	4	18.75	453
FBgn0037424	514	500	513	15	2	7.5	499
FBgn0037427	504	500	360	148	3	49.333333333333336	356
FBgn0037428	501	500	467	35	2	17.5	466
FBgn0037429	510	500	501	19	4	4.75	491
FBgn0037430	573	500	547	99	5	19.8	474
FBgn0037433	344	342	299	47	3	15.666666666666666	297
FBgn0037435	526	500	513	39	7	5.571428571428571	487
FBgn0037436	548	500	528	68	2	34	480
FBgn0037439	510	500	458	62	8	7.75	448
FBgn0037440	503	500	345	161	4	40.25	342
FBgn0037442	416	384	374	74	5	14.8	342
FBgn0037445	514	500	139	389	2	194.5	125
FBgn0037447	508	500	493	23	6	3.8333333333333335	485
FBgn0037448	504	500	504	4	1	4	500
FBgn0037455	511	500	508	14	2	7	497
FBgn0037460	525	500	460	90	11	8.181818181818182	435
FBgn0037461	507	500	491	23	4	5.75	484
FBgn0037462	500	500	489	11	2	5.5	489
FBgn0037465	518	500	511	25	4	6.25	493
FBgn0037466	520	500	513	27	5	5.4	493
FBgn0037468	506	500	483	29	12	2.4166666666666665	477
FBgn0037470	501	500	498	4	3	1.3333333333333333	497
FBgn0037472	530	500	512	48	6	8	482
FBgn0037473	505	500	355	155	7	22.142857142857142	350
FBgn0037475	500	500	497	3	1	3	497
FBgn0037477	536	500	515	57	8	7.125	479
FBgn0037478	464	428	443	57	8	7.125	407
FBgn0037481	501	500	487	15	4	3.75	486
FBgn0037482	516	500	514	18	4	4.5	498
FBgn0037483	503	500	496	10	2	5	493
FBgn0037485	509	500	468	50	5	10	459
FBgn0037486	506	500	494	18	4	4.5	488
FBgn0037487	509	500	506	12	2	6	497
FBgn0037488	500	500	486	14	1	14	486
FBgn0037489	509	500	498	20	5	4	489
FBgn0037490	501	500	479	23	2	11.5	478
FBgn0037491	500	500	499	1	1	1	499
FBgn0037492	506	500	502	10	4	2.5	496
FBgn0037493	537	500	426	148	9	16.444444444444443	389
FBgn0037498	505	500	195	315	3	105	190
FBgn0037500	514	500	497	31	5	6.2	483
FBgn0037501	500	500	373	127	1	127	373
FBgn0037503	510	500	504	16	3	5.333333333333333	494
FBgn0037512	516	500	507	25	7	3.5714285714285716	491
FBgn0037513	511	500	457	65	6	10.833333333333334	446
FBgn0037514	507	500	479	35	8	4.375	472
FBgn0037516	500	500	481	19	5	3.8	481
FBgn0037517	500	500	497	3	1	3	497
FBgn0037518	517	500	384	150	5	30	367
FBgn0037520	500	500	486	14	4	3.5	486
FBgn0037521	509	500	472	46	10	4.6	463
FBgn0037525	513	500	502	24	5	4.8	489
FBgn0037526	504	500	503	5	2	2.5	499
FBgn0037529	559	500	545	73	10	7.3	486
FBgn0037530	501	500	486	16	5	3.2	485
FBgn0037531	521	500	411	131	4	32.75	390
FBgn0037533	500	500	498	2	2	1	498
FBgn0037535	507	500	479	35	5	7	472
FBgn0037536	507	500	490	24	5	4.8	483
FBgn0037538	503	500	487	19	4	4.75	484
FBgn0037539	524	500	497	51	11	4.636363636363637	473
FBgn0037540	524	500	501	47	10	4.7	477
FBgn0037541	505	500	496	14	4	3.5	491
FBgn0037543	501	500	495	7	4	1.75	494
FBgn0037544	515	500	514	16	2	8	499
FBgn0037547	512	500	483	41	5	8.2	471
FBgn0037549	507	500	506	8	3	2.6666666666666665	499
FBgn0037550	539	500	526	52	3	17.333333333333332	487
FBgn0037551	508	500	493	23	3	7.666666666666667	485
FBgn0037552	531	500	516	46	11	4.181818181818182	485
FBgn0037553	485	483	257	230	4	57.5	255
FBgn0037555	538	500	510	66	13	5.076923076923077	472
FBgn0037556	521	500	520	22	4	5.5	499
FBgn0037560	506	463	475	74	5	14.8	432
FBgn0037561	506	500	506	6	2	3	500
FBgn0037563	524	500	449	99	8	12.375	425
FBgn0037565	508	500	461	55	8	6.875	453
FBgn0037566	508	500	461	55	8	6.875	453
FBgn0037571	500	500	491	9	1	9	491
FBgn0037572	500	500	470	30	3	10	470
FBgn0037574	508	500	493	23	5	4.6	485
FBgn0037576	558	500	556	60	6	10	498
FBgn0037577	519	500	477	61	6	10.166666666666666	458
FBgn0037578	510	500	507	13	5	2.6	497
FBgn0037579	507	500	503	11	4	2.75	496
FBgn0037584	507	500	496	18	3	6	489
FBgn0037590	377	375	355	24	3	8	353
FBgn0037591	504	500	504	4	1	4	500
FBgn0037592	518	483	497	56	11	5.090909090909091	462
FBgn0037594	504	500	495	13	3	4.333333333333333	491
FBgn0037601	505	500	372	138	5	27.6	367
FBgn0037602	500	500	497	3	2	1.5	497
FBgn0037603	500	500	500	0	0	NA	500
FBgn0037607	500	500	493	7	2	3.5	493
FBgn0037608	530	500	493	67	12	5.583333333333333	463
FBgn0037609	510	500	507	13	3	4.333333333333333	497
FBgn0037612	524	500	471	77	9	8.555555555555555	447
FBgn0037613	514	500	512	16	4	4	498
FBgn0037614	502	500	493	11	3	3.6666666666666665	491
FBgn0037616	503	500	484	22	4	5.5	481
FBgn0037618	528	500	512	44	6	7.333333333333333	484
FBgn0037621	503	500	472	34	8	4.25	469
FBgn0037622	503	500	471	35	8	4.375	468
FBgn0037623	500	500	500	0	0	NA	500
FBgn0037624	500	500	499	1	1	1	499
FBgn0037625	500	500	465	35	4	8.75	465
FBgn0037626	528	500	503	53	6	8.833333333333334	475
FBgn0037627	500	500	500	0	0	NA	500
FBgn0037630	501	500	475	27	5	5.4	474
FBgn0037632	553	500	547	59	4	14.75	494
FBgn0037633	501	500	494	8	3	2.6666666666666665	493
FBgn0037635	521	500	512	30	7	4.285714285714286	491
FBgn0037637	500	500	482	18	5	3.6	482
FBgn0037638	513	500	495	31	6	5.166666666666667	482
FBgn0037643	504	500	482	26	4	6.5	478
FBgn0037644	549	500	546	52	6	8.666666666666666	497
FBgn0037647	527	500	518	36	6	6	491
FBgn0037648	500	500	498	2	1	2	498
FBgn0037650	514	500	437	91	7	13	423
FBgn0037652	506	500	506	6	1	6	500
FBgn0037653	500	500	464	36	6	6	464
FBgn0037654	491	464	471	47	8	5.875	444
FBgn0037656	502	500	502	2	2	1	500
FBgn0037657	553	500	550	56	6	9.333333333333334	497
FBgn0037659	547	500	533	61	7	8.714285714285714	486
FBgn0037660	500	500	500	0	0	NA	500
FBgn0037661	500	500	500	0	0	NA	500
FBgn0037662	510	500	501	19	7	2.7142857142857144	491
FBgn0037664	506	500	488	24	4	6	482
FBgn0037665	532	500	489	75	11	6.818181818181818	457
FBgn0037666	519	500	423	115	9	12.777777777777779	404
FBgn0037667	379	368	373	17	8	2.125	362
FBgn0037669	582	500	579	85	7	12.142857142857142	497
FBgn0037670	582	500	579	85	7	12.142857142857142	497
FBgn0037671	391	387	360	35	7	5	356
FBgn0037672	509	500	419	99	2	49.5	410
FBgn0037675	500	500	461	39	3	13	461
FBgn0037676	518	500	517	19	3	6.333333333333333	499
FBgn0037677	552	500	539	65	7	9.285714285714286	487
FBgn0037678	506	500	504	8	4	2	498
FBgn0037679	517	500	515	19	6	3.1666666666666665	498
FBgn0037680	519	500	511	27	8	3.375	492
FBgn0037683	516	500	512	20	6	3.3333333333333335	496
FBgn0037685	505	500	503	7	4	1.75	498
FBgn0037686	518	500	518	18	3	6	500
FBgn0037687	518	500	515	21	4	5.25	497
FBgn0037688	505	500	499	11	4	2.75	494
FBgn0037690	505	500	502	8	6	1.3333333333333333	497
FBgn0037696	500	500	471	29	4	7.25	471
FBgn0037697	500	500	453	47	6	7.833333333333333	453
FBgn0037698	500	500	499	1	1	1	499
FBgn0037700	519	500	462	76	9	8.444444444444445	443
FBgn0037707	513	500	440	86	5	17.2	427
FBgn0037708	502	500	485	19	6	3.1666666666666665	483
FBgn0037709	502	500	485	19	6	3.1666666666666665	483
FBgn0037710	509	500	506	12	3	4	497
FBgn0037714	500	500	322	178	1	178	322
FBgn0037715	500	500	488	12	3	4	488
FBgn0037716	528	500	497	59	9	6.555555555555555	469
FBgn0037717	458	442	446	28	5	5.6	430
FBgn0037718	515	500	512	18	3	6	497
FBgn0037719	512	500	503	21	3	7	491
FBgn0037720	519	500	510	28	4	7	491
FBgn0037721	501	500	489	13	4	3.25	488
FBgn0037722	501	500	493	9	3	3	492
FBgn0037723	500	500	496	4	2	2	496
FBgn0037724	500	500	499	1	1	1	499
FBgn0037727	579	500	558	100	8	12.5	479
FBgn0037730	403	402	403	1	1	1	402
FBgn0037736	500	500	499	1	1	1	499
FBgn0037737	505	500	455	55	7	7.857142857142857	450
FBgn0037739	500	500	490	10	3	3.3333333333333335	490
FBgn0037742	503	500	501	5	2	2.5	498
FBgn0037743	500	500	497	3	2	1.5	497
FBgn0037747	500	500	496	4	1	4	496
FBgn0037749	430	430	430	0	0	NA	430
FBgn0037750	503	500	305	201	4	50.25	302
FBgn0037751	500	500	391	109	6	18.166666666666668	391
FBgn0037753	531	500	529	33	5	6.6	498
FBgn0037754	504	500	494	14	6	2.3333333333333335	490
FBgn0037755	509	500	505	13	5	2.6	496
FBgn0037756	518	500	516	20	6	3.3333333333333335	498
FBgn0037757	356	353	354	5	3	1.6666666666666667	351
FBgn0037758	502	500	496	8	4	2	494
FBgn0037759	502	500	499	5	3	1.6666666666666667	497
FBgn0037760	516	500	516	16	2	8	500
FBgn0037761	533	500	511	55	7	7.857142857142857	478
FBgn0037762	355	355	279	76	4	19	279
FBgn0037763	505	500	475	35	5	7	470
FBgn0037764	503	500	479	27	5	5.4	476
FBgn0037765	513	500	513	13	2	6.5	500
FBgn0037766	506	500	494	18	5	3.6	488
FBgn0037770	517	500	505	29	4	7.25	488
FBgn0037772	500	500	484	16	3	5.333333333333333	484
FBgn0037773	507	500	465	49	5	9.8	458
FBgn0037777	507	500	505	9	3	3	498
FBgn0037778	500	500	500	0	0	NA	500
FBgn0037779	518	500	508	28	6	4.666666666666667	490
FBgn0037780	518	500	508	28	6	4.666666666666667	490
FBgn0037783	533	500	511	55	5	11	478
FBgn0037786	508	500	504	12	4	3	496
FBgn0037788	501	500	466	36	5	7.2	465
FBgn0037794	500	500	484	16	5	3.2	484
FBgn0037796	509	500	461	57	5	11.4	452
FBgn0037797	513	500	503	23	2	11.5	490
FBgn0037798	500	500	498	2	2	1	498
FBgn0037801	443	443	441	2	1	2	441
FBgn0037802	504	500	499	9	4	2.25	495
FBgn0037807	518	500	517	19	5	3.8	499
FBgn0037809	501	500	479	23	5	4.6	478
FBgn0037810	521	500	511	31	6	5.166666666666667	490
FBgn0037814	500	500	493	7	2	3.5	493
FBgn0037815	502	500	498	6	3	2	496
FBgn0037816	531	500	520	42	6	7	489
FBgn0037817	536	500	518	54	9	6	482
FBgn0037818	501	500	496	6	5	1.2	495
FBgn0037819	500	500	483	17	5	3.4	483
FBgn0037826	505	500	481	29	7	4.142857142857143	476
FBgn0037827	507	500	505	9	2	4.5	498
FBgn0037828	513	500	488	38	6	6.333333333333333	475
FBgn0037829	544	500	511	77	7	11	467
FBgn0037831	524	500	496	52	6	8.666666666666666	472
FBgn0037832	503	500	500	6	2	3	497
FBgn0037834	519	500	516	22	4	5.5	497
FBgn0037835	500	500	495	5	3	1.6666666666666667	495
FBgn0037837	500	500	499	1	1	1	499
FBgn0037838	500	500	487	13	1	13	487
FBgn0037841	509	500	501	17	3	5.666666666666667	492
FBgn0037842	500	500	499	1	1	1	499
FBgn0037843	500	500	500	0	0	NA	500
FBgn0037844	547	500	534	60	6	10	487
FBgn0037845	500	500	488	12	1	12	488
FBgn0037846	500	500	499	1	1	1	499
FBgn0037848	500	500	494	6	3	2	494
FBgn0037849	517	500	484	50	7	7.142857142857143	467
FBgn0037850	502	500	479	25	7	3.5714285714285716	477
FBgn0037852	347	345	347	2	2	1	345
FBgn0037855	500	500	499	1	1	1	499
FBgn0037857	500	500	474	26	4	6.5	474
FBgn0037860	501	500	487	15	3	5	486
FBgn0037862	503	500	501	5	2	2.5	498
FBgn0037870	531	500	512	50	6	8.333333333333334	481
FBgn0037874	518	500	512	24	6	4	494
FBgn0037875	540	500	504	76	10	7.6	464
FBgn0037876	529	500	525	33	3	11	496
FBgn0037877	464	440	451	37	5	7.4	427
FBgn0037878	503	500	383	123	4	30.75	380
FBgn0037879	501	500	162	340	5	68	161
FBgn0037880	396	384	378	30	5	6	366
FBgn0037882	502	500	494	10	5	2	492
FBgn0037883	539	500	537	41	2	20.5	498
FBgn0037884	528	500	503	53	6	8.833333333333334	475
FBgn0037885	502	500	488	16	4	4	486
FBgn0037890	500	500	497	3	3	1	497
FBgn0037891	500	500	496	4	3	1.3333333333333333	496
FBgn0037892	502	500	499	5	3	1.6666666666666667	497
FBgn0037894	503	500	427	79	7	11.285714285714286	424
FBgn0037895	501	500	492	10	3	3.3333333333333335	491
FBgn0037896	502	500	492	12	5	2.4	490
FBgn0037897	502	500	499	5	4	1.25	497
FBgn0037898	507	500	504	10	5	2	497
FBgn0037899	503	500	503	3	2	1.5	500
FBgn0037900	500	500	499	1	1	1	499
FBgn0037901	501	500	496	6	4	1.5	495
FBgn0037902	514	500	508	20	4	5	494
FBgn0037906	500	500	486	14	2	7	486
FBgn0037908	509	500	506	12	2	6	497
FBgn0037910	532	500	521	43	7	6.142857142857143	489
FBgn0037911	503	500	503	3	1	3	500
FBgn0037915	500	500	439	61	1	61	439
FBgn0037916	500	500	449	51	2	25.5	449
FBgn0037918	509	500	478	40	4	10	469
FBgn0037920	500	500	487	13	3	4.333333333333333	487
FBgn0037922	511	500	503	19	6	3.1666666666666665	492
FBgn0037923	520	500	519	21	3	7	499
FBgn0037924	364	349	364	15	2	7.5	349
FBgn0037926	505	500	492	18	6	3	487
FBgn0037930	506	500	485	27	6	4.5	479
FBgn0037931	438	435	437	4	2	2	434
FBgn0037933	501	500	498	4	4	1	497
FBgn0037934	449	448	427	23	5	4.6	426
FBgn0037936	416	393	404	35	6	5.833333333333333	381
FBgn0037937	508	500	469	47	6	7.833333333333333	461
FBgn0037939	512	500	512	12	4	3	500
FBgn0037940	505	500	505	5	2	2.5	500
FBgn0037941	500	500	494	6	2	3	494
FBgn0037942	518	500	510	26	6	4.333333333333333	492
FBgn0037943	511	500	502	20	3	6.666666666666667	491
FBgn0037944	500	500	492	8	3	2.6666666666666665	492
FBgn0037949	500	500	500	0	0	NA	500
FBgn0037950	521	500	506	36	4	9	485
FBgn0037955	506	500	494	18	2	9	488
FBgn0037956	510	500	452	68	5	13.6	442
FBgn0037958	502	500	495	9	3	3	493
FBgn0037960	505	500	468	42	7	6	463
FBgn0037962	509	500	508	10	2	5	499
FBgn0037963	542	500	539	45	6	7.5	497
FBgn0037964	504	500	492	16	5	3.2	488
FBgn0037970	500	500	500	0	0	NA	500
FBgn0037972	474	442	472	34	3	11.333333333333334	440
FBgn0037973	406	403	356	53	7	7.571428571428571	353
FBgn0037974	500	500	162	338	2	169	162
FBgn0037975	481	457	418	87	5	17.4	394
FBgn0037976	500	500	486	14	2	7	486
FBgn0037978	509	500	461	57	4	14.25	452
FBgn0037979	509	500	460	58	5	11.6	451
FBgn0037980	500	500	448	52	2	26	448
FBgn0037981	528	500	504	52	7	7.428571428571429	476
FBgn0037985	504	500	485	23	6	3.8333333333333335	481
FBgn0037986	504	500	504	4	1	4	500
FBgn0037987	508	500	499	17	4	4.25	491
FBgn0037989	501	500	438	64	4	16	437
FBgn0037992	575	500	562	88	7	12.571428571428571	487
FBgn0037993	503	500	488	18	3	6	485
FBgn0037994	555	500	553	57	5	11.4	498
FBgn0037995	502	500	499	5	3	1.6666666666666667	497
FBgn0037996	506	500	498	14	3	4.666666666666667	492
FBgn0037997	506	500	506	6	1	6	500
FBgn0037999	510	500	509	11	3	3.6666666666666665	499
FBgn0038000	505	500	503	7	5	1.4	498
FBgn0038001	358	344	337	35	4	8.75	323
FBgn0038002	500	500	483	17	1	17	483
FBgn0038003	500	500	495	5	4	1.25	495
FBgn0038006	376	374	363	15	5	3	361
FBgn0038007	503	500	500	6	3	2	497
FBgn0038008	512	500	512	12	2	6	500
FBgn0038011	500	500	500	0	0	NA	500
FBgn0038012	500	500	497	3	1	3	497
FBgn0038016	512	500	469	55	4	13.75	457
FBgn0038017	507	500	409	105	5	21	402
FBgn0038020	399	377	385	36	7	5.142857142857143	363
FBgn0038028	505	500	505	5	2	2.5	500
FBgn0038029	506	500	500	12	5	2.4	494
FBgn0038037	525	500	387	163	9	18.11111111111111	362
FBgn0038038	525	500	390	160	9	17.77777777777778	365
FBgn0038043	500	500	326	174	2	87	326
FBgn0038045	533	500	526	40	7	5.714285714285714	493
FBgn0038046	503	500	496	10	7	1.4285714285714286	493
FBgn0038047	503	500	500	6	5	1.2	497
FBgn0038049	501	500	473	29	4	7.25	472
FBgn0038055	526	500	525	27	5	5.4	499
FBgn0038056	501	500	500	2	2	1	499
FBgn0038057	513	500	508	18	5	3.6	495
FBgn0038063	509	500	508	10	3	3.3333333333333335	499
FBgn0038065	500	500	489	11	1	11	489
FBgn0038070	506	500	506	6	2	3	500
FBgn0038071	527	500	510	44	6	7.333333333333333	483
FBgn0038072	508	500	506	10	3	3.3333333333333335	498
FBgn0038073	500	500	467	33	2	16.5	467
FBgn0038074	508	500	501	15	4	3.75	493
FBgn0038076	503	500	490	16	3	5.333333333333333	487
FBgn0038078	512	500	509	15	4	3.75	497
FBgn0038079	513	500	512	14	4	3.5	499
FBgn0038080	506	500	505	7	2	3.5	499
FBgn0038082	539	500	496	82	6	13.666666666666666	457
FBgn0038083	512	500	503	21	7	3	491
FBgn0038084	500	500	499	1	1	1	499
FBgn0038087	500	500	489	11	2	5.5	489
FBgn0038088	500	500	496	4	1	4	496
FBgn0038089	500	500	491	9	3	3	491
FBgn0038090	519	500	490	48	5	9.6	471
FBgn0038092	506	500	490	22	4	5.5	484
FBgn0038095	550	500	537	63	10	6.3	487
FBgn0038098	501	500	478	24	4	6	477
FBgn0038099	501	500	487	15	3	5	486
FBgn0038100	376	374	372	6	4	1.5	370
FBgn0038102	500	500	495	5	1	5	495
FBgn0038105	516	500	496	36	5	7.2	480
FBgn0038106	516	500	496	36	5	7.2	480
FBgn0038108	522	500	508	36	11	3.272727272727273	486
FBgn0038109	500	500	500	0	0	NA	500
FBgn0038110	507	500	495	19	5	3.8	488
FBgn0038113	450	445	384	71	7	10.142857142857142	379
FBgn0038114	505	500	484	26	3	8.666666666666666	479
FBgn0038115	518	500	291	245	6	40.833333333333336	273
FBgn0038118	500	500	500	0	0	NA	500
FBgn0038122	500	500	243	257	2	128.5	243
FBgn0038123	504	500	466	42	5	8.4	462
FBgn0038124	500	500	457	43	1	43	457
FBgn0038125	544	500	471	117	3	39	427
FBgn0038126	501	500	501	1	1	1	500
FBgn0038127	501	500	374	128	4	32	373
FBgn0038129	517	500	505	29	7	4.142857142857143	488
FBgn0038130	514	500	501	27	5	5.4	487
FBgn0038131	519	500	519	19	2	9.5	500
FBgn0038132	500	500	466	34	4	8.5	466
FBgn0038133	501	500	497	5	3	1.6666666666666667	496
FBgn0038134	500	500	494	6	1	6	494
FBgn0038135	521	500	521	21	2	10.5	500
FBgn0038136	531	500	521	41	7	5.857142857142857	490
FBgn0038139	501	500	469	33	3	11	468
FBgn0038140	502	500	492	12	5	2.4	490
FBgn0038142	524	500	501	47	7	6.714285714285714	477
FBgn0038143	527	500	521	33	7	4.714285714285714	494
FBgn0038144	542	500	538	46	7	6.571428571428571	496
FBgn0038145	551	500	532	70	6	11.666666666666666	481
FBgn0038146	517	500	503	31	6	5.166666666666667	486
FBgn0038147	500	500	479	21	4	5.25	479
FBgn0038148	502	500	489	15	6	2.5	487
FBgn0038149	514	500	124	404	2	202	110
FBgn0038150	452	436	448	20	4	5	432
FBgn0038151	527	500	525	29	5	5.8	498
FBgn0038153	507	500	459	55	11	5	452
FBgn0038156	504	500	504	4	1	4	500
FBgn0038157	504	500	468	40	3	13.333333333333334	464
FBgn0038158	503	500	490	16	4	4	487
FBgn0038159	524	500	492	56	7	8	468
FBgn0038160	524	500	498	50	6	8.333333333333334	474
FBgn0038161	502	500	488	16	5	3.2	486
FBgn0038163	512	500	498	26	6	4.333333333333333	486
FBgn0038165	505	500	462	48	8	6	457
FBgn0038166	500	500	498	2	1	2	498
FBgn0038168	506	500	468	44	8	5.5	462
FBgn0038170	501	500	498	4	2	2	497
FBgn0038172	509	500	508	10	6	1.6666666666666667	499
FBgn0038173	504	500	502	6	4	1.5	498
FBgn0038179	512	500	501	23	4	5.75	489
FBgn0038180	504	500	495	13	5	2.6	491
FBgn0038181	502	500	465	39	6	6.5	463
FBgn0038183	556	500	551	61	12	5.083333333333333	495
FBgn0038186	500	500	490	10	3	3.3333333333333335	490
FBgn0038188	501	500	466	36	5	7.2	465
FBgn0038189	541	500	499	83	6	13.833333333333334	458
FBgn0038190	520	500	495	45	11	4.090909090909091	475
FBgn0038194	512	500	474	50	7	7.142857142857143	462
FBgn0038195	526	500	509	43	6	7.166666666666667	483
FBgn0038196	514	500	459	69	11	6.2727272727272725	445
FBgn0038197	510	500	456	64	5	12.8	446
FBgn0038198	508	500	499	17	5	3.4	491
FBgn0038199	517	500	375	159	4	39.75	358
FBgn0038200	503	500	475	31	3	10.333333333333334	472
FBgn0038201	502	500	501	3	2	1.5	499
FBgn0038202	503	500	502	4	2	2	499
FBgn0038203	505	500	497	13	7	1.8571428571428572	492
FBgn0038204	470	456	462	22	8	2.75	448
FBgn0038205	502	500	497	7	4	1.75	495
FBgn0038206	509	500	491	27	5	5.4	482
FBgn0038207	527	500	477	77	8	9.625	450
FBgn0038208	393	381	384	21	3	7	372
FBgn0038209	486	486	121	365	3	121.66666666666667	121
FBgn0038210	543	500	519	67	5	13.4	476
FBgn0038211	448	440	447	9	3	3	439
FBgn0038213	501	500	489	13	4	3.25	488
FBgn0038214	513	500	512	14	5	2.8	499
FBgn0038218	503	500	503	3	1	3	500
FBgn0038219	500	500	497	3	1	3	497
FBgn0038221	501	500	471	31	6	5.166666666666667	470
FBgn0038223	505	500	505	5	1	5	500
FBgn0038224	505	500	503	7	2	3.5	498
FBgn0038225	524	500	483	65	6	10.833333333333334	459
FBgn0038233	508	500	508	8	4	2	500
FBgn0038234	503	500	495	11	3	3.6666666666666665	492
FBgn0038235	502	500	466	38	6	6.333333333333333	464
FBgn0038236	514	500	505	23	7	3.2857142857142856	491
FBgn0038237	501	500	495	7	4	1.75	494
FBgn0038238	506	500	440	72	5	14.4	434
FBgn0038239	521	500	513	29	7	4.142857142857143	492
FBgn0038240	512	500	508	16	5	3.2	496
FBgn0038241	512	500	454	70	7	10	442
FBgn0038242	507	500	491	23	5	4.6	484
FBgn0038244	457	451	418	45	8	5.625	412
FBgn0038246	504	500	499	9	5	1.8	495
FBgn0038247	536	500	503	69	6	11.5	467
FBgn0038248	500	500	490	10	5	2	490
FBgn0038250	519	500	485	53	10	5.3	466
FBgn0038252	510	500	501	19	3	6.333333333333333	491
FBgn0038256	511	500	501	21	8	2.625	490
FBgn0038257	521	500	500	42	8	5.25	479
FBgn0038258	505	500	485	25	6	4.166666666666667	480
FBgn0038260	506	500	496	16	6	2.6666666666666665	490
FBgn0038261	523	500	478	68	9	7.555555555555555	455
FBgn0038262	555	500	530	80	7	11.428571428571429	475
FBgn0038266	515	500	474	56	8	7	459
FBgn0038268	513	500	494	32	3	10.666666666666666	481
FBgn0038269	500	500	384	116	3	38.666666666666664	384
FBgn0038271	501	500	501	1	1	1	500
FBgn0038272	528	500	517	39	10	3.9	489
FBgn0038273	519	500	515	23	5	4.6	496
FBgn0038274	500	500	262	238	2	119	262
FBgn0038275	505	500	430	80	6	13.333333333333334	425
FBgn0038277	505	500	442	68	8	8.5	437
FBgn0038279	523	500	504	42	9	4.666666666666667	481
FBgn0038280	500	500	490	10	1	10	490
FBgn0038281	500	500	466	34	2	17	466
FBgn0038282	516	500	482	50	3	16.666666666666668	466
FBgn0038285	500	500	493	7	4	1.75	493
FBgn0038286	501	500	490	12	3	4	489
FBgn0038291	519	500	508	30	4	7.5	489
FBgn0038294	500	500	493	7	2	3.5	493
FBgn0038295	500	500	489	11	4	2.75	489
FBgn0038296	513	500	497	29	4	7.25	484
FBgn0038299	524	500	497	51	6	8.5	473
FBgn0038300	525	500	495	55	8	6.875	470
FBgn0038301	522	500	521	23	5	4.6	499
FBgn0038302	522	500	520	24	6	4	498
FBgn0038303	524	500	505	43	9	4.777777777777778	481
FBgn0038304	528	500	518	38	9	4.222222222222222	490
FBgn0038306	518	500	498	38	8	4.75	480
FBgn0038307	518	500	483	53	11	4.818181818181818	465
FBgn0038309	532	500	531	33	4	8.25	499
FBgn0038311	501	500	495	7	4	1.75	494
FBgn0038312	503	500	492	14	4	3.5	489
FBgn0038313	500	500	483	17	3	5.666666666666667	483
FBgn0038315	505	500	474	36	4	9	469
FBgn0038316	528	500	526	30	3	10	498
FBgn0038318	507	500	479	35	4	8.75	472
FBgn0038319	394	376	288	124	7	17.714285714285715	270
FBgn0038320	508	500	499	17	2	8.5	491
FBgn0038321	526	500	523	29	6	4.833333333333333	497
FBgn0038324	500	500	497	3	2	1.5	497
FBgn0038325	511	500	484	38	7	5.428571428571429	473
FBgn0038326	511	500	490	32	5	6.4	479
FBgn0038327	500	500	492	8	2	4	492
FBgn0038330	503	500	480	26	7	3.7142857142857144	477
FBgn0038331	502	500	502	2	1	2	500
FBgn0038332	500	500	500	0	0	NA	500
FBgn0038334	509	500	491	27	6	4.5	482
FBgn0038337	500	500	496	4	1	4	496
FBgn0038339	512	500	480	44	2	22	468
FBgn0038342	539	500	523	55	6	9.166666666666666	484
FBgn0038343	514	500	485	43	6	7.166666666666667	471
FBgn0038344	529	500	507	51	9	5.666666666666667	478
FBgn0038345	510	500	413	107	3	35.666666666666664	403
FBgn0038348	469	455	459	24	5	4.8	445
FBgn0038349	462	439	401	84	9	9.333333333333334	378
FBgn0038350	502	500	495	9	2	4.5	493
FBgn0038353	510	500	489	31	5	6.2	479
FBgn0038354	501	500	494	8	3	2.6666666666666665	493
FBgn0038355	500	500	472	28	3	9.333333333333334	472
FBgn0038356	503	500	458	48	6	8	455
FBgn0038357	501	500	476	26	3	8.666666666666666	475
FBgn0038359	508	500	474	42	6	7	466
FBgn0038360	547	500	508	86	13	6.615384615384615	461
FBgn0038363	509	500	509	9	1	9	500
FBgn0038365	516	500	487	45	5	9	471
FBgn0038366	504	500	503	5	2	2.5	499
FBgn0038369	511	500	504	18	3	6	493
FBgn0038371	501	500	376	126	2	63	375
FBgn0038373	508	500	497	19	7	2.7142857142857144	489
FBgn0038376	502	500	493	11	3	3.6666666666666665	491
FBgn0038377	500	500	498	2	1	2	498
FBgn0038380	514	500	495	33	3	11	481
FBgn0038385	514	500	478	50	7	7.142857142857143	464
FBgn0038386	506	500	493	19	6	3.1666666666666665	487
FBgn0038387	502	500	452	52	4	13	450
FBgn0038388	500	500	498	2	1	2	498
FBgn0038389	500	500	499	1	1	1	499
FBgn0038390	500	500	499	1	1	1	499
FBgn0038391	500	500	500	0	0	NA	500
FBgn0038394	503	500	490	16	3	5.333333333333333	487
FBgn0038395	468	449	416	71	8	8.875	397
FBgn0038396	512	500	502	22	6	3.6666666666666665	490
FBgn0038397	502	500	502	2	2	1	500
FBgn0038398	520	500	473	67	7	9.571428571428571	453
FBgn0038400	510	500	448	72	3	24	438
FBgn0038401	532	500	519	45	6	7.5	487
FBgn0038402	517	500	502	32	7	4.571428571428571	485
FBgn0038404	500	500	478	22	4	5.5	478
FBgn0038405	501	500	501	1	1	1	500
FBgn0038407	517	500	517	17	2	8.5	500
FBgn0038412	504	500	498	10	3	3.3333333333333335	494
FBgn0038414	532	500	503	61	4	15.25	471
FBgn0038415	477	438	476	40	5	8	437
FBgn0038416	501	500	485	17	6	2.8333333333333335	484
FBgn0038418	503	500	496	10	4	2.5	493
FBgn0038419	500	500	500	0	0	NA	500
FBgn0038420	500	500	499	1	1	1	499
FBgn0038422	508	500	508	8	1	8	500
FBgn0038423	502	500	495	9	2	4.5	493
FBgn0038424	380	375	372	13	5	2.6	367
FBgn0038425	400	382	361	57	8	7.125	343
FBgn0038426	427	425	205	224	4	56	203
FBgn0038427	449	410	446	42	6	7	407
FBgn0038428	513	500	499	27	8	3.375	486
FBgn0038429	505	500	495	15	4	3.75	490
FBgn0038431	501	500	434	68	6	11.333333333333334	433
FBgn0038435	500	500	488	12	1	12	488
FBgn0038436	543	500	525	61	6	10.166666666666666	482
FBgn0038437	560	500	539	81	8	10.125	479
FBgn0038438	498	475	492	29	6	4.833333333333333	469
FBgn0038439	510	500	510	10	3	3.3333333333333335	500
FBgn0038445	510	500	457	63	4	15.75	447
FBgn0038446	525	500	469	81	5	16.2	444
FBgn0038447	502	500	488	16	4	4	486
FBgn0038449	500	500	446	54	2	27	446
FBgn0038450	511	500	510	12	5	2.4	499
FBgn0038451	519	500	505	33	9	3.6666666666666665	486
FBgn0038452	509	500	365	153	10	15.3	356
FBgn0038453	542	500	482	102	12	8.5	440
FBgn0038454	533	500	522	44	11	4	489
FBgn0038455	395	372	385	33	3	11	362
FBgn0038458	511	500	509	13	2	6.5	498
FBgn0038465	518	500	503	33	3	11	485
FBgn0038466	524	500	510	38	7	5.428571428571429	486
FBgn0038467	507	500	471	43	7	6.142857142857143	464
FBgn0038468	501	500	501	1	1	1	500
FBgn0038469	500	500	482	18	2	9	482
FBgn0038472	520	500	484	56	8	7	464
FBgn0038473	500	500	500	0	0	NA	500
FBgn0038474	500	500	498	2	1	2	498
FBgn0038475	500	500	482	18	4	4.5	482
FBgn0038476	505	500	488	22	5	4.4	483
FBgn0038478	501	500	471	31	6	5.166666666666667	470
FBgn0038481	538	500	526	50	5	10	488
FBgn0038482	502	500	502	2	1	2	500
FBgn0038484	505	500	466	44	7	6.285714285714286	461
FBgn0038485	501	500	439	63	5	12.6	438
FBgn0038487	538	500	522	54	7	7.714285714285714	484
FBgn0038488	503	500	502	4	2	2	499
FBgn0038492	515	500	497	33	6	5.5	482
FBgn0038494	500	500	487	13	2	6.5	487
FBgn0038498	500	500	485	15	2	7.5	485
FBgn0038505	503	500	492	14	5	2.8	489
FBgn0038506	339	339	339	0	0	NA	339
FBgn0038507	382	376	367	21	4	5.25	361
FBgn0038508	520	500	483	57	6	9.5	463
FBgn0038509	503	500	502	4	2	2	499
FBgn0038510	500	500	482	18	3	6	482
FBgn0038511	507	500	493	21	7	3	486
FBgn0038512	500	500	77	423	2	211.5	77
FBgn0038515	552	500	503	101	12	8.416666666666666	451
FBgn0038516	524	500	489	59	6	9.833333333333334	465
FBgn0038519	506	500	481	31	6	5.166666666666667	475
FBgn0038523	500	500	486	14	3	4.666666666666667	486
FBgn0038524	548	500	504	92	12	7.666666666666667	456
FBgn0038525	509	500	509	9	1	9	500
FBgn0038526	417	417	417	0	0	NA	417
FBgn0038527	500	500	499	1	1	1	499
FBgn0038528	500	500	499	1	1	1	499
FBgn0038531	500	500	500	0	0	NA	500
FBgn0038532	509	500	469	49	3	16.333333333333332	460
FBgn0038533	507	500	494	20	5	4	487
FBgn0038535	500	500	498	2	2	1	498
FBgn0038536	502	500	501	3	2	1.5	499
FBgn0038540	577	500	557	97	11	8.818181818181818	480
FBgn0038541	504	500	364	144	5	28.8	360
FBgn0038545	521	500	497	45	8	5.625	476
FBgn0038546	574	500	569	79	11	7.181818181818182	495
FBgn0038549	505	487	475	48	13	3.6923076923076925	457
FBgn0038550	507	500	484	30	9	3.3333333333333335	477
FBgn0038552	524	500	516	32	5	6.4	492
FBgn0038558	500	500	337	163	3	54.333333333333336	337
FBgn0038564	506	500	471	41	7	5.857142857142857	465
FBgn0038565	506	500	446	66	4	16.5	440
FBgn0038566	500	500	479	21	5	4.2	479
FBgn0038567	509	500	487	31	7	4.428571428571429	478
FBgn0038568	403	403	182	221	5	44.2	182
FBgn0038569	503	500	485	21	3	7	482
FBgn0038575	509	500	509	9	1	9	500
FBgn0038576	500	500	489	11	4	2.75	489
FBgn0038577	500	500	489	11	2	5.5	489
FBgn0038578	500	500	489	11	2	5.5	489
FBgn0038579	512	500	496	28	8	3.5	484
FBgn0038582	515	500	505	25	4	6.25	490
FBgn0038583	502	500	501	3	2	1.5	499
FBgn0038584	502	500	502	2	1	2	500
FBgn0038585	502	500	473	31	4	7.75	471
FBgn0038586	506	500	495	17	4	4.25	489
FBgn0038588	508	500	489	27	10	2.7	481
FBgn0038589	507	500	483	31	2	15.5	476
FBgn0038592	503	500	474	32	4	8	471
FBgn0038593	501	500	499	3	3	1	498
FBgn0038595	505	500	501	9	3	3	496
FBgn0038596	503	500	497	9	4	2.25	494
FBgn0038597	504	500	504	4	2	2	500
FBgn0038598	500	500	496	4	2	2	496
FBgn0038602	501	500	453	49	6	8.166666666666666	452
FBgn0038603	511	500	496	26	4	6.5	485
FBgn0038606	500	500	456	44	2	22	456
FBgn0038607	503	500	501	5	2	2.5	498
FBgn0038610	504	500	427	81	6	13.5	423
FBgn0038611	529	500	508	50	8	6.25	479
FBgn0038613	500	500	484	16	3	5.333333333333333	484
FBgn0038617	529	500	514	44	8	5.5	485
FBgn0038619	501	494	492	16	7	2.2857142857142856	485
FBgn0038626	520	500	495	45	10	4.5	475
FBgn0038629	505	500	504	6	4	1.5	499
FBgn0038632	505	500	496	14	5	2.8	491
FBgn0038638	362	362	359	3	1	3	359
FBgn0038640	508	500	507	9	5	1.8	499
FBgn0038642	501	500	489	13	3	4.333333333333333	488
FBgn0038643	513	500	484	42	7	6	471
FBgn0038645	506	500	491	21	4	5.25	485
FBgn0038646	509	500	491	27	6	4.5	482
FBgn0038647	503	500	469	37	9	4.111111111111111	466
FBgn0038649	506	500	461	51	4	12.75	455
FBgn0038651	500	500	478	22	2	11	478
FBgn0038652	501	500	342	160	2	80	341
FBgn0038653	512	500	483	41	5	8.2	471
FBgn0038654	534	500	523	45	6	7.5	489
FBgn0038655	500	500	473	27	5	5.4	473
FBgn0038658	508	500	494	22	7	3.142857142857143	486
FBgn0038659	547	500	529	65	9	7.222222222222222	482
FBgn0038660	513	500	480	46	10	4.6	467
FBgn0038662	543	500	475	111	13	8.538461538461538	432
FBgn0038666	500	500	500	0	0	NA	500
FBgn0038672	500	500	494	6	3	2	494
FBgn0038673	500	500	499	1	1	1	499
FBgn0038674	361	349	321	52	6	8.666666666666666	309
FBgn0038675	502	500	469	35	6	5.833333333333333	467
FBgn0038676	500	500	500	0	0	NA	500
FBgn0038678	502	500	457	47	7	6.714285714285714	455
FBgn0038679	502	500	410	94	5	18.8	408
FBgn0038680	504	500	493	15	6	2.5	489
FBgn0038681	505	500	482	28	7	4	477
FBgn0038682	513	500	498	28	6	4.666666666666667	485
FBgn0038683	359	354	329	35	4	8.75	324
FBgn0038685	524	500	518	30	8	3.75	494
FBgn0038686	509	500	502	16	7	2.2857142857142856	493
FBgn0038691	504	500	495	13	3	4.333333333333333	491
FBgn0038692	500	500	471	29	3	9.666666666666666	471
FBgn0038693	503	500	485	21	3	7	482
FBgn0038694	533	500	525	41	6	6.833333333333333	492
FBgn0038695	524	500	510	38	10	3.8	486
FBgn0038701	467	467	465	2	1	2	465
FBgn0038702	509	500	503	15	7	2.142857142857143	494
FBgn0038705	520	500	488	52	6	8.666666666666666	468
FBgn0038706	515	500	497	33	8	4.125	482
FBgn0038709	522	500	506	38	7	5.428571428571429	484
FBgn0038714	501	500	501	1	1	1	500
FBgn0038715	505	500	501	9	3	3	496
FBgn0038716	510	500	486	34	6	5.666666666666667	476
FBgn0038717	528	500	470	86	7	12.285714285714286	442
FBgn0038718	506	500	503	9	4	2.25	497
FBgn0038719	500	500	500	0	0	NA	500
FBgn0038720	509	500	429	89	9	9.88888888888889	420
FBgn0038721	523	500	492	54	11	4.909090909090909	469
FBgn0038722	502	500	468	36	8	4.5	466
FBgn0038723	500	500	204	296	3	98.66666666666667	204
FBgn0038725	518	500	516	20	2	10	498
FBgn0038727	509	500	506	12	5	2.4	497
FBgn0038732	549	500	511	87	7	12.428571428571429	462
FBgn0038733	512	500	465	59	5	11.8	453
FBgn0038734	489	486	442	50	4	12.5	439
FBgn0038735	527	500	392	162	12	13.5	365
FBgn0038737	502	500	487	17	3	5.666666666666667	485
FBgn0038738	522	500	517	27	7	3.857142857142857	495
FBgn0038739	505	500	494	16	6	2.6666666666666665	489
FBgn0038740	537	500	535	39	9	4.333333333333333	498
FBgn0038741	504	500	497	11	4	2.75	493
FBgn0038742	501	500	500	2	2	1	499
FBgn0038744	522	500	502	42	8	5.25	480
FBgn0038746	517	500	467	67	4	16.75	450
FBgn0038747	521	500	492	50	5	10	471
FBgn0038750	505	500	503	7	3	2.3333333333333335	498
FBgn0038751	507	500	505	9	4	2.25	498
FBgn0038752	514	500	497	31	5	6.2	483
FBgn0038753	500	500	492	8	2	4	492
FBgn0038755	507	500	502	12	7	1.7142857142857142	495
FBgn0038756	501	500	493	9	3	3	492
FBgn0038760	507	500	502	12	7	1.7142857142857142	495
FBgn0038761	501	500	482	20	4	5	481
FBgn0038763	576	500	557	95	8	11.875	481
FBgn0038765	503	500	500	6	2	3	497
FBgn0038766	501	500	498	4	2	2	497
FBgn0038767	507	500	460	54	12	4.5	453
FBgn0038768	507	500	459	55	13	4.230769230769231	452
FBgn0038769	508	500	477	39	6	6.5	469
FBgn0038771	509	500	509	9	3	3	500
FBgn0038772	521	500	511	31	9	3.4444444444444446	490
FBgn0038774	530	500	524	36	4	9	494
FBgn0038775	509	500	506	12	4	3	497
FBgn0038783	500	500	385	115	3	38.333333333333336	385
FBgn0038784	509	500	499	19	3	6.333333333333333	490
FBgn0038787	507	500	505	9	4	2.25	498
FBgn0038788	501	500	499	3	3	1	498
FBgn0038789	500	500	438	62	5	12.4	438
FBgn0038796	524	500	516	32	7	4.571428571428571	492
FBgn0038798	543	500	416	170	6	28.333333333333332	373
FBgn0038799	500	500	485	15	4	3.75	485
FBgn0038803	520	500	484	56	6	9.333333333333334	464
FBgn0038804	503	500	495	11	6	1.8333333333333333	492
FBgn0038805	511	500	511	11	1	11	500
FBgn0038806	500	500	500	0	0	NA	500
FBgn0038808	500	500	500	0	0	NA	500
FBgn0038809	502	500	470	34	6	5.666666666666667	468
FBgn0038814	510	500	506	14	4	3.5	496
FBgn0038815	505	500	471	39	10	3.9	466
FBgn0038818	508	500	317	199	6	33.166666666666664	309
FBgn0038819	500	500	500	0	0	NA	500
FBgn0038820	500	500	487	13	1	13	487
FBgn0038821	501	500	490	12	3	4	489
FBgn0038826	500	500	489	11	4	2.75	489
FBgn0038827	532	500	521	43	6	7.166666666666667	489
FBgn0038828	348	347	344	5	4	1.25	343
FBgn0038829	505	500	500	10	4	2.5	495
FBgn0038830	522	500	262	282	4	70.5	240
FBgn0038832	518	500	518	18	3	6	500
FBgn0038833	500	500	453	47	4	11.75	453
FBgn0038837	500	500	440	60	3	20	440
FBgn0038839	500	500	499	1	1	1	499
FBgn0038840	519	500	497	41	5	8.2	478
FBgn0038842	504	500	478	30	2	15	474
FBgn0038845	500	500	500	0	0	NA	500
FBgn0038846	503	500	503	3	1	3	500
FBgn0038847	500	500	494	6	2	3	494
FBgn0038850	508	500	493	23	6	3.8333333333333335	485
FBgn0038851	502	500	479	25	4	6.25	477
FBgn0038852	511	500	497	25	3	8.333333333333334	486
FBgn0038853	502	500	481	23	5	4.6	479
FBgn0038855	510	500	493	27	8	3.375	483
FBgn0038857	511	500	509	13	6	2.1666666666666665	498
FBgn0038858	500	500	499	1	1	1	499
FBgn0038859	510	500	462	58	11	5.2727272727272725	452
FBgn0038860	510	500	464	56	11	5.090909090909091	454
FBgn0038861	551	500	540	62	6	10.333333333333334	489
FBgn0038862	562	500	556	68	7	9.714285714285714	494
FBgn0038865	529	500	513	45	7	6.428571428571429	484
FBgn0038868	505	500	462	48	5	9.6	457
FBgn0038869	508	500	507	9	4	2.25	499
FBgn0038870	518	500	512	24	6	4	494
FBgn0038872	529	500	529	29	2	14.5	500
FBgn0038874	508	500	486	30	6	5	478
FBgn0038876	502	500	502	2	1	2	500
FBgn0038877	512	500	495	29	9	3.2222222222222223	483
FBgn0038878	500	500	498	2	2	1	498
FBgn0038879	508	500	504	12	2	6	496
FBgn0038880	501	500	501	1	1	1	500
FBgn0038881	517	500	517	17	3	5.666666666666667	500
FBgn0038886	500	500	478	22	5	4.4	478
FBgn0038887	510	500	506	14	6	2.3333333333333335	496
FBgn0038888	511	500	487	35	5	7	476
FBgn0038889	520	500	511	29	4	7.25	491
FBgn0038890	549	500	294	304	5	60.8	245
FBgn0038892	505	500	504	6	2	3	499
FBgn0038893	541	500	511	71	9	7.888888888888889	470
FBgn0038894	500	500	492	8	3	2.6666666666666665	492
FBgn0038897	514	500	497	31	7	4.428571428571429	483
FBgn0038902	500	500	500	0	0	NA	500
FBgn0038903	500	500	476	24	2	12	476
FBgn0038909	508	500	499	17	5	3.4	491
FBgn0038912	506	480	489	43	5	8.6	463
FBgn0038914	343	343	343	0	0	NA	343
FBgn0038916	523	500	418	128	4	32	395
FBgn0038917	540	500	502	78	11	7.090909090909091	462
FBgn0038918	501	500	480	22	4	5.5	479
FBgn0038921	502	500	457	47	6	7.833333333333333	455
FBgn0038922	490	477	470	33	4	8.25	457
FBgn0038923	500	500	500	0	0	NA	500
FBgn0038925	508	500	466	50	5	10	458
FBgn0038926	503	500	494	12	3	4	491
FBgn0038929	508	500	508	8	2	4	500
FBgn0038930	546	500	536	56	7	8	490
FBgn0038931	500	500	484	16	3	5.333333333333333	484
FBgn0038941	506	500	491	21	3	7	485
FBgn0038943	500	500	481	19	4	4.75	481
FBgn0038944	551	500	520	82	7	11.714285714285714	469
FBgn0038945	507	500	496	18	4	4.5	489
FBgn0038946	507	500	503	11	4	2.75	496
FBgn0038951	500	500	462	38	2	19	462
FBgn0038952	354	353	337	18	3	6	336
FBgn0038953	456	451	454	7	4	1.75	449
FBgn0038956	502	500	494	10	4	2.5	492
FBgn0038957	505	500	477	33	7	4.714285714285714	472
FBgn0038958	500	500	500	0	0	NA	500
FBgn0038959	500	500	499	1	1	1	499
FBgn0038964	502	500	494	10	2	5	492
FBgn0038965	500	500	498	2	1	2	498
FBgn0038966	506	500	503	9	4	2.25	497
FBgn0038967	509	500	508	10	4	2.5	499
FBgn0038968	390	384	390	6	4	1.5	384
FBgn0038972	508	500	497	19	5	3.8	489
FBgn0038974	504	500	504	4	2	2	500
FBgn0038975	504	500	502	6	3	2	498
FBgn0038976	500	500	498	2	1	2	498
FBgn0038977	347	347	347	0	0	NA	347
FBgn0038979	515	500	474	56	6	9.333333333333334	459
FBgn0038980	527	500	518	36	7	5.142857142857143	491
FBgn0038983	509	500	506	12	4	3	497
FBgn0038984	502	500	502	2	2	1	500
FBgn0038989	500	500	494	6	2	3	494
FBgn0038993	534	500	534	34	3	11.333333333333334	500
FBgn0039002	504	500	498	10	4	2.5	494
FBgn0039003	500	500	497	3	1	3	497
FBgn0039004	500	500	500	0	0	NA	500
FBgn0039006	406	386	404	22	3	7.333333333333333	384
FBgn0039007	502	500	498	6	3	2	496
FBgn0039009	502	500	488	16	3	5.333333333333333	486
FBgn0039010	501	500	499	3	3	1	498
FBgn0039013	543	500	528	58	12	4.833333333333333	485
FBgn0039016	513	500	498	28	3	9.333333333333334	485
FBgn0039017	500	500	497	3	1	3	497
FBgn0039019	500	500	497	3	1	3	497
FBgn0039022	513	500	495	31	5	6.2	482
FBgn0039024	500	500	494	6	3	2	494
FBgn0039027	500	500	474	26	4	6.5	474
FBgn0039028	510	500	495	25	5	5	485
FBgn0039029	521	500	519	23	4	5.75	498
FBgn0039031	502	500	494	10	2	5	492
FBgn0039033	500	500	497	3	1	3	497
FBgn0039034	503	500	501	5	4	1.25	498
FBgn0039038	500	500	398	102	4	25.5	398
FBgn0039039	500	500	466	34	5	6.8	466
FBgn0039040	555	500	538	72	14	5.142857142857143	483
FBgn0039041	502	500	490	14	6	2.3333333333333335	488
FBgn0039042	505	500	461	49	7	7	456
FBgn0039043	504	500	502	6	4	1.5	498
FBgn0039044	459	440	455	23	6	3.8333333333333335	436
FBgn0039048	523	500	455	91	6	15.166666666666666	432
FBgn0039051	503	500	466	40	6	6.666666666666667	463
FBgn0039052	511	500	459	63	6	10.5	448
FBgn0039053	431	395	431	36	2	18	395
FBgn0039054	508	500	495	21	6	3.5	487
FBgn0039055	513	500	513	13	4	3.25	500
FBgn0039056	512	500	506	18	4	4.5	494
FBgn0039058	558	500	523	93	8	11.625	465
FBgn0039059	502	500	475	29	7	4.142857142857143	473
FBgn0039064	500	500	494	6	3	2	494
FBgn0039065	500	500	473	27	5	5.4	473
FBgn0039066	529	500	529	29	6	4.833333333333333	500
FBgn0039067	528	500	527	29	4	7.25	499
FBgn0039068	528	500	527	29	5	5.8	499
FBgn0039071	503	500	493	13	3	4.333333333333333	490
FBgn0039073	526	500	505	47	6	7.833333333333333	479
FBgn0039075	510	500	455	65	10	6.5	445
FBgn0039077	500	500	498	2	1	2	498
FBgn0039078	503	500	500	6	2	3	497
FBgn0039080	500	500	494	6	2	3	494
FBgn0039081	500	500	499	1	1	1	499
FBgn0039083	507	500	504	10	2	5	497
FBgn0039084	519	500	492	46	7	6.571428571428571	473
FBgn0039087	503	500	492	14	7	2	489
FBgn0039088	537	500	513	61	9	6.777777777777778	476
FBgn0039089	569	500	565	73	9	8.11111111111111	496
FBgn0039093	518	500	488	48	4	12	470
FBgn0039094	507	500	494	20	7	2.857142857142857	487
FBgn0039098	519	500	449	89	9	9.88888888888889	430
FBgn0039099	541	500	534	48	6	8	493
FBgn0039101	364	362	357	9	4	2.25	355
FBgn0039102	390	378	245	157	8	19.625	233
FBgn0039104	347	347	347	0	0	NA	347
FBgn0039106	521	500	503	39	9	4.333333333333333	482
FBgn0039109	513	500	475	51	9	5.666666666666667	462
FBgn0039110	501	500	501	1	1	1	500
FBgn0039111	534	500	531	37	3	12.333333333333334	497
FBgn0039112	380	380	373	7	2	3.5	373
FBgn0039113	514	500	503	25	5	5	489
FBgn0039114	512	500	509	15	4	3.75	497
FBgn0039115	516	500	501	31	6	5.166666666666667	485
FBgn0039116	516	500	480	52	8	6.5	464
FBgn0039118	381	381	377	4	3	1.3333333333333333	377
FBgn0039120	506	500	502	10	2	5	496
FBgn0039126	504	500	493	15	3	5	489
FBgn0039128	501	500	499	3	3	1	498
FBgn0039129	500	500	484	16	2	8	484
FBgn0039130	500	500	484	16	3	5.333333333333333	484
FBgn0039131	500	500	487	13	2	6.5	487
FBgn0039135	500	500	500	0	0	NA	500
FBgn0039136	501	500	496	6	3	2	495
FBgn0039137	501	500	490	12	3	4	489
FBgn0039139	500	500	497	3	2	1.5	497
FBgn0039140	500	500	500	0	0	NA	500
FBgn0039141	500	500	492	8	2	4	492
FBgn0039147	500	500	500	0	0	NA	500
FBgn0039149	503	500	491	15	4	3.75	488
FBgn0039150	529	500	503	55	11	5	474
FBgn0039151	525	500	519	31	7	4.428571428571429	494
FBgn0039153	500	500	500	0	0	NA	500
FBgn0039154	500	500	500	0	0	NA	500
FBgn0039155	538	499	538	39	3	13	499
FBgn0039156	504	500	500	8	5	1.6	496
FBgn0039157	513	500	506	20	4	5	493
FBgn0039158	513	500	506	20	4	5	493
FBgn0039159	509	500	494	24	7	3.4285714285714284	485
FBgn0039160	514	500	513	15	3	5	499
FBgn0039161	500	500	492	8	1	8	492
FBgn0039165	515	500	507	23	7	3.2857142857142856	492
FBgn0039169	514	500	514	14	2	7	500
FBgn0039170	500	500	498	2	1	2	498
FBgn0039175	510	500	503	17	5	3.4	493
FBgn0039178	502	500	464	40	6	6.666666666666667	462
FBgn0039180	517	500	504	30	6	5	487
FBgn0039182	505	500	505	5	1	5	500
FBgn0039183	500	500	495	5	1	5	495
FBgn0039186	501	500	501	1	1	1	500
FBgn0039187	500	500	500	0	0	NA	500
FBgn0039190	500	500	500	0	0	NA	500
FBgn0039192	511	500	509	13	2	6.5	498
FBgn0039193	511	500	509	13	2	6.5	498
FBgn0039195	500	500	500	0	0	NA	500
FBgn0039196	511	500	496	26	5	5.2	485
FBgn0039197	506	500	489	23	4	5.75	483
FBgn0039198	500	500	497	3	1	3	497
FBgn0039199	500	500	500	0	0	NA	500
FBgn0039200	511	500	508	14	3	4.666666666666667	497
FBgn0039201	501	500	501	1	1	1	500
FBgn0039203	506	500	495	17	3	5.666666666666667	489
FBgn0039204	503	500	482	24	7	3.4285714285714284	479
FBgn0039205	500	500	495	5	3	1.6666666666666667	495
FBgn0039213	500	500	500	0	0	NA	500
FBgn0039214	505	500	504	6	3	2	499
FBgn0039215	507	500	506	8	3	2.6666666666666665	499
FBgn0039218	364	364	360	4	2	2	360
FBgn0039223	518	500	517	19	5	3.8	499
FBgn0039224	501	500	466	36	5	7.2	465
FBgn0039226	393	365	378	43	3	14.333333333333334	350
FBgn0039228	500	500	486	14	1	14	486
FBgn0039232	500	500	490	10	2	5	490
FBgn0039233	396	393	391	8	3	2.6666666666666665	388
FBgn0039237	527	500	518	36	6	6	491
FBgn0039238	534	500	527	41	6	6.833333333333333	493
FBgn0039239	517	500	498	36	3	12	481
FBgn0039240	523	500	496	50	6	8.333333333333334	473
FBgn0039244	510	500	487	33	4	8.25	477
FBgn0039246	500	500	495	5	2	2.5	495
FBgn0039249	505	500	468	42	6	7	463
FBgn0039250	416	388	406	38	4	9.5	378
FBgn0039254	501	500	487	15	3	5	486
FBgn0039257	509	500	379	139	4	34.75	370
FBgn0039258	512	500	472	52	5	10.4	460
FBgn0039259	523	500	521	25	5	5	498
FBgn0039260	511	500	492	30	4	7.5	481
FBgn0039261	500	500	491	9	2	4.5	491
FBgn0039264	504	500	479	29	3	9.666666666666666	475
FBgn0039265	369	345	342	51	3	17	318
FBgn0039266	350	344	350	6	1	6	344
FBgn0039269	506	500	495	17	3	5.666666666666667	489
FBgn0039270	500	500	499	1	1	1	499
FBgn0039271	501	500	500	2	2	1	499
FBgn0039273	502	500	482	22	4	5.5	480
FBgn0039274	501	500	481	21	3	7	480
FBgn0039277	500	500	488	12	3	4	488
FBgn0039286	518	500	500	36	5	7.2	482
FBgn0039288	506	500	503	9	2	4.5	497
FBgn0039290	516	500	515	17	4	4.25	499
FBgn0039291	573	500	562	84	9	9.333333333333334	489
FBgn0039294	503	500	462	44	4	11	459
FBgn0039296	524	500	470	78	9	8.666666666666666	446
FBgn0039297	549	500	515	83	9	9.222222222222221	466
FBgn0039298	510	500	490	30	5	6	480
FBgn0039299	524	500	512	36	7	5.142857142857143	488
FBgn0039300	504	500	156	352	2	176	152
FBgn0039301	501	500	500	2	2	1	499
FBgn0039303	353	338	344	24	4	6	329
FBgn0039304	521	500	519	23	3	7.666666666666667	498
FBgn0039306	500	500	490	10	2	5	490
FBgn0039310	525	500	517	33	4	8.25	492
FBgn0039311	500	500	497	3	1	3	497
FBgn0039312	538	500	533	43	6	7.166666666666667	495
FBgn0039313	510	500	489	31	4	7.75	479
FBgn0039316	502	500	349	155	6	25.833333333333332	347
FBgn0039319	503	500	357	149	2	74.5	354
FBgn0039321	525	500	523	27	4	6.75	498
FBgn0039323	536	500	506	66	13	5.076923076923077	470
FBgn0039324	500	500	268	232	2	116	268
FBgn0039325	505	500	475	35	5	7	470
FBgn0039326	569	500	552	86	9	9.555555555555555	483
FBgn0039328	500	500	189	311	4	77.75	189
FBgn0039329	500	500	500	0	0	NA	500
FBgn0039331	500	500	488	12	1	12	488
FBgn0039335	534	500	531	37	5	7.4	497
FBgn0039336	501	500	501	1	1	1	500
FBgn0039337	501	500	501	1	1	1	500
FBgn0039338	505	500	480	30	5	6	475
FBgn0039341	530	500	488	72	12	6	458
FBgn0039342	501	500	469	33	9	3.6666666666666665	468
FBgn0039344	501	500	491	11	4	2.75	490
FBgn0039346	514	500	503	25	7	3.5714285714285716	489
FBgn0039347	519	500	505	33	8	4.125	486
FBgn0039349	501	500	496	6	5	1.2	495
FBgn0039350	503	500	463	43	6	7.166666666666667	460
FBgn0039354	510	500	505	15	3	5	495
FBgn0039355	500	500	499	1	1	1	499
FBgn0039356	500	500	496	4	2	2	496
FBgn0039357	501	500	500	2	2	1	499
FBgn0039358	501	500	496	6	3	2	495
FBgn0039360	543	500	405	181	7	25.857142857142858	362
FBgn0039370	545	500	545	45	5	9	500
FBgn0039371	515	500	451	79	6	13.166666666666666	436
FBgn0039373	530	500	520	40	4	10	490
FBgn0039376	502	500	500	4	2	2	498
FBgn0039378	548	500	535	61	8	7.625	487
FBgn0039379	506	500	505	7	2	3.5	499
FBgn0039380	503	500	424	82	4	20.5	421
FBgn0039381	500	500	155	345	2	172.5	155
FBgn0039385	539	500	528	50	4	12.5	489
FBgn0039386	510	500	347	173	2	86.5	337
FBgn0039387	394	381	373	34	4	8.5	360
FBgn0039395	518	500	518	18	3	6	500
FBgn0039396	502	500	479	25	4	6.25	477
FBgn0039398	502	500	384	120	4	30	382
FBgn0039402	506	500	430	82	9	9.11111111111111	424
FBgn0039403	500	500	500	0	0	NA	500
FBgn0039404	500	500	496	4	2	2	496
FBgn0039406	502	500	502	2	2	1	500
FBgn0039407	502	500	502	2	1	2	500
FBgn0039408	526	500	501	51	7	7.285714285714286	475
FBgn0039411	543	500	534	52	6	8.666666666666666	491
FBgn0039415	500	500	487	13	2	6.5	487
FBgn0039420	503	500	501	5	2	2.5	498
FBgn0039421	500	500	500	0	0	NA	500
FBgn0039424	525	500	520	30	4	7.5	495
FBgn0039425	502	500	497	7	2	3.5	495
FBgn0039428	512	500	496	28	10	2.8	484
FBgn0039429	504	500	473	35	6	5.833333333333333	469
FBgn0039430	500	500	413	87	3	29	413
FBgn0039431	534	500	523	45	9	5	489
FBgn0039434	511	500	507	15	3	5	496
FBgn0039435	500	500	500	0	0	NA	500
FBgn0039436	500	500	499	1	1	1	499
FBgn0039437	355	355	355	0	0	NA	355
FBgn0039438	501	500	498	4	3	1.3333333333333333	497
FBgn0039439	500	500	494	6	1	6	494
FBgn0039440	507	500	507	7	2	3.5	500
FBgn0039441	500	500	500	0	0	NA	500
FBgn0039443	500	500	499	1	1	1	499
FBgn0039444	500	500	500	0	0	NA	500
FBgn0039448	500	500	492	8	1	8	492
FBgn0039450	535	500	494	76	9	8.444444444444445	459
FBgn0039451	513	500	496	30	8	3.75	483
FBgn0039453	500	500	485	15	2	7.5	485
FBgn0039454	514	500	514	14	2	7	500
FBgn0039459	517	500	513	21	6	3.5	496
FBgn0039462	500	500	390	110	7	15.714285714285714	390
FBgn0039464	519	500	519	19	3	6.333333333333333	500
FBgn0039466	505	500	496	14	2	7	491
FBgn0039469	500	500	487	13	2	6.5	487
FBgn0039470	513	478	511	37	4	9.25	476
FBgn0039472	374	372	370	6	3	2	368
FBgn0039473	536	500	515	57	8	7.125	479
FBgn0039474	505	500	485	25	4	6.25	480
FBgn0039475	503	500	494	12	4	3	491
FBgn0039476	506	500	458	54	6	9	452
FBgn0039478	502	500	496	8	3	2.6666666666666665	494
FBgn0039479	503	500	503	3	2	1.5	500
FBgn0039480	505	500	364	146	4	36.5	359
FBgn0039481	502	500	495	9	4	2.25	493
FBgn0039482	528	500	523	33	4	8.25	495
FBgn0039483	420	396	419	25	2	12.5	395
FBgn0039485	506	500	487	25	4	6.25	481
FBgn0039486	513	500	509	17	5	3.4	496
FBgn0039488	501	500	489	13	2	6.5	488
FBgn0039489	501	500	501	1	1	1	500
FBgn0039490	355	355	355	0	0	NA	355
FBgn0039491	503	500	500	6	3	2	497
FBgn0039494	510	500	508	12	5	2.4	498
FBgn0039495	521	500	509	33	6	5.5	488
FBgn0039500	400	375	400	25	3	8.333333333333334	375
FBgn0039503	500	500	500	0	0	NA	500
FBgn0039504	524	500	518	30	2	15	494
FBgn0039505	501	500	496	6	4	1.5	495
FBgn0039507	507	500	507	7	3	2.3333333333333335	500
FBgn0039508	534	500	520	48	10	4.8	486
FBgn0039509	531	500	530	32	5	6.4	499
FBgn0039510	500	500	499	1	1	1	499
FBgn0039511	531	500	517	45	5	9	486
FBgn0039518	503	500	441	65	6	10.833333333333334	438
FBgn0039519	511	500	479	43	7	6.142857142857143	468
FBgn0039520	516	500	485	47	4	11.75	469
FBgn0039521	436	436	399	37	3	12.333333333333334	399
FBgn0039522	502	500	496	8	3	2.6666666666666665	494
FBgn0039523	500	500	496	4	1	4	496
FBgn0039525	512	500	235	289	5	57.8	223
FBgn0039527	510	500	485	35	6	5.833333333333333	475
FBgn0039528	531	500	511	51	10	5.1	480
FBgn0039529	505	500	479	31	6	5.166666666666667	474
FBgn0039530	531	500	511	51	10	5.1	480
FBgn0039531	511	500	504	18	6	3	493
FBgn0039532	502	500	483	21	3	7	481
FBgn0039536	500	500	499	1	1	1	499
FBgn0039537	538	500	529	47	6	7.833333333333333	491
FBgn0039538	392	368	391	25	6	4.166666666666667	367
FBgn0039543	500	500	476	24	4	6	476
FBgn0039544	500	500	476	24	4	6	476
FBgn0039551	500	500	443	57	6	9.5	443
FBgn0039554	503	500	342	164	4	41	339
FBgn0039555	535	500	483	87	8	10.875	448
FBgn0039558	526	500	497	55	9	6.111111111111111	471
FBgn0039559	552	500	531	73	9	8.11111111111111	479
FBgn0039560	547	500	526	68	7	9.714285714285714	479
FBgn0039561	501	500	497	5	4	1.25	496
FBgn0039562	519	500	516	22	5	4.4	497
FBgn0039563	520	500	502	38	8	4.75	482
FBgn0039564	500	500	489	11	4	2.75	489
FBgn0039568	520	500	502	38	6	6.333333333333333	482
FBgn0039576	336	335	317	20	4	5	316
FBgn0039577	500	500	499	1	1	1	499
FBgn0039580	505	500	503	7	5	1.4	498
FBgn0039581	505	500	501	9	6	1.5	496
FBgn0039582	500	500	497	3	1	3	497
FBgn0039584	509	500	501	17	3	5.666666666666667	492
FBgn0039585	500	500	379	121	3	40.333333333333336	379
FBgn0039589	523	500	501	45	7	6.428571428571429	478
FBgn0039590	502	500	365	139	3	46.333333333333336	363
FBgn0039592	500	500	490	10	3	3.3333333333333335	490
FBgn0039594	501	500	436	66	4	16.5	435
FBgn0039595	508	500	502	14	3	4.666666666666667	494
FBgn0039596	500	500	499	1	1	1	499
FBgn0039600	519	500	419	119	6	19.833333333333332	400
FBgn0039601	510	500	500	20	7	2.857142857142857	490
FBgn0039602	501	500	464	38	8	4.75	463
FBgn0039609	500	500	499	1	1	1	499
FBgn0039611	502	500	501	3	2	1.5	499
FBgn0039613	504	500	499	9	4	2.25	495
FBgn0039616	506	500	473	39	6	6.5	467
FBgn0039617	502	500	481	23	4	5.75	479
FBgn0039620	505	500	502	8	3	2.6666666666666665	497
FBgn0039621	502	500	502	2	1	2	500
FBgn0039622	500	500	497	3	2	1.5	497
FBgn0039623	529	500	503	55	4	13.75	474
FBgn0039625	502	500	477	27	5	5.4	475
FBgn0039626	500	500	498	2	1	2	498
FBgn0039627	501	500	465	37	3	12.333333333333334	464
FBgn0039628	409	409	394	15	3	5	394
FBgn0039629	500	500	493	7	2	3.5	493
FBgn0039630	525	500	275	275	8	34.375	250
FBgn0039632	501	500	495	7	5	1.4	494
FBgn0039633	502	500	498	6	4	1.5	496
FBgn0039634	500	500	457	43	5	8.6	457
FBgn0039635	511	500	481	41	5	8.2	470
FBgn0039636	438	431	437	8	4	2	430
FBgn0039637	500	500	484	16	1	16	484
FBgn0039638	500	500	494	6	4	1.5	494
FBgn0039639	505	500	502	8	2	4	497
FBgn0039640	500	500	500	0	0	NA	500
FBgn0039642	510	500	508	12	5	2.4	498
FBgn0039644	511	500	501	21	7	3	490
FBgn0039645	503	500	494	12	3	4	491
FBgn0039647	507	500	468	46	4	11.5	461
FBgn0039648	500	500	471	29	3	9.666666666666666	471
FBgn0039651	500	500	497	3	2	1.5	497
FBgn0039654	511	500	510	12	2	6	499
FBgn0039655	503	500	462	44	5	8.8	459
FBgn0039659	510	500	508	12	3	4	498
FBgn0039663	514	500	501	27	5	5.4	487
FBgn0039664	522	500	514	30	4	7.5	492
FBgn0039665	524	500	521	27	4	6.75	497
FBgn0039666	530	500	522	38	4	9.5	492
FBgn0039667	539	500	537	41	8	5.125	498
FBgn0039668	503	500	498	8	2	4	495
FBgn0039669	509	500	507	11	3	3.6666666666666665	498
FBgn0039670	507	500	423	91	7	13	416
FBgn0039671	386	386	356	30	3	10	356
FBgn0039673	545	500	540	50	8	6.25	495
FBgn0039674	500	500	467	33	4	8.25	467
FBgn0039675	509	500	490	28	5	5.6	481
FBgn0039676	500	500	445	55	3	18.333333333333332	445
FBgn0039677	500	500	490	10	4	2.5	490
FBgn0039680	501	500	494	8	5	1.6	493
FBgn0039681	501	500	488	14	6	2.3333333333333335	487
FBgn0039682	500	500	490	10	2	5	490
FBgn0039683	519	500	519	19	2	9.5	500
FBgn0039684	501	500	380	122	3	40.666666666666664	379
FBgn0039685	505	500	488	22	5	4.4	483
FBgn0039686	501	500	483	19	3	6.333333333333333	482
FBgn0039687	500	500	500	0	0	NA	500
FBgn0039689	500	500	490	10	2	5	490
FBgn0039691	500	500	483	17	4	4.25	483
FBgn0039694	540	500	519	61	9	6.777777777777778	479
FBgn0039696	520	500	507	33	5	6.6	487
FBgn0039697	501	500	501	1	1	1	500
FBgn0039698	500	500	499	1	1	1	499
FBgn0039702	464	464	464	0	0	NA	464
FBgn0039703	515	500	504	26	8	3.25	489
FBgn0039704	518	500	515	21	4	5.25	497
FBgn0039707	503	500	497	9	3	3	494
FBgn0039709	515	500	495	35	5	7	480
FBgn0039712	500	500	466	34	2	17	466
FBgn0039713	500	500	500	0	0	NA	500
FBgn0039714	510	500	502	18	4	4.5	492
FBgn0039718	511	500	486	36	13	2.769230769230769	475
FBgn0039719	500	500	495	5	3	1.6666666666666667	495
FBgn0039722	504	500	485	23	4	5.75	481
FBgn0039723	501	500	501	1	1	1	500
FBgn0039726	500	500	486	14	2	7	486
FBgn0039727	500	500	476	24	3	8	476
FBgn0039728	549	500	524	74	9	8.222222222222221	475
FBgn0039730	500	500	500	0	0	NA	500
FBgn0039731	504	500	501	7	2	3.5	497
FBgn0039732	500	500	500	0	0	NA	500
FBgn0039733	500	500	498	2	1	2	498
FBgn0039735	502	500	501	3	2	1.5	499
FBgn0039736	504	500	500	8	2	4	496
FBgn0039737	502	500	499	5	2	2.5	497
FBgn0039739	501	500	500	2	2	1	499
FBgn0039741	506	500	505	7	2	3.5	499
FBgn0039742	500	500	468	32	4	8	468
FBgn0039744	500	500	491	9	3	3	491
FBgn0039747	528	500	528	28	3	9.333333333333334	500
FBgn0039748	511	500	495	27	3	9	484
FBgn0039749	543	500	536	50	6	8.333333333333334	493
FBgn0039751	500	500	493	7	2	3.5	493
FBgn0039752	500	500	488	12	4	3	488
FBgn0039754	500	500	480	20	5	4	480
FBgn0039755	408	408	406	2	1	2	406
FBgn0039756	500	500	458	42	2	21	458
FBgn0039757	523	500	495	51	6	8.5	472
FBgn0039758	503	500	468	38	5	7.6	465
FBgn0039759	508	500	487	29	5	5.8	479
FBgn0039760	367	367	347	20	5	4	347
FBgn0039761	429	429	429	0	0	NA	429
FBgn0039764	500	500	500	0	0	NA	500
FBgn0039765	500	500	496	4	1	4	496
FBgn0039766	505	500	474	36	7	5.142857142857143	469
FBgn0039767	528	500	523	33	7	4.714285714285714	495
FBgn0039768	528	500	520	36	7	5.142857142857143	492
FBgn0039769	545	500	545	45	4	11.25	500
FBgn0039770	502	500	497	7	5	1.4	495
FBgn0039771	500	500	495	5	1	5	495
FBgn0039773	544	500	503	85	9	9.444444444444445	459
FBgn0039774	523	500	467	79	5	15.8	444
FBgn0039776	489	488	484	6	5	1.2	483
FBgn0039777	510	500	313	207	4	51.75	303
FBgn0039780	504	500	475	33	3	11	471
FBgn0039782	509	500	496	22	5	4.4	487
FBgn0039787	511	500	510	12	3	4	499
FBgn0039788	585	500	579	91	10	9.1	494
FBgn0039789	500	500	493	7	1	7	493
FBgn0039792	503	500	488	18	2	9	485
FBgn0039795	500	500	499	1	1	1	499
FBgn0039797	505	500	469	41	6	6.833333333333333	464
FBgn0039798	523	500	494	52	9	5.777777777777778	471
FBgn0039799	500	500	495	5	2	2.5	495
FBgn0039800	594	500	592	96	8	12	498
FBgn0039801	412	394	400	30	5	6	382
FBgn0039802	514	500	489	39	9	4.333333333333333	475
FBgn0039804	504	500	493	15	3	5	489
FBgn0039805	500	500	494	6	2	3	494
FBgn0039806	504	500	493	15	4	3.75	489
FBgn0039807	517	500	453	81	9	9	436
FBgn0039808	502	500	362	142	4	35.5	360
FBgn0039809	409	409	408	1	1	1	408
FBgn0039811	533	500	532	34	6	5.666666666666667	499
FBgn0039812	512	500	495	29	2	14.5	483
FBgn0039816	501	500	488	14	3	4.666666666666667	487
FBgn0039817	509	500	483	35	7	5	474
FBgn0039820	523	500	516	30	4	7.5	493
FBgn0039821	503	500	488	18	7	2.5714285714285716	485
FBgn0039828	510	500	502	18	2	9	492
FBgn0039829	511	500	498	24	3	8	487
FBgn0039830	512	500	464	60	10	6	452
FBgn0039831	508	500	483	33	5	6.6	475
FBgn0039833	509	500	509	9	1	9	500
FBgn0039835	502	500	499	5	2	2.5	497
FBgn0039836	526	500	518	34	5	6.8	492
FBgn0039838	508	500	465	51	9	5.666666666666667	457
FBgn0039839	500	500	481	19	3	6.333333333333333	481
FBgn0039840	508	500	496	20	4	5	488
FBgn0039844	507	500	492	22	7	3.142857142857143	485
FBgn0039846	514	500	513	15	4	3.75	499
FBgn0039849	503	500	489	17	5	3.4	486
FBgn0039850	503	500	497	9	5	1.8	494
FBgn0039852	533	500	528	38	5	7.6	495
FBgn0039854	503	500	490	16	5	3.2	487
FBgn0039856	500	500	493	7	1	7	493
FBgn0039857	538	500	523	53	6	8.833333333333334	485
FBgn0039858	503	500	503	3	1	3	500
FBgn0039859	501	500	494	8	3	2.6666666666666665	493
FBgn0039860	503	500	491	15	5	3	488
FBgn0039863	514	500	491	37	9	4.111111111111111	477
FBgn0039864	500	500	497	3	2	1.5	497
FBgn0039867	500	500	492	8	1	8	492
FBgn0039868	505	500	503	7	2	3.5	498
FBgn0039869	500	500	500	0	0	NA	500
FBgn0039872	507	500	481	33	4	8.25	474
FBgn0039875	506	500	491	21	6	3.5	485
FBgn0039876	511	500	492	30	9	3.3333333333333335	481
FBgn0039877	500	500	494	6	3	2	494
FBgn0039879	517	500	516	18	2	9	499
FBgn0039881	500	500	492	8	3	2.6666666666666665	492
FBgn0039882	502	500	497	7	4	1.75	495
FBgn0039883	527	500	523	31	4	7.75	496
FBgn0039886	509	500	451	67	4	16.75	442
FBgn0039887	500	500	494	6	5	1.2	494
FBgn0039889	517	500	452	82	10	8.2	435
FBgn0039907	541	500	485	97	12	8.083333333333334	444
FBgn0039908	509	500	470	48	8	6	461
FBgn0039909	506	500	394	118	5	23.6	388
FBgn0039911	500	500	29	471	2	235.5	29
FBgn0039915	525	500	501	49	4	12.25	476
FBgn0039916	502	500	489	15	5	3	487
FBgn0039920	513	500	315	211	6	35.166666666666664	302
FBgn0039929	507	500	488	26	6	4.333333333333333	481
FBgn0039930	558	500	542	74	13	5.6923076923076925	484
FBgn0039932	504	500	469	39	4	9.75	465
FBgn0039937	519	500	460	78	5	15.6	441
FBgn0039938	507	500	487	27	8	3.375	480
FBgn0039941	516	500	451	81	6	13.5	435
FBgn0039942	500	500	491	9	2	4.5	491
FBgn0039943	505	500	483	27	6	4.5	478
FBgn0039944	515	500	458	72	7	10.285714285714286	443
FBgn0039946	519	500	283	255	8	31.875	264
FBgn0039965	510	500	478	42	6	7	468
FBgn0039966	500	500	491	9	1	9	491
FBgn0039969	500	500	245	255	3	85	245
FBgn0039970	571	500	488	154	13	11.846153846153847	417
FBgn0039994	500	500	103	397	2	198.5	103
FBgn0040007	500	500	271	229	3	76.33333333333333	271
FBgn0040020	510	500	415	105	2	52.5	405
FBgn0040031	509	500	480	38	12	3.1666666666666665	471
FBgn0040060	507	500	507	7	1	7	500
FBgn0040063	540	500	533	47	6	7.833333333333333	493
FBgn0040064	512	500	490	34	8	4.25	478
FBgn0040066	500	500	474	26	4	6.5	474
FBgn0040068	511	500	468	54	10	5.4	457
FBgn0040069	522	500	510	34	9	3.7777777777777777	488
FBgn0040070	500	500	442	58	6	9.666666666666666	442
FBgn0040071	522	500	497	47	9	5.222222222222222	475
FBgn0040075	594	500	577	111	10	11.1	483
FBgn0040078	501	500	496	6	4	1.5	495
FBgn0040079	526	500	514	38	5	7.6	488
FBgn0040087	505	500	503	7	4	1.75	498
FBgn0040089	506	500	502	10	2	5	496
FBgn0040091	502	500	496	8	4	2	494
FBgn0040092	500	500	466	34	2	17	466
FBgn0040093	542	500	535	49	5	9.8	493
FBgn0040097	546	500	525	67	6	11.166666666666666	479
FBgn0040099	544	500	366	222	6	37	322
FBgn0040102	507	500	505	9	6	1.5	498
FBgn0040106	500	500	461	39	2	19.5	461
FBgn0040107	500	500	493	7	3	2.3333333333333335	493
FBgn0040153	541	500	540	42	4	10.5	499
FBgn0040206	527	500	501	53	7	7.571428571428571	474
FBgn0040207	502	500	502	2	1	2	500
FBgn0040208	523	500	515	31	8	3.875	492
FBgn0040211	536	500	536	36	1	36	500
FBgn0040228	503	500	500	6	3	2	497
FBgn0040230	517	500	511	23	6	3.8333333333333335	494
FBgn0040234	500	500	482	18	3	6	482
FBgn0040235	500	500	484	16	4	4	484
FBgn0040236	549	500	515	83	10	8.3	466
FBgn0040238	504	500	423	85	4	21.25	419
FBgn0040239	404	402	391	15	6	2.5	389
FBgn0040250	500	500	496	4	2	2	496
FBgn0040252	500	500	464	36	3	12	464
FBgn0040255	535	500	448	122	6	20.333333333333332	413
FBgn0040256	541	500	518	64	12	5.333333333333333	477
FBgn0040257	501	500	459	43	7	6.142857142857143	458
FBgn0040259	521	500	411	131	5	26.2	390
FBgn0040260	532	500	518	46	8	5.75	486
FBgn0040261	522	500	371	173	5	34.6	349
FBgn0040262	522	500	513	31	9	3.4444444444444446	491
FBgn0040268	500	500	499	1	1	1	499
FBgn0040271	515	500	500	30	3	10	485
FBgn0040273	506	500	504	8	2	4	498
FBgn0040279	510	500	497	23	4	5.75	487
FBgn0040281	503	500	339	167	4	41.75	336
FBgn0040283	510	500	437	83	8	10.375	427
FBgn0040285	533	500	527	39	4	9.75	494
FBgn0040290	467	447	467	20	1	20	447
FBgn0040291	511	500	427	95	11	8.636363636363637	416
FBgn0040294	506	500	502	10	3	3.3333333333333335	496
FBgn0040296	500	500	471	29	2	14.5	471
FBgn0040298	529	500	521	37	6	6.166666666666667	492
FBgn0040299	502	500	476	28	3	9.333333333333334	474
FBgn0040305	548	500	537	59	5	11.8	489
FBgn0040309	507	500	498	16	5	3.2	491
FBgn0040318	500	500	499	1	1	1	499
FBgn0040319	502	500	497	7	3	2.3333333333333335	495
FBgn0040321	513	500	435	91	5	18.2	422
FBgn0040322	513	500	504	22	3	7.333333333333333	491
FBgn0040323	513	500	498	28	4	7	485
FBgn0040333	500	500	476	24	5	4.8	476
FBgn0040334	507	500	502	12	3	4	495
FBgn0040338	513	500	496	30	4	7.5	483
FBgn0040339	501	500	456	46	5	9.2	455
FBgn0040341	500	500	474	26	3	8.666666666666666	474
FBgn0040342	531	500	528	34	8	4.25	497
FBgn0040345	500	500	476	24	2	12	476
FBgn0040346	500	500	496	4	2	2	496
FBgn0040347	500	500	495	5	3	1.6666666666666667	495
FBgn0040348	523	500	512	34	5	6.8	489
FBgn0040349	501	500	487	15	6	2.5	486
FBgn0040350	500	500	500	0	0	NA	500
FBgn0040351	524	500	463	85	3	28.333333333333332	439
FBgn0040352	507	500	490	24	7	3.4285714285714284	483
FBgn0040353	517	500	499	35	10	3.5	482
FBgn0040354	500	500	476	24	6	4	476
FBgn0040357	506	500	498	14	5	2.8	492
FBgn0040358	504	500	502	6	2	3	498
FBgn0040360	509	500	509	9	2	4.5	500
FBgn0040361	500	500	449	51	5	10.2	449
FBgn0040362	500	500	419	81	4	20.25	419
FBgn0040363	513	500	512	14	3	4.666666666666667	499
FBgn0040364	504	500	455	53	8	6.625	451
FBgn0040365	566	500	549	83	11	7.545454545454546	483
FBgn0040366	509	500	505	13	2	6.5	496
FBgn0040367	517	500	486	48	6	8	469
FBgn0040368	508	500	426	90	2	45	418
FBgn0040370	500	500	460	40	5	8	460
FBgn0040372	504	500	502	6	3	2	498
FBgn0040373	516	500	516	16	2	8	500
FBgn0040375	500	500	489	11	2	5.5	489
FBgn0040376	513	500	473	53	10	5.3	460
FBgn0040377	513	500	477	49	11	4.454545454545454	464
FBgn0040383	500	500	494	6	1	6	494
FBgn0040385	525	500	525	25	5	5	500
FBgn0040388	503	500	471	35	6	5.833333333333333	468
FBgn0040389	500	500	468	32	8	4	468
FBgn0040392	530	500	504	56	11	5.090909090909091	474
FBgn0040393	505	500	438	72	9	8	433
FBgn0040394	501	500	494	8	3	2.6666666666666665	493
FBgn0040395	500	500	488	12	4	3	488
FBgn0040396	515	500	497	33	12	2.75	482
FBgn0040397	518	500	516	20	5	4	498
FBgn0040465	368	362	367	7	3	2.3333333333333335	361
FBgn0040467	500	500	494	6	2	3	494
FBgn0040475	520	500	507	33	4	8.25	487
FBgn0040477	506	500	506	6	2	3	500
FBgn0040487	500	500	467	33	3	11	467
FBgn0040491	500	500	490	10	2	5	490
FBgn0040496	500	500	457	43	4	10.75	457
FBgn0040502	500	500	499	1	1	1	499
FBgn0040503	513	500	494	32	6	5.333333333333333	481
FBgn0040505	500	500	496	4	2	2	496
FBgn0040506	500	500	473	27	4	6.75	473
FBgn0040507	517	500	516	18	3	6	499
FBgn0040508	500	500	497	3	2	1.5	497
FBgn0040512	517	500	506	28	6	4.666666666666667	489
FBgn0040524	500	500	496	4	2	2	496
FBgn0040529	501	500	501	1	1	1	500
FBgn0040531	508	500	507	9	2	4.5	499
FBgn0040532	505	500	427	83	3	27.666666666666668	422
FBgn0040534	501	500	495	7	4	1.75	494
FBgn0040551	524	500	498	50	10	5	474
FBgn0040553	502	500	486	18	8	2.25	484
FBgn0040565	595	500	577	113	10	11.3	482
FBgn0040569	548	500	523	73	8	9.125	475
FBgn0040575	519	500	482	56	6	9.333333333333334	463
FBgn0040582	546	500	541	51	7	7.285714285714286	495
FBgn0040588	500	500	492	8	5	1.6	492
FBgn0040600	546	500	546	46	5	9.2	500
FBgn0040601	520	500	500	40	6	6.666666666666667	480
FBgn0040602	506	500	505	7	2	3.5	499
FBgn0040607	502	500	487	17	4	4.25	485
FBgn0040608	520	500	517	23	4	5.75	497
FBgn0040609	512	500	512	12	3	4	500
FBgn0040623	567	500	550	84	10	8.4	483
FBgn0040629	507	500	502	12	2	6	495
FBgn0040634	500	500	500	0	0	NA	500
FBgn0040636	506	500	496	16	6	2.6666666666666665	490
FBgn0040637	500	500	468	32	4	8	468
FBgn0040648	507	500	495	19	5	3.8	488
FBgn0040649	510	500	444	76	9	8.444444444444445	434
FBgn0040650	520	500	494	46	6	7.666666666666667	474
FBgn0040653	504	500	493	15	5	3	489
FBgn0040658	505	496	464	50	7	7.142857142857143	455
FBgn0040660	516	500	503	29	4	7.25	487
FBgn0040666	500	500	500	0	0	NA	500
FBgn0040674	509	500	507	11	4	2.75	498
FBgn0040679	510	500	504	16	4	4	494
FBgn0040682	536	500	460	112	5	22.4	424
FBgn0040688	503	500	483	23	4	5.75	480
FBgn0040694	517	500	501	33	4	8.25	484
FBgn0040696	495	494	492	4	3	1.3333333333333333	491
FBgn0040699	500	500	492	8	2	4	492
FBgn0040705	500	500	474	26	4	6.5	474
FBgn0040717	505	500	496	14	3	4.666666666666667	491
FBgn0040718	500	500	498	2	2	1	498
FBgn0040725	502	500	486	18	3	6	484
FBgn0040726	547	500	539	55	9	6.111111111111111	492
FBgn0040729	557	500	551	63	8	7.875	494
FBgn0040730	504	500	441	67	9	7.444444444444445	437
FBgn0040732	502	500	490	14	6	2.3333333333333335	488
FBgn0040733	500	500	494	6	2	3	494
FBgn0040734	514	500	409	119	8	14.875	395
FBgn0040735	500	500	472	28	5	5.6	472
FBgn0040736	503	500	457	49	10	4.9	454
FBgn0040737	506	500	483	29	4	7.25	477
FBgn0040743	511	500	507	15	4	3.75	496
FBgn0040747	500	500	493	7	4	1.75	493
FBgn0040751	500	500	480	20	5	4	480
FBgn0040752	503	500	487	19	5	3.8	484
FBgn0040754	500	500	499	1	1	1	499
FBgn0040755	504	500	503	5	3	1.6666666666666667	499
FBgn0040759	516	500	479	53	6	8.833333333333334	463
FBgn0040764	501	500	499	3	3	1	498
FBgn0040765	511	500	511	11	2	5.5	500
FBgn0040773	513	500	456	70	5	14	443
FBgn0040777	534	500	524	44	5	8.8	490
FBgn0040778	509	500	505	13	4	3.25	496
FBgn0040793	501	500	500	2	2	1	499
FBgn0040794	508	500	445	71	5	14.2	437
FBgn0040795	501	500	482	20	4	5	481
FBgn0040796	501	500	485	17	3	5.666666666666667	484
FBgn0040797	501	500	501	1	1	1	500
FBgn0040801	500	500	500	0	0	NA	500
FBgn0040805	501	500	252	250	6	41.666666666666664	251
FBgn0040809	528	500	487	69	6	11.5	459
FBgn0040812	502	500	321	183	2	91.5	319
FBgn0040814	527	500	503	51	5	10.2	476
FBgn0040816	512	500	477	47	10	4.7	465
FBgn0040817	510	500	510	10	4	2.5	500
FBgn0040823	514	500	496	32	5	6.4	482
FBgn0040827	501	500	493	9	3	3	492
FBgn0040828	500	500	498	2	2	1	498
FBgn0040832	523	500	485	61	7	8.714285714285714	462
FBgn0040837	512	500	407	117	6	19.5	395
FBgn0040842	504	500	483	25	3	8.333333333333334	479
FBgn0040843	503	500	501	5	3	1.6666666666666667	498
FBgn0040849	503	500	255	251	2	125.5	252
FBgn0040850	504	500	484	24	5	4.8	480
FBgn0040871	520	500	497	43	6	7.166666666666667	477
FBgn0040892	513	500	508	18	4	4.5	495
FBgn0040899	501	500	499	3	2	1.5	498
FBgn0040900	500	500	500	0	0	NA	500
FBgn0040905	514	500	508	20	3	6.666666666666667	494
FBgn0040907	518	500	506	30	7	4.285714285714286	488
FBgn0040918	522	500	500	44	11	4	478
FBgn0040922	519	500	513	25	5	5	494
FBgn0040928	500	500	452	48	6	8	452
FBgn0040929	500	500	499	1	1	1	499
FBgn0040941	508	500	503	13	4	3.25	495
FBgn0040942	500	500	468	32	5	6.4	468
FBgn0040950	520	500	372	168	3	56	352
FBgn0040958	528	500	495	61	10	6.1	467
FBgn0040959	508	500	481	35	5	7	473
FBgn0040964	500	500	497	3	1	3	497
FBgn0040965	516	500	509	23	5	4.6	493
FBgn0040967	506	500	487	25	5	5	481
FBgn0040972	500	500	483	17	2	8.5	483
FBgn0040984	506	500	474	38	8	4.75	468
FBgn0040985	519	500	514	24	8	3	495
FBgn0040989	500	500	481	19	1	19	481
FBgn0040996	508	500	489	27	7	3.857142857142857	481
FBgn0041004	556	500	530	82	8	10.25	474
FBgn0041087	518	500	438	98	9	10.88888888888889	420
FBgn0041092	503	500	500	6	4	1.5	497
FBgn0041094	507	500	499	15	4	3.75	492
FBgn0041096	518	500	492	44	8	5.5	474
FBgn0041097	501	500	497	5	2	2.5	496
FBgn0041100	514	500	514	14	1	14	500
FBgn0041103	521	500	505	37	8	4.625	484
FBgn0041105	508	500	479	37	5	7.4	471
FBgn0041111	511	500	346	176	4	44	335
FBgn0041147	468	455	459	22	2	11	446
FBgn0041150	514	500	485	43	9	4.777777777777778	471
FBgn0041156	507	500	507	7	1	7	500
FBgn0041160	500	500	492	8	2	4	492
FBgn0041171	510	500	452	68	8	8.5	442
FBgn0041174	500	500	494	6	3	2	494
FBgn0041180	527	500	489	65	10	6.5	462
FBgn0041181	518	500	515	21	7	3	497
FBgn0041182	513	500	318	208	6	34.666666666666664	305
FBgn0041183	502	500	469	35	10	3.5	467
FBgn0041186	502	500	497	7	2	3.5	495
FBgn0041188	500	500	496	4	2	2	496
FBgn0041191	507	500	493	21	6	3.5	486
FBgn0041194	503	500	484	22	4	5.5	481
FBgn0041195	536	500	523	49	9	5.444444444444445	487
FBgn0041205	515	500	504	26	4	6.5	489
FBgn0041210	522	500	521	23	3	7.666666666666667	499
FBgn0041224	505	500	496	14	2	7	491
FBgn0041225	500	500	497	3	1	3	497
FBgn0041229	504	500	450	58	4	14.5	446
FBgn0041231	512	500	456	68	6	11.333333333333334	444
FBgn0041232	501	500	480	22	4	5.5	479
FBgn0041233	509	500	509	9	1	9	500
FBgn0041234	500	500	500	0	0	NA	500
FBgn0041237	505	500	487	23	6	3.8333333333333335	482
FBgn0041238	500	500	497	3	1	3	497
FBgn0041239	500	500	500	0	0	NA	500
FBgn0041240	523	500	430	116	4	29	407
FBgn0041242	504	500	496	12	4	3	492
FBgn0041243	500	500	497	3	1	3	497
FBgn0041245	532	500	444	120	7	17.142857142857142	412
FBgn0041246	543	500	515	71	9	7.888888888888889	472
FBgn0041247	500	500	442	58	6	9.666666666666666	442
FBgn0041249	568	500	562	74	6	12.333333333333334	494
FBgn0041250	506	500	506	6	2	3	500
FBgn0041252	501	500	476	26	3	8.666666666666666	475
FBgn0041336	523	500	442	104	9	11.555555555555555	419
FBgn0041337	506	500	233	279	3	93	227
FBgn0041342	513	500	503	23	5	4.6	490
FBgn0041581	514	500	510	18	7	2.5714285714285716	496
FBgn0041582	501	500	497	5	2	2.5	496
FBgn0041585	527	500	520	34	8	4.25	493
FBgn0041588	465	453	451	26	6	4.333333333333333	439
FBgn0041604	512	500	344	180	8	22.5	332
FBgn0041605	500	500	499	1	1	1	499
FBgn0041621	505	500	498	12	4	3	493
FBgn0041622	505	500	492	18	6	3	487
FBgn0041623	500	500	128	372	4	93	128
FBgn0041624	504	500	498	10	4	2.5	494
FBgn0041625	500	500	499	1	1	1	499
FBgn0041629	518	500	516	20	4	5	498
FBgn0041630	349	349	349	0	0	NA	349
FBgn0041706	501	500	495	7	2	3.5	494
FBgn0041707	499	496	487	15	7	2.142857142857143	484
FBgn0041709	520	500	512	28	5	5.6	492
FBgn0041711	501	500	501	1	1	1	500
FBgn0041712	500	500	499	1	1	1	499
FBgn0041713	500	500	478	22	4	5.5	478
FBgn0041717	504	500	495	13	4	3.25	491
FBgn0041719	507	500	504	10	4	2.5	497
FBgn0041721	528	500	518	38	4	9.5	490
FBgn0041723	405	400	402	8	4	2	397
FBgn0041775	501	500	497	5	3	1.6666666666666667	496
FBgn0041781	504	500	477	31	7	4.428571428571429	473
FBgn0041789	507	500	504	10	3	3.3333333333333335	497
FBgn0042083	532	500	520	44	10	4.4	488
FBgn0042085	514	500	490	38	5	7.6	476
FBgn0042092	539	500	526	52	4	13	487
FBgn0042098	495	452	495	43	2	21.5	452
FBgn0042101	527	500	502	52	5	10.4	475
FBgn0042103	500	500	500	0	0	NA	500
FBgn0042104	496	495	481	16	5	3.2	480
FBgn0042105	461	448	460	14	2	7	447
FBgn0042110	500	500	478	22	2	11	478
FBgn0042111	500	500	488	12	4	3	488
FBgn0042119	511	500	506	16	2	8	495
FBgn0042126	501	500	499	3	2	1.5	498
FBgn0042129	437	436	423	15	2	7.5	422
FBgn0042135	500	500	159	341	5	68.2	159
FBgn0042137	395	393	386	11	4	2.75	384
FBgn0042138	375	369	370	11	4	2.75	364
FBgn0042146	550	500	532	68	6	11.333333333333334	482
FBgn0042179	505	500	464	46	5	9.2	459
FBgn0042185	516	500	492	40	4	10	476
FBgn0042186	504	500	357	151	9	16.77777777777778	353
FBgn0042187	500	500	190	310	3	103.33333333333333	190
FBgn0042189	514	500	466	62	8	7.75	452
FBgn0042198	500	500	486	14	5	2.8	486
FBgn0042201	538	500	483	93	10	9.3	445
FBgn0042205	513	500	513	13	2	6.5	500
FBgn0042206	511	500	503	19	9	2.111111111111111	492
FBgn0042207	401	383	375	44	6	7.333333333333333	357
FBgn0042213	500	500	500	0	0	NA	500
FBgn0042627	420	416	411	13	5	2.6	407
FBgn0042630	501	500	501	1	1	1	500
FBgn0042696	526	500	484	68	7	9.714285714285714	458
FBgn0042711	390	384	388	8	3	2.6666666666666665	382
FBgn0042712	502	500	481	23	5	4.6	479
FBgn0043002	500	500	499	1	1	1	499
FBgn0043005	502	500	473	31	6	5.166666666666667	471
FBgn0043010	502	500	499	5	3	1.6666666666666667	497
FBgn0043012	500	500	495	5	2	2.5	495
FBgn0043022	500	500	41	459	2	229.5	41
FBgn0043043	500	500	194	306	4	76.5	194
FBgn0043070	503	500	182	324	5	64.8	179
FBgn0043362	500	500	484	16	4	4	484
FBgn0043364	501	500	500	2	2	1	499
FBgn0043455	511	500	511	11	2	5.5	500
FBgn0043456	534	500	518	50	7	7.142857142857143	484
FBgn0043457	501	500	464	38	6	6.333333333333333	463
FBgn0043458	502	500	494	10	5	2	492
FBgn0043470	500	500	466	34	5	6.8	466
FBgn0043471	535	500	523	47	6	7.833333333333333	488
FBgn0043530	535	500	522	48	6	8	487
FBgn0043532	500	500	497	3	2	1.5	497
FBgn0043533	513	500	493	33	9	3.6666666666666665	480
FBgn0043535	424	395	388	65	7	9.285714285714286	359
FBgn0043539	500	500	496	4	2	2	496
FBgn0043550	502	500	459	45	2	22.5	457
FBgn0043575	504	500	503	5	2	2.5	499
FBgn0043577	500	500	496	4	1	4	496
FBgn0043578	537	500	516	58	9	6.444444444444445	479
FBgn0043783	526	500	296	256	3	85.33333333333333	270
FBgn0043791	562	500	560	64	4	16	498
FBgn0043792	506	500	505	7	2	3.5	499
FBgn0043796	502	500	464	40	6	6.666666666666667	462
FBgn0043806	506	500	428	84	7	12	422
FBgn0043825	544	500	525	63	8	7.875	481
FBgn0043841	551	500	540	62	9	6.888888888888889	489
FBgn0043854	511	500	478	44	5	8.8	467
FBgn0043884	508	500	507	9	3	3	499
FBgn0043900	500	500	500	0	0	NA	500
FBgn0043903	501	500	491	11	2	5.5	490
FBgn0044011	507	500	415	99	6	16.5	408
FBgn0044020	504	500	503	5	3	1.6666666666666667	499
FBgn0044030	507	500	499	15	3	5	492
FBgn0044046	511	500	501	21	7	3	490
FBgn0044047	526	500	517	35	5	7	491
FBgn0044048	524	500	507	41	7	5.857142857142857	483
FBgn0044049	532	500	524	40	4	10	492
FBgn0044050	526	500	508	44	4	11	482
FBgn0044328	502	500	487	17	5	3.4	485
FBgn0044452	548	500	529	67	6	11.166666666666666	481
FBgn0044511	551	500	529	73	7	10.428571428571429	478
FBgn0044809	501	500	472	30	5	6	471
FBgn0044810	501	500	500	2	2	1	499
FBgn0044811	504	500	281	227	4	56.75	277
FBgn0044812	506	500	471	41	11	3.727272727272727	465
FBgn0044871	527	500	513	41	6	6.833333333333333	486
FBgn0045035	524	500	522	26	6	4.333333333333333	498
FBgn0045038	508	500	506	10	2	5	498
FBgn0045064	511	500	493	29	5	5.8	482
FBgn0045073	500	500	497	3	2	1.5	497
FBgn0045442	500	500	181	319	2	159.5	181
FBgn0045443	522	500	271	273	3	91	249
FBgn0045471	500	500	479	21	5	4.2	479
FBgn0045473	500	500	484	16	3	5.333333333333333	484
FBgn0045474	501	500	480	22	5	4.4	479
FBgn0045479	500	500	477	23	4	5.75	477
FBgn0045482	477	477	242	235	1	235	242
FBgn0045495	546	500	535	57	7	8.142857142857142	489
FBgn0045497	536	500	529	43	5	8.6	493
FBgn0045500	400	399	289	112	2	56	288
FBgn0045759	500	500	498	2	2	1	498
FBgn0045761	388	376	380	20	4	5	368
FBgn0045770	506	500	484	28	5	5.6	478
FBgn0045823	520	500	507	33	4	8.25	487
FBgn0045842	519	500	484	54	14	3.857142857142857	465
FBgn0045843	557	500	549	65	7	9.285714285714286	492
FBgn0045852	506	500	506	6	1	6	500
FBgn0045862	505	500	482	28	5	5.6	477
FBgn0045866	501	500	499	3	3	1	498
FBgn0046113	532	500	529	35	4	8.75	497
FBgn0046114	511	500	504	18	5	3.6	493
FBgn0046225	502	500	485	19	2	9.5	483
FBgn0046247	487	478	481	15	5	3	472
FBgn0046253	539	500	535	43	6	7.166666666666667	496
FBgn0046258	513	500	470	56	7	8	457
FBgn0046294	518	500	514	22	5	4.4	496
FBgn0046296	516	500	484	48	10	4.8	468
FBgn0046297	528	500	514	42	5	8.4	486
FBgn0046302	500	500	407	93	4	23.25	407
FBgn0046332	509	500	506	12	5	2.4	497
FBgn0046685	513	500	513	13	1	13	500
FBgn0046687	531	500	519	43	9	4.777777777777778	488
FBgn0046689	521	500	513	29	8	3.625	492
FBgn0046692	523	500	448	98	12	8.166666666666666	425
FBgn0046704	504	500	468	40	6	6.666666666666667	464
FBgn0046756	524	500	512	36	6	6	488
FBgn0046763	511	500	507	15	3	5	496
FBgn0046873	500	500	94	406	3	135.33333333333334	94
FBgn0046875	516	500	497	35	8	4.375	481
FBgn0046876	546	500	525	67	8	8.375	479
FBgn0046878	536	500	524	48	6	8	488
FBgn0046879	505	500	505	5	1	5	500
FBgn0046880	501	500	493	9	3	3	492
FBgn0046887	500	500	490	10	3	3.3333333333333335	490
FBgn0047000	502	500	499	5	3	1.6666666666666667	497
FBgn0047038	427	426	378	50	6	8.333333333333334	377
FBgn0047092	516	500	504	28	6	4.666666666666667	488
FBgn0047095	500	500	493	7	3	2.3333333333333335	493
FBgn0047114	500	500	500	0	0	NA	500
FBgn0047135	500	500	494	6	2	3	494
FBgn0047178	529	500	508	50	4	12.5	479
FBgn0047199	502	500	459	45	6	7.5	457
FBgn0047205	500	500	476	24	3	8	476
FBgn0047330	512	500	352	172	6	28.666666666666668	340
FBgn0047338	508	500	471	45	5	9	463
FBgn0047351	506	500	501	11	3	3.6666666666666665	495
FBgn0050000	500	500	494	6	2	3	494
FBgn0050008	506	500	504	8	2	4	498
FBgn0050009	500	500	486	14	1	14	486
FBgn0050010	505	500	465	45	9	5	460
FBgn0050016	526	500	470	82	9	9.11111111111111	444
FBgn0050018	531	500	382	180	7	25.714285714285715	351
FBgn0050020	507	500	467	47	11	4.2727272727272725	460
FBgn0050021	532	500	526	38	7	5.428571428571429	494
FBgn0050026	434	404	407	57	8	7.125	377
FBgn0050029	347	346	336	12	3	4	335
FBgn0050033	500	500	498	2	1	2	498
FBgn0050035	514	500	473	55	7	7.857142857142857	459
FBgn0050037	541	500	481	101	10	10.1	440
FBgn0050039	505	500	499	11	4	2.75	494
FBgn0050042	508	500	505	11	2	5.5	497
FBgn0050043	464	463	429	36	4	9	428
FBgn0050045	506	500	500	12	4	3	494
FBgn0050046	376	348	359	45	4	11.25	331
FBgn0050047	505	500	505	5	2	2.5	500
FBgn0050049	391	378	387	17	3	5.666666666666667	374
FBgn0050050	506	500	492	20	3	6.666666666666667	486
FBgn0050051	501	500	494	8	6	1.3333333333333333	493
FBgn0050052	506	500	497	15	5	3	491
FBgn0050054	518	500	434	102	5	20.4	416
FBgn0050055	500	500	499	1	1	1	499
FBgn0050067	501	500	497	5	3	1.6666666666666667	496
FBgn0050069	510	500	508	12	4	3	498
FBgn0050074	500	496	492	12	3	4	488
FBgn0050075	502	500	502	2	2	1	500
FBgn0050076	503	500	501	5	3	1.6666666666666667	498
FBgn0050077	500	500	498	2	1	2	498
FBgn0050081	507	500	507	7	2	3.5	500
FBgn0050082	541	500	541	41	1	41	500
FBgn0050083	502	500	498	6	3	2	496
FBgn0050085	530	500	526	34	8	4.25	496
FBgn0050089	508	500	504	12	6	2	496
FBgn0050091	577	500	576	78	10	7.8	499
FBgn0050094	505	500	445	65	8	8.125	440
FBgn0050095	507	500	476	38	8	4.75	469
FBgn0050096	500	500	499	1	1	1	499
FBgn0050098	530	500	517	43	3	14.333333333333334	487
FBgn0050101	500	500	497	3	2	1.5	497
FBgn0050103	541	500	447	135	13	10.384615384615385	406
FBgn0050104	519	500	475	63	9	7	456
FBgn0050105	501	500	486	16	2	8	485
FBgn0050106	502	500	501	3	2	1.5	499
FBgn0050108	524	500	520	28	6	4.666666666666667	496
FBgn0050110	511	500	313	209	5	41.8	302
FBgn0050114	520	500	510	30	9	3.3333333333333335	490
FBgn0050121	503	500	493	13	6	2.1666666666666665	490
FBgn0050125	511	500	501	21	3	7	490
FBgn0050145	533	500	520	46	7	6.571428571428571	487
FBgn0050147	510	500	462	58	5	11.6	452
FBgn0050151	500	500	494	6	3	2	494
FBgn0050154	395	389	389	12	3	4	383
FBgn0050157	502	500	492	12	6	2	490
FBgn0050158	500	500	470	30	3	10	470
FBgn0050160	500	500	495	5	1	5	495
FBgn0050161	501	500	499	3	3	1	498
FBgn0050169	500	500	497	3	2	1.5	497
FBgn0050172	376	376	376	0	0	NA	376
FBgn0050177	512	500	488	36	3	12	476
FBgn0050178	503	500	491	15	5	3	488
FBgn0050183	500	500	478	22	5	4.4	478
FBgn0050192	503	500	498	8	2	4	495
FBgn0050196	361	361	358	3	2	1.5	358
FBgn0050197	554	500	529	79	10	7.9	475
FBgn0050198	506	500	451	61	6	10.166666666666666	445
FBgn0050201	519	500	509	29	7	4.142857142857143	490
FBgn0050202	519	500	500	38	8	4.75	481
FBgn0050203	449	449	449	0	0	NA	449
FBgn0050211	506	500	503	9	4	2.25	497
FBgn0050215	577	500	530	124	9	13.777777777777779	453
FBgn0050222	505	500	505	5	2	2.5	500
FBgn0050223	502	500	498	6	5	1.2	496
FBgn0050227	505	500	490	20	3	6.666666666666667	485
FBgn0050234	500	500	495	5	2	2.5	495
FBgn0050235	501	500	485	17	5	3.4	484
FBgn0050241	506	500	485	27	5	5.4	479
FBgn0050250	527	500	515	39	6	6.5	488
FBgn0050257	501	500	494	8	4	2	493
FBgn0050259	518	500	498	38	4	9.5	480
FBgn0050263	500	500	481	19	3	6.333333333333333	481
FBgn0050265	511	500	502	20	7	2.857142857142857	491
FBgn0050267	378	375	196	185	5	37	193
FBgn0050271	500	500	405	95	2	47.5	405
FBgn0050272	500	500	495	5	2	2.5	495
FBgn0050279	522	500	515	29	6	4.833333333333333	493
FBgn0050280	501	500	495	7	3	2.3333333333333335	494
FBgn0050281	355	355	355	0	0	NA	355
FBgn0050284	550	500	549	51	4	12.75	499
FBgn0050285	509	500	498	20	5	4	489
FBgn0050293	457	447	455	12	5	2.4	445
FBgn0050296	513	500	501	25	7	3.5714285714285716	488
FBgn0050298	515	500	509	21	8	2.625	494
FBgn0050299	507	500	503	11	3	3.6666666666666665	496
FBgn0050326	374	353	265	130	9	14.444444444444445	244
FBgn0050334	508	500	455	61	8	7.625	447
FBgn0050339	500	500	490	10	3	3.3333333333333335	490
FBgn0050342	500	500	499	1	1	1	499
FBgn0050343	502	500	501	3	2	1.5	499
FBgn0050345	472	472	459	13	3	4.333333333333333	459
FBgn0050355	500	500	492	8	1	8	492
FBgn0050359	510	500	485	35	10	3.5	475
FBgn0050361	501	500	499	3	3	1	498
FBgn0050369	504	500	483	25	4	6.25	479
FBgn0050371	530	500	523	37	5	7.4	493
FBgn0050372	500	500	496	4	2	2	496
FBgn0050373	500	500	492	8	1	8	492
FBgn0050374	509	500	379	139	6	23.166666666666668	370
FBgn0050375	385	379	290	101	2	50.5	284
FBgn0050376	505	500	501	9	3	3	496
FBgn0050379	507	500	491	23	5	4.6	484
FBgn0050380	505	500	499	11	4	2.75	494
FBgn0050383	525	500	477	73	8	9.125	452
FBgn0050389	552	500	535	69	7	9.857142857142858	483
FBgn0050390	502	500	497	7	4	1.75	495
FBgn0050393	500	500	474	26	6	4.333333333333333	474
FBgn0050394	534	500	533	35	3	11.666666666666666	499
FBgn0050395	532	500	509	55	7	7.857142857142857	477
FBgn0050398	500	500	493	7	3	2.3333333333333335	493
FBgn0050401	501	500	499	3	3	1	498
FBgn0050403	514	500	512	16	3	5.333333333333333	498
FBgn0050404	504	500	500	8	4	2	496
FBgn0050406	504	500	464	44	6	7.333333333333333	460
FBgn0050407	501	500	474	28	3	9.333333333333334	473
FBgn0050409	523	500	504	42	7	6	481
FBgn0050411	520	500	494	46	8	5.75	474
FBgn0050412	517	500	504	30	6	5	487
FBgn0050413	508	500	469	47	3	15.666666666666666	461
FBgn0050414	515	500	498	32	11	2.909090909090909	483
FBgn0050416	500	500	497	3	1	3	497
FBgn0050417	501	500	499	3	3	1	498
FBgn0050419	503	500	454	52	5	10.4	451
FBgn0050421	508	500	480	36	8	4.5	472
FBgn0050423	539	500	535	43	6	7.166666666666667	496
FBgn0050424	500	500	176	324	5	64.8	176
FBgn0050430	505	500	320	190	3	63.333333333333336	315
FBgn0050431	509	500	509	9	1	9	500
FBgn0050440	547	500	503	91	8	11.375	456
FBgn0050443	544	500	521	67	9	7.444444444444445	477
FBgn0050446	511	500	511	11	2	5.5	500
FBgn0050447	528	500	236	320	6	53.333333333333336	208
FBgn0050457	500	500	500	0	0	NA	500
FBgn0050458	502	500	485	19	3	6.333333333333333	483
FBgn0050460	501	500	498	4	3	1.3333333333333333	497
FBgn0050463	517	500	513	21	4	5.25	496
FBgn0050464	531	500	530	32	5	6.4	499
FBgn0050466	516	500	516	16	1	16	500
FBgn0050467	501	500	486	16	3	5.333333333333333	485
FBgn0050468	514	500	373	155	6	25.833333333333332	359
FBgn0050469	397	388	391	15	3	5	382
FBgn0050471	500	500	478	22	3	7.333333333333333	478
FBgn0050472	500	500	426	74	2	37	426
FBgn0050476	500	500	343	157	1	157	343
FBgn0050484	504	500	502	6	4	1.5	498
FBgn0050486	544	500	522	66	9	7.333333333333333	478
FBgn0050487	500	500	499	1	1	1	499
FBgn0050491	500	500	499	1	1	1	499
FBgn0050493	500	500	486	14	2	7	486
FBgn0050502	502	500	494	10	2	5	492
FBgn0050506	500	500	499	1	1	1	499
FBgn0050509	506	500	503	9	5	1.8	497
FBgn0051002	524	500	511	37	4	9.25	487
FBgn0051004	500	500	499	1	1	1	499
FBgn0051005	501	500	498	4	2	2	497
FBgn0051010	510	500	501	19	6	3.1666666666666665	491
FBgn0051013	542	500	521	63	8	7.875	479
FBgn0051014	509	500	495	23	6	3.8333333333333335	486
FBgn0051015	501	500	440	62	6	10.333333333333334	439
FBgn0051019	500	500	482	18	3	6	482
FBgn0051021	505	500	497	13	4	3.25	492
FBgn0051023	500	500	494	6	2	3	494
FBgn0051028	500	500	489	11	3	3.6666666666666665	489
FBgn0051029	518	500	458	78	6	13	440
FBgn0051030	399	381	393	24	3	8	375
FBgn0051032	488	488	454	34	4	8.5	454
FBgn0051036	521	500	503	39	7	5.571428571428571	482
FBgn0051038	504	500	464	44	4	11	460
FBgn0051040	511	500	504	18	5	3.6	493
FBgn0051041	500	500	221	279	2	139.5	221
FBgn0051044	505	500	498	12	4	3	493
FBgn0051050	500	500	498	2	1	2	498
FBgn0051051	501	500	501	1	1	1	500
FBgn0051053	503	500	500	6	3	2	497
FBgn0051055	510	500	479	41	5	8.2	469
FBgn0051064	500	500	449	51	2	25.5	449
FBgn0051068	500	500	494	6	1	6	494
FBgn0051070	500	500	466	34	2	17	466
FBgn0051072	515	500	515	15	3	5	500
FBgn0051075	510	500	500	20	8	2.5	490
FBgn0051076	500	500	492	8	3	2.6666666666666665	492
FBgn0051080	500	500	497	3	3	1	497
FBgn0051084	500	500	497	3	1	3	497
FBgn0051086	501	500	501	1	1	1	500
FBgn0051087	500	500	493	7	3	2.3333333333333335	493
FBgn0051089	506	500	506	6	3	2	500
FBgn0051092	528	500	527	29	4	7.25	499
FBgn0051093	500	500	489	11	1	11	489
FBgn0051098	530	500	431	129	6	21.5	401
FBgn0051100	506	500	506	6	1	6	500
FBgn0051102	508	500	488	28	7	4	480
FBgn0051103	510	500	491	29	8	3.625	481
FBgn0051104	393	382	385	19	5	3.8	374
FBgn0051106	501	500	495	7	4	1.75	494
FBgn0051111	504	500	503	5	2	2.5	499
FBgn0051115	507	500	496	18	5	3.6	489
FBgn0051116	506	500	489	23	5	4.6	483
FBgn0051121	530	500	516	44	5	8.8	486
FBgn0051122	538	500	530	46	4	11.5	492
FBgn0051125	501	500	500	2	2	1	499
FBgn0051126	526	500	515	37	6	6.166666666666667	489
FBgn0051128	500	500	465	35	5	7	465
FBgn0051130	518	500	501	35	7	5	483
FBgn0051140	509	500	504	14	4	3.5	495
FBgn0051141	500	500	488	12	2	6	488
FBgn0051143	517	500	499	35	4	8.75	482
FBgn0051144	501	500	501	1	1	1	500
FBgn0051145	523	500	486	60	10	6	463
FBgn0051146	541	500	507	75	9	8.333333333333334	466
FBgn0051148	521	500	512	30	5	6	491
FBgn0051156	500	500	495	5	2	2.5	495
FBgn0051157	422	418	381	45	4	11.25	377
FBgn0051158	502	500	466	38	6	6.333333333333333	464
FBgn0051159	500	500	453	47	2	23.5	453
FBgn0051163	514	500	509	19	4	4.75	495
FBgn0051165	546	500	545	47	5	9.4	499
FBgn0051174	541	500	541	41	2	20.5	500
FBgn0051176	504	500	480	28	4	7	476
FBgn0051183	504	500	476	32	7	4.571428571428571	472
FBgn0051191	525	500	510	40	5	8	485
FBgn0051195	527	500	521	33	8	4.125	494
FBgn0051198	506	500	504	8	3	2.6666666666666665	498
FBgn0051199	435	409	417	44	9	4.888888888888889	391
FBgn0051200	520	500	485	55	5	11	465
FBgn0051205	527	500	369	185	9	20.555555555555557	342
FBgn0051206	501	500	494	8	3	2.6666666666666665	493
FBgn0051207	526	500	508	44	10	4.4	482
FBgn0051211	542	500	539	45	6	7.5	497
FBgn0051215	518	500	485	51	11	4.636363636363637	467
FBgn0051216	505	500	496	14	6	2.3333333333333335	491
FBgn0051219	501	485	224	293	6	48.833333333333336	208
FBgn0051220	500	500	489	11	1	11	489
FBgn0051221	505	500	365	145	3	48.333333333333336	360
FBgn0051223	500	500	180	320	7	45.714285714285715	180
FBgn0051224	503	500	496	10	2	5	493
FBgn0051225	500	500	484	16	2	8	484
FBgn0051226	523	500	491	55	9	6.111111111111111	468
FBgn0051228	521	500	498	44	12	3.6666666666666665	477
FBgn0051233	502	500	501	3	3	1	499
FBgn0051249	502	500	241	263	4	65.75	239
FBgn0051251	500	500	461	39	4	9.75	461
FBgn0051259	425	423	398	29	6	4.833333333333333	396
FBgn0051262	505	500	498	12	5	2.4	493
FBgn0051266	502	500	502	2	1	2	500
FBgn0051267	500	500	230	270	2	135	230
FBgn0051268	506	500	491	21	4	5.25	485
FBgn0051269	500	500	498	2	1	2	498
FBgn0051272	505	500	485	25	6	4.166666666666667	480
FBgn0051279	504	500	471	37	2	18.5	467
FBgn0051281	502	500	494	10	3	3.3333333333333335	492
FBgn0051287	518	500	518	18	3	6	500
FBgn0051288	509	500	501	17	8	2.125	492
FBgn0051294	500	500	466	34	3	11.333333333333334	466
FBgn0051296	514	500	501	27	6	4.5	487
FBgn0051300	532	500	525	39	6	6.5	493
FBgn0051301	500	500	496	4	2	2	496
FBgn0051313	575	500	564	86	6	14.333333333333334	489
FBgn0051321	508	500	478	38	8	4.75	470
FBgn0051323	532	500	532	32	1	32	500
FBgn0051324	500	500	487	13	2	6.5	487
FBgn0051326	505	483	503	24	3	8	481
FBgn0051327	545	500	535	55	5	11	490
FBgn0051331	508	500	464	52	7	7.428571428571429	456
FBgn0051333	465	464	410	56	7	8	409
FBgn0051334	364	352	357	19	6	3.1666666666666665	345
FBgn0051337	502	500	487	17	3	5.666666666666667	485
FBgn0051342	514	500	471	57	6	9.5	457
FBgn0051343	500	500	497	3	3	1	497
FBgn0051344	528	500	525	31	4	7.75	497
FBgn0051345	504	500	503	5	4	1.25	499
FBgn0051347	500	500	500	0	0	NA	500
FBgn0051352	514	500	493	35	5	7	479
FBgn0051356	503	500	498	8	3	2.6666666666666665	495
FBgn0051357	520	500	516	24	5	4.8	496
FBgn0051360	518	500	504	32	6	5.333333333333333	486
FBgn0051361	501	500	501	1	1	1	500
FBgn0051363	502	500	485	19	5	3.8	483
FBgn0051368	502	500	502	2	1	2	500
FBgn0051374	501	500	500	2	2	1	499
FBgn0051380	520	494	501	45	8	5.625	475
FBgn0051382	500	500	499	1	1	1	499
FBgn0051383	513	500	431	95	5	19	418
FBgn0051386	500	500	498	2	2	1	498
FBgn0051388	445	415	430	45	6	7.5	400
FBgn0051410	501	500	501	1	1	1	500
FBgn0051415	500	500	497	3	1	3	497
FBgn0051418	500	500	492	8	2	4	492
FBgn0051423	519	500	513	25	3	8.333333333333334	494
FBgn0051427	462	462	203	259	3	86.33333333333333	203
FBgn0051431	501	500	499	3	2	1.5	498
FBgn0051432	511	500	496	26	3	8.666666666666666	485
FBgn0051437	500	500	479	21	3	7	479
FBgn0051438	505	500	475	35	8	4.375	470
FBgn0051446	500	500	481	19	2	9.5	481
FBgn0051454	531	499	530	33	3	11	498
FBgn0051457	500	500	497	3	2	1.5	497
FBgn0051459	526	500	483	69	8	8.625	457
FBgn0051460	502	500	499	5	3	1.6666666666666667	497
FBgn0051467	502	500	497	7	2	3.5	495
FBgn0051471	504	500	502	6	4	1.5	498
FBgn0051472	508	500	344	172	6	28.666666666666668	336
FBgn0051475	514	500	511	17	6	2.8333333333333335	497
FBgn0051477	506	500	489	23	5	4.6	483
FBgn0051480	501	500	500	2	2	1	499
FBgn0051481	500	500	499	1	1	1	499
FBgn0051482	526	500	522	30	4	7.5	496
FBgn0051491	528	500	471	85	7	12.142857142857142	443
FBgn0051493	528	500	479	77	8	9.625	451
FBgn0051495	533	500	509	57	6	9.5	476
FBgn0051496	570	500	564	76	4	19	494
FBgn0051497	501	500	490	12	3	4	489
FBgn0051506	500	500	489	11	3	3.6666666666666665	489
FBgn0051514	502	500	498	6	3	2	496
FBgn0051515	508	500	459	57	8	7.125	451
FBgn0051516	500	500	496	4	3	1.3333333333333333	496
FBgn0051522	513	500	508	18	4	4.5	495
FBgn0051523	500	500	115	385	2	192.5	115
FBgn0051524	500	500	296	204	2	102	296
FBgn0051525	500	500	500	0	0	NA	500
FBgn0051546	432	410	422	32	10	3.2	400
FBgn0051547	524	500	433	115	5	23	409
FBgn0051548	551	500	535	67	8	8.375	484
FBgn0051550	507	500	417	97	9	10.777777777777779	410
FBgn0051551	500	500	126	374	2	187	126
FBgn0051559	502	500	488	16	2	8	486
FBgn0051560	507	500	455	59	12	4.916666666666667	448
FBgn0051561	503	500	503	3	1	3	500
FBgn0051562	500	500	312	188	5	37.6	312
FBgn0051569	539	500	538	40	4	10	499
FBgn0051575	501	500	492	10	4	2.5	491
FBgn0051579	505	500	436	74	4	18.5	431
FBgn0051588	500	500	330	170	3	56.666666666666664	330
FBgn0051591	504	500	478	30	3	10	474
FBgn0051609	505	500	501	9	4	2.25	496
FBgn0051619	527	500	491	63	7	9	464
FBgn0051626	501	500	487	15	6	2.5	486
FBgn0051627	525	500	515	35	7	5	490
FBgn0051632	510	500	506	14	3	4.666666666666667	496
FBgn0051634	533	500	525	41	8	5.125	492
FBgn0051635	501	500	501	1	1	1	500
FBgn0051636	518	500	516	20	2	10	498
FBgn0051638	501	500	496	6	2	3	495
FBgn0051639	504	500	477	31	4	7.75	473
FBgn0051643	517	500	515	19	5	3.8	498
FBgn0051644	536	500	520	52	11	4.7272727272727275	484
FBgn0051646	500	500	500	0	0	NA	500
FBgn0051647	501	500	478	24	4	6	477
FBgn0051658	500	500	469	31	6	5.166666666666667	469
FBgn0051659	356	356	328	28	3	9.333333333333334	328
FBgn0051660	423	408	419	19	3	6.333333333333333	404
FBgn0051663	503	500	495	11	6	1.8333333333333333	492
FBgn0051665	500	500	496	4	1	4	496
FBgn0051668	492	489	465	30	8	3.75	462
FBgn0051669	502	500	499	5	2	2.5	497
FBgn0051673	555	500	554	56	5	11.2	499
FBgn0051675	512	500	509	15	7	2.142857142857143	497
FBgn0051676	513	500	509	17	5	3.4	496
FBgn0051678	527	500	527	27	4	6.75	500
FBgn0051681	519	500	481	57	5	11.4	462
FBgn0051682	509	500	507	11	2	5.5	498
FBgn0051690	503	500	492	14	3	4.666666666666667	489
FBgn0051694	503	500	454	52	7	7.428571428571429	451
FBgn0051698	500	500	500	0	0	NA	500
FBgn0051700	506	500	490	22	7	3.142857142857143	484
FBgn0051703	500	500	55	445	3	148.33333333333334	55
FBgn0051706	523	500	512	34	3	11.333333333333334	489
FBgn0051708	502	500	501	3	2	1.5	499
FBgn0051709	376	364	370	18	4	4.5	358
FBgn0051710	501	500	491	11	3	3.6666666666666665	490
FBgn0051716	516	500	511	21	4	5.25	495
FBgn0051717	500	500	500	0	0	NA	500
FBgn0051718	504	500	495	13	3	4.333333333333333	491
FBgn0051719	545	500	528	62	15	4.133333333333334	483
FBgn0051720	519	500	400	138	6	23	381
FBgn0051721	507	500	471	43	11	3.909090909090909	464
FBgn0051729	500	500	111	389	2	194.5	111
FBgn0051730	507	500	507	7	3	2.3333333333333335	500
FBgn0051735	506	500	474	38	6	6.333333333333333	468
FBgn0051739	361	361	353	8	4	2	353
FBgn0051740	500	500	496	4	1	4	496
FBgn0051741	532	500	527	37	6	6.166666666666667	495
FBgn0051742	501	500	473	29	2	14.5	472
FBgn0051760	524	500	447	101	7	14.428571428571429	423
FBgn0051769	524	500	514	34	7	4.857142857142857	490
FBgn0051774	501	500	381	121	3	40.333333333333336	380
FBgn0051776	525	500	521	29	4	7.25	496
FBgn0051778	500	500	498	2	2	1	498
FBgn0051781	513	500	500	26	5	5.2	487
FBgn0051784	500	500	475	25	4	6.25	475
FBgn0051785	503	500	246	260	7	37.142857142857146	243
FBgn0051787	500	500	426	74	2	37	426
FBgn0051789	516	500	510	22	9	2.4444444444444446	494
FBgn0051792	522	500	422	122	7	17.428571428571427	400
FBgn0051793	567	500	561	73	8	9.125	494
FBgn0051797	516	500	504	28	6	4.666666666666667	488
FBgn0051798	516	500	516	16	3	5.333333333333333	500
FBgn0051800	503	500	497	9	5	1.8	494
FBgn0051803	500	500	498	2	1	2	498
FBgn0051804	506	500	494	18	4	4.5	488
FBgn0051807	501	500	459	43	7	6.142857142857143	458
FBgn0051810	501	500	247	255	5	51	246
FBgn0051812	529	500	495	63	10	6.3	466
FBgn0051813	500	500	498	2	1	2	498
FBgn0051814	510	500	482	38	8	4.75	472
FBgn0051816	504	500	500	8	4	2	496
FBgn0051820	501	500	492	10	2	5	491
FBgn0051823	501	500	488	14	4	3.5	487
FBgn0051824	540	500	537	43	6	7.166666666666667	497
FBgn0051826	501	500	296	206	7	29.428571428571427	295
FBgn0051832	503	500	259	247	3	82.33333333333333	256
FBgn0051840	509	500	509	9	2	4.5	500
FBgn0051845	502	500	482	22	5	4.4	480
FBgn0051848	501	500	361	141	4	35.25	360
FBgn0051862	509	500	499	19	4	4.75	490
FBgn0051869	485	485	344	141	6	23.5	344
FBgn0051870	556	500	516	96	7	13.714285714285714	460
FBgn0051871	538	500	525	51	9	5.666666666666667	487
FBgn0051872	352	338	337	29	2	14.5	323
FBgn0051876	518	500	506	30	5	6	488
FBgn0051882	502	500	490	14	6	2.3333333333333335	488
FBgn0051885	535	500	514	56	9	6.222222222222222	479
FBgn0051889	542	500	516	68	9	7.555555555555555	474
FBgn0051890	500	500	491	9	2	4.5	491
FBgn0051892	528	500	527	29	3	9.666666666666666	499
FBgn0051898	489	448	486	44	5	8.8	445
FBgn0051901	538	500	528	48	9	5.333333333333333	490
FBgn0051907	500	500	496	4	2	2	496
FBgn0051908	509	500	509	9	1	9	500
FBgn0051910	500	500	499	1	1	1	499
FBgn0051912	500	500	497	3	1	3	497
FBgn0051913	503	500	468	38	2	19	465
FBgn0051921	500	500	465	35	4	8.75	465
FBgn0051922	502	500	485	19	3	6.333333333333333	483
FBgn0051928	502	500	496	8	4	2	494
FBgn0051933	543	500	537	49	4	12.25	494
FBgn0051935	501	500	482	20	5	4	481
FBgn0051940	545	500	538	52	8	6.5	493
FBgn0051942	500	500	475	25	8	3.125	475
FBgn0051946	509	500	485	33	4	8.25	476
FBgn0051949	527	500	395	159	5	31.8	368
FBgn0051950	502	500	500	4	2	2	498
FBgn0051952	500	500	491	9	6	1.5	491
FBgn0051954	486	486	482	4	1	4	482
FBgn0051955	508	500	506	10	4	2.5	498
FBgn0051957	373	371	371	4	3	1.3333333333333333	369
FBgn0051960	503	500	502	4	2	2	499
FBgn0051961	506	500	502	10	5	2	496
FBgn0051971	502	500	502	2	1	2	500
FBgn0051974	518	500	515	21	5	4.2	497
FBgn0051988	540	500	539	41	5	8.2	499
FBgn0051992	509	500	345	173	9	19.22222222222222	336
FBgn0051997	502	500	436	68	8	8.5	434
FBgn0051998	500	500	130	370	2	185	130
FBgn0051999	507	500	495	19	5	3.8	488
FBgn0052006	560	500	546	74	9	8.222222222222221	486
FBgn0052022	500	500	417	83	4	20.75	417
FBgn0052023	500	500	483	17	3	5.666666666666667	483
FBgn0052024	500	500	494	6	2	3	494
FBgn0052029	510	500	500	20	5	4	490
FBgn0052034	509	500	472	46	2	23	463
FBgn0052036	507	500	500	14	3	4.666666666666667	493
FBgn0052037	503	500	463	43	7	6.142857142857143	460
FBgn0052039	502	500	500	4	3	1.3333333333333333	498
FBgn0052040	500	500	499	1	1	1	499
FBgn0052053	503	485	480	41	4	10.25	462
FBgn0052054	500	500	235	265	1	265	235
FBgn0052056	519	500	507	31	4	7.75	488
FBgn0052057	523	500	521	25	6	4.166666666666667	498
FBgn0052058	500	500	487	13	1	13	487
FBgn0052062	502	500	502	2	2	1	500
FBgn0052066	584	500	509	159	13	12.23076923076923	425
FBgn0052068	454	449	438	21	4	5.25	433
FBgn0052071	545	500	503	87	10	8.7	458
FBgn0052072	406	390	380	42	6	7	364
FBgn0052073	501	500	99	403	4	100.75	98
FBgn0052074	508	500	500	16	4	4	492
FBgn0052075	500	500	495	5	1	5	495
FBgn0052079	503	500	491	15	5	3	488
FBgn0052082	506	500	455	57	4	14.25	449
FBgn0052085	509	500	483	35	6	5.833333333333333	474
FBgn0052088	486	466	477	29	5	5.8	457
FBgn0052093	531	500	528	34	7	4.857142857142857	497
FBgn0052100	506	500	488	24	5	4.8	482
FBgn0052102	519	500	321	217	2	108.5	302
FBgn0052103	495	493	492	5	2	2.5	490
FBgn0052105	501	500	495	7	3	2.3333333333333335	494
FBgn0052107	501	486	476	40	7	5.714285714285714	461
FBgn0052109	442	411	419	54	9	6	388
FBgn0052111	517	500	500	34	4	8.5	483
FBgn0052112	511	500	462	60	6	10	451
FBgn0052113	510	500	505	15	3	5	495
FBgn0052117	500	500	456	44	5	8.8	456
FBgn0052119	504	500	496	12	3	4	492
FBgn0052121	505	500	499	11	2	5.5	494
FBgn0052123	503	500	503	3	2	1.5	500
FBgn0052126	500	500	482	18	4	4.5	482
FBgn0052129	500	500	488	12	1	12	488
FBgn0052133	504	500	497	11	5	2.2	493
FBgn0052137	507	500	430	84	4	21	423
FBgn0052150	504	500	480	28	6	4.666666666666667	476
FBgn0052153	501	500	497	5	2	2.5	496
FBgn0052160	500	500	489	11	4	2.75	489
FBgn0052163	500	500	492	8	2	4	492
FBgn0052174	517	500	511	23	4	5.75	494
FBgn0052176	516	500	504	28	6	4.666666666666667	488
FBgn0052182	546	500	533	59	9	6.555555555555555	487
FBgn0052183	501	500	489	13	3	4.333333333333333	488
FBgn0052187	437	410	312	152	5	30.4	285
FBgn0052188	500	500	198	302	3	100.66666666666667	198
FBgn0052189	500	500	455	45	4	11.25	455
FBgn0052192	523	500	289	257	5	51.4	266
FBgn0052196	532	500	464	100	6	16.666666666666668	432
FBgn0052198	519	500	494	44	8	5.5	475
FBgn0052200	558	500	524	92	7	13.142857142857142	466
FBgn0052202	512	500	276	248	4	62	264
FBgn0052204	501	500	499	3	3	1	498
FBgn0052206	500	500	486	14	2	7	486
FBgn0052220	514	500	411	117	9	13	397
FBgn0052221	500	500	477	23	3	7.666666666666667	477
FBgn0052224	533	500	507	59	6	9.833333333333334	474
FBgn0052226	510	500	504	16	4	4	494
FBgn0052227	500	500	483	17	3	5.666666666666667	483
FBgn0052228	528	500	502	54	6	9	474
FBgn0052237	510	500	510	10	2	5	500
FBgn0052238	503	500	480	26	6	4.333333333333333	477
FBgn0052240	504	500	487	21	2	10.5	483
FBgn0052241	502	500	501	3	2	1.5	499
FBgn0052243	544	500	519	69	9	7.666666666666667	475
FBgn0052246	506	500	492	20	6	3.3333333333333335	486
FBgn0052248	501	500	500	2	2	1	499
FBgn0052249	501	500	477	25	4	6.25	476
FBgn0052250	384	375	373	20	6	3.3333333333333335	364
FBgn0052251	544	500	533	55	7	7.857142857142857	489
FBgn0052252	500	500	492	8	3	2.6666666666666665	492
FBgn0052259	536	500	498	74	6	12.333333333333334	462
FBgn0052260	484	470	473	25	5	5	459
FBgn0052263	502	500	490	14	6	2.3333333333333335	488
FBgn0052266	523	500	471	75	9	8.333333333333334	448
FBgn0052267	517	500	510	24	5	4.8	493
FBgn0052268	502	500	493	11	4	2.75	491
FBgn0052271	515	500	515	15	3	5	500
FBgn0052274	359	355	348	15	4	3.75	344
FBgn0052278	501	500	499	3	3	1	498
FBgn0052279	501	500	497	5	3	1.6666666666666667	496
FBgn0052280	500	500	500	0	0	NA	500
FBgn0052282	370	370	351	19	6	3.1666666666666665	351
FBgn0052283	438	408	417	51	4	12.75	387
FBgn0052286	501	500	460	42	3	14	459
FBgn0052288	504	500	504	4	2	2	500
FBgn0052296	525	500	517	33	7	4.714285714285714	492
FBgn0052301	518	500	362	174	4	43.5	344
FBgn0052303	523	500	508	38	6	6.333333333333333	485
FBgn0052304	390	390	383	7	4	1.75	383
FBgn0052305	489	489	477	12	3	4	477
FBgn0052311	500	500	489	11	3	3.6666666666666665	489
FBgn0052313	513	500	505	21	4	5.25	492
FBgn0052333	505	500	405	105	4	26.25	400
FBgn0052344	500	500	124	376	3	125.33333333333333	124
FBgn0052351	515	500	426	104	9	11.555555555555555	411
FBgn0052354	500	500	255	245	3	81.66666666666667	255
FBgn0052357	500	500	499	1	1	1	499
FBgn0052360	500	500	495	5	1	5	495
FBgn0052362	500	500	478	22	3	7.333333333333333	478
FBgn0052364	517	500	487	47	6	7.833333333333333	470
FBgn0052365	512	500	487	37	9	4.111111111111111	475
FBgn0052368	505	500	278	232	2	116	273
FBgn0052369	521	500	499	43	7	6.142857142857143	478
FBgn0052370	500	500	490	10	4	2.5	490
FBgn0052373	502	500	478	26	5	5.2	476
FBgn0052374	432	413	338	113	6	18.833333333333332	319
FBgn0052376	545	500	533	57	8	7.125	488
FBgn0052379	456	450	428	34	5	6.8	422
FBgn0052380	505	500	494	16	3	5.333333333333333	489
FBgn0052382	515	500	515	15	2	7.5	500
FBgn0052392	527	500	468	86	7	12.285714285714286	441
FBgn0052404	500	500	292	208	1	208	292
FBgn0052405	502	500	497	7	3	2.3333333333333335	495
FBgn0052406	500	500	500	0	0	NA	500
FBgn0052407	515	500	445	85	7	12.142857142857142	430
FBgn0052412	434	430	429	9	3	3	425
FBgn0052413	508	500	495	21	5	4.2	487
FBgn0052418	431	430	414	18	4	4.5	413
FBgn0052420	511	500	511	11	3	3.6666666666666665	500
FBgn0052421	487	486	486	2	2	1	485
FBgn0052423	510	500	505	15	4	3.75	495
FBgn0052425	430	337	420	103	7	14.714285714285714	327
FBgn0052428	500	500	494	6	1	6	494
FBgn0052432	501	500	494	8	4	2	493
FBgn0052436	502	500	480	24	4	6	478
FBgn0052437	526	500	437	115	10	11.5	411
FBgn0052438	504	500	487	21	4	5.25	483
FBgn0052440	396	362	374	56	8	7	340
FBgn0052442	566	500	520	112	12	9.333333333333334	454
FBgn0052446	415	415	141	274	1	274	141
FBgn0052447	520	500	512	28	5	5.6	492
FBgn0052449	541	500	536	46	6	7.666666666666667	495
FBgn0052450	515	500	513	17	2	8.5	498
FBgn0052451	501	500	331	171	3	57	330
FBgn0052452	504	500	468	40	8	5	464
FBgn0052457	510	500	223	297	5	59.4	213
FBgn0052460	521	500	503	39	4	9.75	482
FBgn0052461	500	500	137	363	1	363	137
FBgn0052462	533	500	463	103	11	9.363636363636363	430
FBgn0052473	416	416	416	0	0	NA	416
FBgn0052476	501	500	212	290	5	58	211
FBgn0052479	512	500	510	14	3	4.666666666666667	498
FBgn0052480	519	500	485	53	3	17.666666666666668	466
FBgn0052481	513	500	487	39	8	4.875	474
FBgn0052483	523	500	514	32	5	6.4	491
FBgn0052484	532	500	526	38	4	9.5	494
FBgn0052485	529	500	516	42	8	5.25	487
FBgn0052487	500	500	492	8	1	8	492
FBgn0052496	490	490	473	17	2	8.5	473
FBgn0052506	545	500	513	77	10	7.7	468
FBgn0052511	500	500	41	459	2	229.5	41
FBgn0052512	501	500	449	53	7	7.571428571428571	448
FBgn0052523	501	500	476	26	4	6.5	475
FBgn0052528	523	500	421	125	9	13.88888888888889	398
FBgn0052529	500	500	487	13	1	13	487
FBgn0052532	519	500	511	27	9	3	492
FBgn0052536	425	404	373	73	7	10.428571428571429	352
FBgn0052547	500	500	395	105	2	52.5	395
FBgn0052548	530	500	441	119	9	13.222222222222221	411
FBgn0052549	511	500	400	122	8	15.25	389
FBgn0052551	515	500	484	46	9	5.111111111111111	469
FBgn0052553	513	500	494	32	7	4.571428571428571	481
FBgn0052554	343	343	298	45	1	45	298
FBgn0052557	515	500	511	19	7	2.7142857142857144	496
FBgn0052563	553	500	510	96	6	16	457
FBgn0052564	501	500	451	51	2	25.5	450
FBgn0052568	504	500	459	49	5	9.8	455
FBgn0052569	512	500	504	20	4	5	492
FBgn0052570	501	500	498	4	3	1.3333333333333333	497
FBgn0052571	503	500	492	14	2	7	489
FBgn0052574	503	500	474	32	3	10.666666666666666	471
FBgn0052576	506	500	503	9	4	2.25	497
FBgn0052579	527	500	520	34	4	8.5	493
FBgn0052580	479	475	455	28	9	3.111111111111111	451
FBgn0052582	501	500	469	33	4	8.25	468
FBgn0052590	503	500	493	13	4	3.25	490
FBgn0052591	506	500	482	30	8	3.75	476
FBgn0052594	501	500	292	210	5	42	291
FBgn0052600	521	500	506	36	8	4.5	485
FBgn0052602	502	500	477	27	4	6.75	475
FBgn0052603	500	500	460	40	6	6.666666666666667	460
FBgn0052626	526	500	454	98	10	9.8	428
FBgn0052631	510	500	483	37	5	7.4	473
FBgn0052633	502	500	486	18	5	3.6	484
FBgn0052636	526	500	497	55	10	5.5	471
FBgn0052638	544	500	533	55	6	9.166666666666666	489
FBgn0052642	518	500	515	21	4	5.25	497
FBgn0052643	513	500	513	13	4	3.25	500
FBgn0052644	503	500	498	8	3	2.6666666666666665	495
FBgn0052645	503	500	498	8	2	4	495
FBgn0052647	511	500	488	34	8	4.25	477
FBgn0052649	471	431	460	51	8	6.375	420
FBgn0052655	500	500	492	8	3	2.6666666666666665	492
FBgn0052666	516	500	492	40	5	8	476
FBgn0052667	358	356	340	20	4	5	338
FBgn0052668	503	500	420	86	2	43	417
FBgn0052672	510	500	467	53	3	17.666666666666668	457
FBgn0052675	502	500	497	7	5	1.4	495
FBgn0052676	500	500	490	10	1	10	490
FBgn0052677	511	500	354	168	4	42	343
FBgn0052679	510	500	497	23	5	4.6	487
FBgn0052681	505	500	494	16	5	3.2	489
FBgn0052683	500	500	479	21	2	10.5	479
FBgn0052686	500	500	497	3	1	3	497
FBgn0052687	500	500	444	56	5	11.2	444
FBgn0052693	537	500	534	40	4	10	497
FBgn0052694	500	500	486	14	3	4.666666666666667	486
FBgn0052695	527	500	512	42	6	7	485
FBgn0052698	502	500	356	148	7	21.142857142857142	354
FBgn0052699	553	500	545	61	8	7.625	492
FBgn0052702	505	500	497	13	4	3.25	492
FBgn0052704	505	500	456	54	8	6.75	451
FBgn0052707	518	500	384	152	8	19	366
FBgn0052712	507	500	467	47	10	4.7	460
FBgn0052713	507	500	465	49	12	4.083333333333333	458
FBgn0052718	545	500	540	50	4	12.5	495
FBgn0052719	500	500	430	70	1	70	430
FBgn0052726	513	500	511	15	4	3.75	498
FBgn0052732	517	500	512	22	4	5.5	495
FBgn0052740	505	500	500	10	5	2	495
FBgn0052745	539	500	410	168	8	21	371
FBgn0052748	525	500	469	81	5	16.2	444
FBgn0052751	501	500	478	24	6	4	477
FBgn0052756	503	500	148	358	3	119.33333333333333	145
FBgn0052758	563	500	530	96	10	9.6	467
FBgn0052762	535	500	514	56	11	5.090909090909091	479
FBgn0052767	504	500	487	21	7	3	483
FBgn0052772	503	494	498	14	5	2.8	489
FBgn0052773	529	500	480	78	9	8.666666666666666	451
FBgn0052774	518	500	516	20	3	6.666666666666667	498
FBgn0052792	534	500	416	152	8	19	382
FBgn0052801	504	500	497	11	5	2.2	493
FBgn0052808	500	500	498	2	1	2	498
FBgn0052813	506	500	482	30	7	4.285714285714286	476
FBgn0052815	507	500	507	7	2	3.5	500
FBgn0052816	501	500	198	304	5	60.8	197
FBgn0052826	550	500	521	79	7	11.285714285714286	471
FBgn0052831	523	500	522	24	3	8	499
FBgn0052832	515	500	505	25	5	5	490
FBgn0052835	530	500	453	107	6	17.833333333333332	423
FBgn0052843	562	500	555	69	5	13.8	493
FBgn0052845	507	500	504	10	4	2.5	497
FBgn0052846	570	500	570	70	4	17.5	500
FBgn0052850	526	500	477	75	8	9.375	451
FBgn0052856	500	500	497	3	1	3	497
FBgn0052944	516	500	491	41	5	8.2	475
FBgn0052982	538	500	520	56	8	7	482
FBgn0052984	362	357	299	68	6	11.333333333333334	294
FBgn0052986	501	500	483	19	4	4.75	482
FBgn0053002	500	500	466	34	3	11.333333333333334	466
FBgn0053003	500	500	498	2	1	2	498
FBgn0053012	500	500	482	18	4	4.5	482
FBgn0053013	500	500	495	5	3	1.6666666666666667	495
FBgn0053017	500	500	494	6	2	3	494
FBgn0053051	474	457	462	29	3	9.666666666666666	445
FBgn0053052	469	467	453	18	6	3	451
FBgn0053056	531	500	483	79	9	8.777777777777779	452
FBgn0053060	460	457	450	13	2	6.5	447
FBgn0053061	392	392	324	68	6	11.333333333333334	324
FBgn0053080	521	500	498	44	9	4.888888888888889	477
FBgn0053093	519	500	508	30	6	5	489
FBgn0053100	503	500	491	15	4	3.75	488
FBgn0053107	500	500	499	1	1	1	499
FBgn0053108	500	500	497	3	3	1	497
FBgn0053109	517	500	488	46	12	3.8333333333333335	471
FBgn0053110	502	500	500	4	2	2	498
FBgn0053113	500	500	496	4	1	4	496
FBgn0053116	504	500	484	24	7	3.4285714285714284	480
FBgn0053120	518	500	490	46	10	4.6	472
FBgn0053121	529	500	517	41	8	5.125	488
FBgn0053124	503	500	494	12	4	3	491
FBgn0053125	500	500	473	27	2	13.5	473
FBgn0053126	500	500	456	44	4	11	456
FBgn0053128	500	499	486	15	7	2.142857142857143	485
FBgn0053129	514	500	513	15	3	5	499
FBgn0053136	511	500	476	46	9	5.111111111111111	465
FBgn0053137	512	500	399	125	5	25	387
FBgn0053138	502	500	502	2	1	2	500
FBgn0053143	508	500	506	10	3	3.3333333333333335	498
FBgn0053144	510	500	472	48	8	6	462
FBgn0053145	485	472	484	14	5	2.8	471
FBgn0053147	512	500	506	18	7	2.5714285714285716	494
FBgn0053156	506	500	504	8	3	2.6666666666666665	498
FBgn0053158	500	500	324	176	2	88	324
FBgn0053160	582	500	552	112	8	14	470
FBgn0053169	515	500	346	184	9	20.444444444444443	331
FBgn0053170	452	440	448	16	3	5.333333333333333	436
FBgn0053177	505	500	494	16	5	3.2	489
FBgn0053178	505	500	466	44	10	4.4	461
FBgn0053179	511	500	507	15	7	2.142857142857143	496
FBgn0053181	518	500	475	61	11	5.545454545454546	457
FBgn0053182	521	500	496	46	11	4.181818181818182	475
FBgn0053192	506	500	501	11	3	3.6666666666666665	495
FBgn0053193	513	500	510	16	5	3.2	497
FBgn0053196	500	500	500	0	0	NA	500
FBgn0053198	503	500	497	9	3	3	494
FBgn0053200	500	500	494	6	4	1.5	494
FBgn0053202	500	500	500	0	0	NA	500
FBgn0053203	509	500	508	10	2	5	499
FBgn0053207	502	500	500	4	2	2	498
FBgn0053208	539	500	509	69	15	4.6	470
FBgn0053223	508	500	480	36	6	6	472
FBgn0053225	500	500	423	77	6	12.833333333333334	423
FBgn0053233	514	500	474	54	4	13.5	460
FBgn0053236	545	500	535	55	7	7.857142857142857	490
FBgn0053257	500	500	483	17	4	4.25	483
FBgn0053258	512	500	505	19	3	6.333333333333333	493
FBgn0053260	502	500	496	8	4	2	494
FBgn0053262	506	500	479	33	8	4.125	473
FBgn0053263	411	410	389	23	4	5.75	388
FBgn0053267	541	500	523	59	10	5.9	482
FBgn0053270	554	500	542	66	8	8.25	488
FBgn0053271	540	500	517	63	8	7.875	477
FBgn0053272	504	500	449	59	4	14.75	445
FBgn0053276	369	368	158	212	2	106	157
FBgn0053281	502	500	494	10	3	3.3333333333333335	492
FBgn0053282	548	500	544	52	7	7.428571428571429	496
FBgn0053283	515	500	424	106	8	13.25	409
FBgn0053284	504	500	479	29	5	5.8	475
FBgn0053286	519	500	504	34	9	3.7777777777777777	485
FBgn0053288	506	500	502	10	2	5	496
FBgn0053290	511	500	507	15	4	3.75	496
FBgn0053294	510	500	161	359	5	71.8	151
FBgn0053296	406	406	197	209	3	69.66666666666667	197
FBgn0053299	500	500	494	6	1	6	494
FBgn0053300	500	500	498	2	2	1	498
FBgn0053301	565	500	524	106	9	11.777777777777779	459
FBgn0053303	517	500	514	20	4	5	497
FBgn0053306	514	500	505	23	5	4.6	491
FBgn0053307	512	500	465	59	3	19.666666666666668	453
FBgn0053309	504	500	504	4	1	4	500
FBgn0053315	552	500	552	52	2	26	500
FBgn0053325	514	500	507	21	3	7	493
FBgn0053329	516	500	497	35	6	5.833333333333333	481
FBgn0053333	518	500	508	28	6	4.666666666666667	490
FBgn0053339	501	500	498	4	2	2	497
FBgn0053341	502	500	502	2	1	2	500
FBgn0053346	554	500	531	77	8	9.625	477
FBgn0053453	534	500	524	44	8	5.5	490
FBgn0053454	510	500	468	52	5	10.4	458
FBgn0053458	518	500	494	42	8	5.25	476
FBgn0053465	546	500	474	118	10	11.8	428
FBgn0053467	500	500	156	344	2	172	156
FBgn0053468	458	436	447	33	5	6.6	425
FBgn0053505	504	500	502	6	3	2	498
FBgn0053508	520	500	403	137	6	22.833333333333332	383
FBgn0053509	393	393	365	28	4	7	365
FBgn0053510	387	381	357	36	4	9	351
FBgn0053511	399	394	397	7	4	1.75	392
FBgn0053512	501	500	483	19	2	9.5	482
FBgn0053513	500	500	493	7	3	2.3333333333333335	493
FBgn0053516	501	500	318	184	3	61.333333333333336	317
FBgn0053517	545	500	503	87	4	21.75	458
FBgn0053519	503	500	456	50	7	7.142857142857143	453
FBgn0053523	360	354	355	11	5	2.2	349
FBgn0053526	505	500	467	43	8	5.375	462
FBgn0053530	500	500	499	1	1	1	499
FBgn0053531	500	500	500	0	0	NA	500
FBgn0053534	539	500	534	44	5	8.8	495
FBgn0053536	548	500	499	97	13	7.461538461538462	451
FBgn0053542	508	500	502	14	6	2.3333333333333335	494
FBgn0053543	500	500	496	4	2	2	496
FBgn0053544	539	500	523	55	10	5.5	484
FBgn0053547	500	500	489	11	4	2.75	489
FBgn0053548	554	500	530	78	5	15.6	476
FBgn0053551	503	500	500	6	3	2	497
FBgn0053556	500	500	143	357	2	178.5	143
FBgn0053557	500	500	447	53	6	8.833333333333334	447
FBgn0053626	436	424	431	17	6	2.8333333333333335	419
FBgn0053629	500	500	464	36	4	9	464
FBgn0053632	581	500	574	88	8	11	493
FBgn0053635	506	500	500	12	5	2.4	494
FBgn0053639	506	500	486	26	7	3.7142857142857144	480
FBgn0053641	500	500	496	4	1	4	496
FBgn0053643	491	475	467	40	12	3.3333333333333335	451
FBgn0053644	426	422	401	29	6	4.833333333333333	397
FBgn0053648	501	500	393	109	5	21.8	392
FBgn0053653	516	500	485	47	8	5.875	469
FBgn0053654	511	500	511	11	2	5.5	500
FBgn0053658	508	500	497	19	8	2.375	489
FBgn0053673	523	500	515	31	3	10.333333333333334	492
FBgn0053679	549	500	534	64	6	10.666666666666666	485
FBgn0053687	510	500	465	55	9	6.111111111111111	455
FBgn0053696	511	500	511	11	2	5.5	500
FBgn0053700	500	500	485	15	2	7.5	485
FBgn0053704	512	500	485	39	5	7.8	473
FBgn0053721	512	500	509	15	3	5	497
FBgn0053723	500	500	480	20	3	6.666666666666667	480
FBgn0053725	501	500	463	39	6	6.5	462
FBgn0053757	512	500	485	39	8	4.875	473
FBgn0053764	507	500	441	73	6	12.166666666666666	434
FBgn0053766	506	500	480	32	5	6.4	474
FBgn0053772	500	500	499	1	1	1	499
FBgn0053773	514	500	503	25	4	6.25	489
FBgn0053774	528	500	507	49	10	4.9	479
FBgn0053775	543	500	516	70	13	5.384615384615385	473
FBgn0053777	513	500	496	30	6	5	483
FBgn0053783	500	500	107	393	1	393	107
FBgn0053784	346	337	201	154	3	51.333333333333336	192
FBgn0053792	505	500	501	9	3	3	496
FBgn0053795	537	500	484	90	12	7.5	447
FBgn0053796	557	500	493	121	9	13.444444444444445	436
FBgn0053912	526	500	524	28	5	5.6	498
FBgn0053914	534	500	256	312	5	62.4	222
FBgn0053922	513	500	458	68	7	9.714285714285714	445
FBgn0053923	507	500	448	66	9	7.333333333333333	441
FBgn0053927	515	500	484	46	8	5.75	469
FBgn0053928	451	447	413	42	6	7	409
FBgn0053929	500	500	165	335	3	111.66666666666667	165
FBgn0053958	541	500	509	73	9	8.11111111111111	468
FBgn0053965	470	470	462	8	1	8	462
FBgn0053969	513	500	505	21	6	3.5	492
FBgn0053977	396	396	392	4	1	4	392
FBgn0053983	500	500	494	6	3	2	494
FBgn0053986	512	500	507	17	4	4.25	495
FBgn0053988	500	500	497	3	3	1	497
FBgn0053993	512	500	498	26	4	6.5	486
FBgn0054003	357	357	355	2	1	2	355
FBgn0054005	502	500	493	11	4	2.75	491
FBgn0054007	535	500	504	66	6	11	469
FBgn0054008	505	500	492	18	5	3.6	487
FBgn0054012	510	500	506	14	2	7	496
FBgn0054015	514	500	433	95	4	23.75	419
FBgn0054024	511	500	477	45	2	22.5	466
FBgn0054025	512	500	512	12	2	6	500
FBgn0054026	504	500	476	32	5	6.4	472
FBgn0054027	337	337	334	3	1	3	334
FBgn0054028	514	500	454	74	10	7.4	440
FBgn0054029	508	500	444	72	5	14.4	436
FBgn0054033	507	500	501	13	4	3.25	494
FBgn0054034	516	500	482	50	4	12.5	466
FBgn0054038	523	500	522	24	4	6	499
FBgn0054040	501	500	492	10	4	2.5	491
FBgn0054043	501	500	484	18	6	3	483
FBgn0054045	509	500	503	15	4	3.75	494
FBgn0054046	501	500	492	10	2	5	491
FBgn0054047	501	500	496	6	3	2	495
FBgn0054049	502	500	489	15	6	2.5	487
FBgn0054051	408	408	392	16	3	5.333333333333333	392
FBgn0054052	511	500	491	31	8	3.875	480
FBgn0054054	517	500	492	42	6	7	475
FBgn0054056	509	500	500	18	4	4.5	491
FBgn0058002	502	500	336	168	7	24	334
FBgn0058005	516	500	389	143	8	17.875	373
FBgn0058006	524	500	520	28	4	7	496
FBgn0058100	514	500	475	53	5	10.6	461
FBgn0058160	500	500	67	433	2	216.5	67
FBgn0058172	503	500	496	10	4	2.5	493
FBgn0058263	517	500	284	250	6	41.666666666666664	267
FBgn0058470	502	500	446	58	5	11.6	444
FBgn0060296	509	500	470	48	6	8	461
FBgn0061188	505	500	462	48	3	16	457
FBgn0061197	509	500	479	39	6	6.5	470
FBgn0061198	508	500	471	45	9	5	463
FBgn0061200	529	500	464	94	10	9.4	435
FBgn0061356	443	431	443	12	1	12	431
FBgn0061435	503	500	502	4	2	2	499
FBgn0061469	505	500	505	5	1	5	500
FBgn0061476	510	500	507	13	3	4.333333333333333	497
FBgn0061492	528	500	524	32	10	3.2	496
FBgn0061515	507	500	482	32	7	4.571428571428571	475
FBgn0062411	500	500	494	6	1	6	494
FBgn0062413	500	500	499	1	1	1	499
FBgn0062440	505	500	493	17	4	4.25	488
FBgn0062442	500	500	499	1	1	1	499
FBgn0062449	520	500	501	39	5	7.8	481
FBgn0062517	507	500	499	15	3	5	492
FBgn0062961	597	500	591	103	14	7.357142857142857	494
FBgn0063083	517	500	515	19	2	9.5	498
FBgn0063127	500	500	498	2	1	2	498
FBgn0063298	511	500	500	22	2	11	489
FBgn0063449	541	500	531	51	5	10.2	490
FBgn0063491	511	500	422	100	6	16.666666666666668	411
FBgn0063494	507	500	462	52	7	7.428571428571429	455
FBgn0063495	501	500	397	105	6	17.5	396
FBgn0063496	521	498	492	52	6	8.666666666666666	469
FBgn0063497	533	500	481	85	8	10.625	448
FBgn0063649	500	500	494	6	3	2	494
FBgn0063667	381	366	376	20	3	6.666666666666667	361
FBgn0063670	514	500	469	59	6	9.833333333333334	455
FBgn0064237	501	500	492	10	5	2	491
FBgn0064766	501	500	499	3	2	1.5	498
FBgn0065032	500	500	117	383	2	191.5	117
FBgn0065046	500	500	319	181	4	45.25	319
FBgn0065081	500	500	494	6	3	2	494
FBgn0065098	504	500	484	24	5	4.8	480
FBgn0065099	523	500	468	78	7	11.142857142857142	445
FBgn0065104	501	500	499	3	3	1	498
FBgn0066084	500	500	499	1	1	1	499
FBgn0066101	517	500	513	21	3	7	496
FBgn0066365	500	500	495	5	2	2.5	495
FBgn0067052	518	500	493	43	3	14.333333333333334	475
FBgn0067102	537	500	524	50	9	5.555555555555555	487
FBgn0067311	532	500	519	45	7	6.428571428571429	487
FBgn0067312	527	500	458	96	9	10.666666666666666	431
FBgn0067317	500	500	487	13	4	3.25	487
FBgn0067407	502	500	483	21	4	5.25	481
FBgn0067905	502	500	427	77	7	11	425
FBgn0069354	501	500	478	24	5	4.8	477
FBgn0069913	516	500	490	42	7	6	474
FBgn0069969	514	500	475	53	10	5.3	461
FBgn0069973	511	500	449	73	10	7.3	438
FBgn0082585	533	500	533	33	4	8.25	500
FBgn0082598	500	500	87	413	1	413	87
FBgn0082831	506	500	491	21	6	3.5	485
FBgn0082922	506	500	489	23	6	3.8333333333333335	483
FBgn0083039	500	500	500	0	0	NA	500
FBgn0083068	517	500	457	77	7	11	440
FBgn0083120	549	500	521	77	11	7	472
FBgn0083123	511	500	508	14	4	3.5	497
FBgn0083124	543	500	489	97	12	8.083333333333334	446
FBgn0083141	544	500	418	170	7	24.285714285714285	374
FBgn0083167	539	500	539	39	2	19.5	500
FBgn0083228	508	500	508	8	2	4	500
FBgn0083938	502	500	479	25	5	5	477
FBgn0083940	500	500	482	18	2	9	482
FBgn0083941	527	500	523	31	7	4.428571428571429	496
FBgn0083943	500	500	500	0	0	NA	500
FBgn0083945	500	500	490	10	3	3.3333333333333335	490
FBgn0083946	515	500	497	33	7	4.714285714285714	482
FBgn0083949	506	500	483	29	4	7.25	477
FBgn0083950	500	500	435	65	5	13	435
FBgn0083951	524	500	464	84	9	9.333333333333334	440
FBgn0083952	500	500	500	0	0	NA	500
FBgn0083953	384	383	370	15	5	3	369
FBgn0083956	500	500	121	379	2	189.5	121
FBgn0083961	415	397	401	32	7	4.571428571428571	383
FBgn0083962	507	500	497	17	3	5.666666666666667	490
FBgn0083963	525	500	524	26	2	13	499
FBgn0083965	509	500	480	38	6	6.333333333333333	471
FBgn0083968	500	500	473	27	2	13.5	473
FBgn0083969	510	500	502	18	4	4.5	492
FBgn0083970	500	500	500	0	0	NA	500
FBgn0083972	521	500	476	66	6	11	455
FBgn0083974	512	500	505	19	3	6.333333333333333	493
FBgn0083975	501	500	480	22	3	7.333333333333333	479
FBgn0083978	510	500	504	16	4	4	494
FBgn0083979	509	500	455	63	6	10.5	446
FBgn0083981	522	500	471	73	4	18.25	449
FBgn0083983	501	500	493	9	4	2.25	492
FBgn0083986	524	500	520	28	6	4.666666666666667	496
FBgn0083987	500	500	497	3	3	1	497
FBgn0083990	500	500	494	6	1	6	494
FBgn0083991	504	500	470	38	5	7.6	466
FBgn0083992	505	500	482	28	4	7	477
FBgn0083994	515	500	406	124	6	20.666666666666668	391
FBgn0084001	544	500	483	105	10	10.5	439
FBgn0085188	513	500	495	31	7	4.428571428571429	482
FBgn0085190	505	500	501	9	3	3	496
FBgn0085191	513	500	513	13	2	6.5	500
FBgn0085192	511	500	503	19	5	3.8	492
FBgn0085194	529	500	520	38	4	9.5	491
FBgn0085195	507	500	478	36	8	4.5	471
FBgn0085198	506	500	451	61	6	10.166666666666666	445
FBgn0085199	500	500	500	0	0	NA	500
FBgn0085201	503	500	502	4	2	2	499
FBgn0085202	516	500	263	269	5	53.8	247
FBgn0085203	519	500	494	44	6	7.333333333333333	475
FBgn0085204	519	500	468	70	5	14	449
FBgn0085205	529	500	508	50	5	10	479
FBgn0085209	500	500	486	14	4	3.5	486
FBgn0085210	509	500	508	10	3	3.3333333333333335	499
FBgn0085212	500	500	485	15	2	7.5	485
FBgn0085217	503	500	501	5	2	2.5	498
FBgn0085218	500	500	498	2	1	2	498
FBgn0085220	500	500	497	3	1	3	497
FBgn0085222	513	500	497	29	4	7.25	484
FBgn0085224	501	500	489	13	4	3.25	488
FBgn0085225	512	500	499	25	5	5	487
FBgn0085228	536	500	530	42	6	7	494
FBgn0085230	562	500	554	70	6	11.666666666666666	492
FBgn0085231	462	462	454	8	1	8	454
FBgn0085232	500	500	476	24	2	12	476
FBgn0085233	520	500	510	30	6	5	490
FBgn0085234	507	500	507	7	1	7	500
FBgn0085235	506	500	503	9	2	4.5	497
FBgn0085237	500	500	483	17	4	4.25	483
FBgn0085239	531	500	530	32	3	10.666666666666666	499
FBgn0085240	503	500	469	37	5	7.4	466
FBgn0085241	504	500	489	19	3	6.333333333333333	485
FBgn0085242	505	500	493	17	6	2.8333333333333335	488
FBgn0085244	501	500	470	32	4	8	469
FBgn0085246	500	500	470	30	4	7.5	470
FBgn0085248	476	472	468	12	2	6	464
FBgn0085250	507	500	434	80	3	26.666666666666668	427
FBgn0085253	518	500	512	24	4	6	494
FBgn0085254	426	402	398	52	5	10.4	374
FBgn0085256	505	500	463	47	8	5.875	458
FBgn0085257	500	500	499	1	1	1	499
FBgn0085259	506	500	493	19	4	4.75	487
FBgn0085260	535	500	524	46	11	4.181818181818182	489
FBgn0085261	540	500	499	81	10	8.1	459
FBgn0085263	500	500	497	3	1	3	497
FBgn0085265	503	500	501	5	4	1.25	498
FBgn0085267	505	500	455	55	8	6.875	450
FBgn0085271	508	500	501	15	5	3	493
FBgn0085273	500	500	469	31	2	15.5	469
FBgn0085274	521	500	521	21	3	7	500
FBgn0085276	500	500	497	3	1	3	497
FBgn0085277	503	500	495	11	4	2.75	492
FBgn0085279	478	476	445	35	9	3.888888888888889	443
FBgn0085280	507	500	443	71	2	35.5	436
FBgn0085285	510	500	510	10	1	10	500
FBgn0085288	514	500	500	28	6	4.666666666666667	486
FBgn0085289	506	500	506	6	1	6	500
FBgn0085290	500	500	500	0	0	NA	500
FBgn0085292	500	500	493	7	2	3.5	493
FBgn0085294	504	500	496	12	7	1.7142857142857142	492
FBgn0085295	502	500	495	9	3	3	493
FBgn0085297	500	500	494	6	2	3	494
FBgn0085300	501	500	499	3	2	1.5	498
FBgn0085302	500	500	496	4	2	2	496
FBgn0085303	523	500	512	34	4	8.5	489
FBgn0085307	531	500	510	52	6	8.666666666666666	479
FBgn0085309	502	500	236	268	4	67	234
FBgn0085310	521	500	508	34	5	6.8	487
FBgn0085311	507	500	504	10	5	2	497
FBgn0085313	501	500	494	8	5	1.6	493
FBgn0085314	500	500	499	1	1	1	499
FBgn0085315	510	500	509	11	3	3.6666666666666665	499
FBgn0085316	503	500	503	3	1	3	500
FBgn0085317	502	500	498	6	4	1.5	496
FBgn0085318	501	500	486	16	2	8	485
FBgn0085319	501	500	492	10	5	2	491
FBgn0085320	505	500	505	5	2	2.5	500
FBgn0085321	500	500	491	9	3	3	491
FBgn0085322	508	500	507	9	3	3	499
FBgn0085324	502	500	478	26	4	6.5	476
FBgn0085326	506	500	493	19	6	3.1666666666666665	487
FBgn0085328	501	500	495	7	3	2.3333333333333335	494
FBgn0085329	541	500	520	62	6	10.333333333333334	479
FBgn0085330	500	500	493	7	2	3.5	493
FBgn0085332	500	500	236	264	4	66	236
FBgn0085334	525	500	449	101	8	12.625	424
FBgn0085336	500	500	500	0	0	NA	500
FBgn0085340	500	500	333	167	3	55.666666666666664	333
FBgn0085349	500	500	478	22	4	5.5	478
FBgn0085351	500	500	486	14	3	4.666666666666667	486
FBgn0085353	507	500	495	19	7	2.7142857142857144	488
FBgn0085354	522	500	497	47	6	7.833333333333333	475
FBgn0085356	507	500	504	10	7	1.4285714285714286	497
FBgn0085358	543	500	360	226	7	32.285714285714285	317
FBgn0085359	557	500	542	72	8	9	485
FBgn0085360	534	500	467	101	10	10.1	433
FBgn0085362	509	500	505	13	5	2.6	496
FBgn0085366	508	500	476	40	6	6.666666666666667	468
FBgn0085367	500	500	485	15	4	3.75	485
FBgn0085369	500	500	500	0	0	NA	500
FBgn0085370	511	500	496	26	4	6.5	485
FBgn0085371	504	500	496	12	5	2.4	492
FBgn0085374	518	500	488	48	5	9.6	470
FBgn0085376	500	500	494	6	3	2	494
FBgn0085377	502	500	495	9	3	3	493
FBgn0085380	502	500	488	16	5	3.2	486
FBgn0085382	516	500	510	22	6	3.6666666666666665	494
FBgn0085383	515	500	513	17	2	8.5	498
FBgn0085384	505	500	494	16	2	8	489
FBgn0085385	501	500	484	18	5	3.6	483
FBgn0085386	531	500	529	33	3	11	498
FBgn0085387	500	500	493	7	1	7	493
FBgn0085390	516	500	511	21	6	3.5	495
FBgn0085391	508	500	502	14	4	3.5	494
FBgn0085395	500	500	496	4	2	2	496
FBgn0085396	509	500	505	13	6	2.1666666666666665	496
FBgn0085397	500	500	491	9	2	4.5	491
FBgn0085398	500	500	462	38	3	12.666666666666666	462
FBgn0085399	506	500	411	101	5	20.2	405
FBgn0085400	506	500	504	8	3	2.6666666666666665	498
FBgn0085404	512	500	508	16	3	5.333333333333333	496
FBgn0085405	512	500	511	13	4	3.25	499
FBgn0085407	513	500	506	20	7	2.857142857142857	493
FBgn0085409	500	500	499	1	1	1	499
FBgn0085410	511	500	492	30	4	7.5	481
FBgn0085411	512	500	484	40	5	8	472
FBgn0085412	502	500	499	5	4	1.25	497
FBgn0085414	501	500	490	12	2	6	489
FBgn0085415	500	500	407	93	4	23.25	407
FBgn0085417	525	500	510	40	6	6.666666666666667	485
FBgn0085419	505	500	497	13	3	4.333333333333333	492
FBgn0085420	500	500	498	2	2	1	498
FBgn0085421	514	500	494	34	5	6.8	480
FBgn0085422	519	500	516	22	4	5.5	497
FBgn0085424	504	500	501	7	4	1.75	497
FBgn0085425	506	500	503	9	4	2.25	497
FBgn0085426	501	500	468	34	11	3.090909090909091	467
FBgn0085427	501	500	490	12	3	4	489
FBgn0085428	501	500	488	14	3	4.666666666666667	487
FBgn0085430	500	500	497	3	1	3	497
FBgn0085431	500	500	500	0	0	NA	500
FBgn0085432	503	500	458	48	7	6.857142857142857	455
FBgn0085434	520	500	520	20	3	6.666666666666667	500
FBgn0085436	525	500	511	39	7	5.571428571428571	486
FBgn0085437	520	500	501	39	5	7.8	481
FBgn0085440	504	500	464	44	9	4.888888888888889	460
FBgn0085443	518	500	513	23	4	5.75	495
FBgn0085444	505	500	501	9	3	3	496
FBgn0085446	515	500	511	19	5	3.8	496
FBgn0085447	500	500	496	4	3	1.3333333333333333	496
FBgn0085450	541	500	524	58	6	9.666666666666666	483
FBgn0085455	500	500	492	8	2	4	492
FBgn0085456	500	500	483	17	3	5.666666666666667	483
FBgn0085457	506	500	503	9	3	3	497
FBgn0085458	359	358	359	1	1	1	358
FBgn0085459	500	500	288	212	4	53	288
FBgn0085461	508	500	487	29	10	2.9	479
FBgn0085465	520	500	515	25	4	6.25	495
FBgn0085468	541	500	537	45	4	11.25	496
FBgn0085474	554	500	487	121	7	17.285714285714285	433
FBgn0085476	525	500	516	34	5	6.8	491
FBgn0085477	552	500	430	174	9	19.333333333333332	378
FBgn0085478	501	500	497	5	3	1.6666666666666667	496
FBgn0085480	543	500	535	51	4	12.75	492
FBgn0085481	511	500	509	13	3	4.333333333333333	498
FBgn0085482	502	500	175	329	5	65.8	173
FBgn0085484	532	500	492	72	7	10.285714285714286	460
FBgn0085485	389	386	375	17	7	2.4285714285714284	372
FBgn0085486	501	500	499	3	2	1.5	498
FBgn0085487	451	449	436	17	6	2.8333333333333335	434
FBgn0085488	514	500	474	54	10	5.4	460
FBgn0085491	501	500	498	4	4	1	497
FBgn0085612	506	500	258	254	10	25.4	252
FBgn0086074	514	500	507	21	5	4.2	493
FBgn0086129	508	500	499	17	4	4.25	491
FBgn0086200	503	500	498	8	3	2.6666666666666665	495
FBgn0086253	501	500	491	11	3	3.6666666666666665	490
FBgn0086254	344	344	340	4	2	2	340
FBgn0086265	546	500	538	54	7	7.714285714285714	492
FBgn0086266	502	500	495	9	2	4.5	493
FBgn0086346	505	500	484	26	4	6.5	479
FBgn0086347	500	500	496	4	2	2	496
FBgn0086348	345	342	305	43	4	10.75	302
FBgn0086350	500	500	475	25	3	8.333333333333334	475
FBgn0086355	519	500	509	29	5	5.8	490
FBgn0086356	502	500	485	19	5	3.8	483
FBgn0086358	507	500	499	15	8	1.875	492
FBgn0086362	503	500	484	22	6	3.6666666666666665	481
FBgn0086365	509	500	507	11	4	2.75	498
FBgn0086367	521	500	503	39	7	5.571428571428571	482
FBgn0086368	511	500	463	59	6	9.833333333333334	452
FBgn0086370	501	500	495	7	5	1.4	494
FBgn0086371	513	500	499	27	7	3.857142857142857	486
FBgn0086372	516	500	511	21	5	4.2	495
FBgn0086384	511	500	392	130	7	18.571428571428573	381
FBgn0086408	503	500	499	7	3	2.3333333333333335	496
FBgn0086442	512	500	509	15	5	3	497
FBgn0086443	534	500	519	49	7	7	485
FBgn0086444	512	500	505	19	5	3.8	493
FBgn0086445	512	500	502	22	6	3.6666666666666665	490
FBgn0086446	538	500	525	51	7	7.285714285714286	487
FBgn0086447	508	500	486	30	7	4.285714285714286	478
FBgn0086448	505	500	470	40	5	8	465
FBgn0086450	528	500	460	96	14	6.857142857142857	432
FBgn0086451	501	484	488	30	7	4.285714285714286	471
FBgn0086472	529	500	529	29	1	29	500
FBgn0086519	491	490	491	1	1	1	490
FBgn0086532	500	500	439	61	6	10.166666666666666	439
FBgn0086558	504	500	438	70	8	8.75	434
FBgn0086604	501	500	499	3	3	1	498
FBgn0086608	578	500	484	172	8	21.5	406
FBgn0086610	516	500	466	66	5	13.2	450
FBgn0086611	431	429	427	6	3	2	425
FBgn0086655	529	500	529	29	3	9.666666666666666	500
FBgn0086656	504	500	501	7	2	3.5	497
FBgn0086657	516	500	508	24	4	6	492
FBgn0086659	504	500	475	33	9	3.6666666666666665	471
FBgn0086673	515	500	510	20	6	3.3333333333333335	495
FBgn0086675	503	500	406	100	8	12.5	403
FBgn0086676	410	403	393	24	8	3	386
FBgn0086677	502	500	501	3	2	1.5	499
FBgn0086679	500	500	490	10	3	3.3333333333333335	490
FBgn0086680	501	500	499	3	2	1.5	498
FBgn0086681	502	500	462	42	5	8.4	460
FBgn0086683	523	500	466	80	10	8	443
FBgn0086687	514	500	484	44	7	6.285714285714286	470
FBgn0086690	502	500	412	92	10	9.2	410
FBgn0086691	500	500	496	4	3	1.3333333333333333	496
FBgn0086693	517	500	512	22	4	5.5	495
FBgn0086694	371	371	361	10	2	5	361
FBgn0086695	500	500	432	68	2	34	432
FBgn0086698	529	500	509	49	6	8.166666666666666	480
FBgn0086704	509	500	484	34	8	4.25	475
FBgn0086707	552	500	529	75	10	7.5	477
FBgn0086708	504	500	499	9	4	2.25	495
FBgn0086710	500	500	474	26	2	13	474
FBgn0086711	505	500	469	41	7	5.857142857142857	464
FBgn0086712	513	500	496	30	5	6	483
FBgn0086757	502	500	500	4	3	1.3333333333333333	498
FBgn0086758	502	500	483	21	4	5.25	481
FBgn0086778	532	500	463	101	9	11.222222222222221	431
FBgn0086782	505	500	449	61	5	12.2	444
FBgn0086784	510	500	508	12	3	4	498
FBgn0086785	504	500	485	23	5	4.6	481
FBgn0086855	515	500	511	19	2	9.5	496
FBgn0086856	500	500	478	22	5	4.4	478
FBgn0086895	500	500	499	1	1	1	499
FBgn0086898	500	500	500	0	0	NA	500
FBgn0086904	504	500	503	5	3	1.6666666666666667	499
FBgn0086906	510	500	509	11	2	5.5	499
FBgn0086907	502	500	502	2	2	1	500
FBgn0086909	511	500	501	21	6	3.5	490
FBgn0086912	528	500	517	39	9	4.333333333333333	489
FBgn0086913	504	500	478	30	8	3.75	474
FBgn0086916	501	500	489	13	8	1.625	488
FBgn0087002	512	500	505	19	6	3.1666666666666665	493
FBgn0087005	504	500	494	14	5	2.8	490
FBgn0087007	505	500	504	6	4	1.5	499
FBgn0087008	516	500	431	101	10	10.1	415
FBgn0087013	500	500	47	453	2	226.5	47
FBgn0087021	500	500	491	9	3	3	491
FBgn0087039	505	500	372	138	2	69	367
FBgn0087040	461	457	440	25	4	6.25	436
FBgn0243511	576	500	543	109	9	12.11111111111111	467
FBgn0243512	489	486	453	39	6	6.5	450
FBgn0243513	504	500	504	4	1	4	500
FBgn0243514	514	500	482	46	7	6.571428571428571	468
FBgn0243516	502	500	498	6	4	1.5	496
FBgn0243586	505	500	504	6	2	3	499
FBgn0250732	534	500	534	34	2	17	500
FBgn0250746	558	500	476	140	12	11.666666666666666	418
FBgn0250753	512	500	506	18	8	2.25	494
FBgn0250754	514	500	472	56	8	7	458
FBgn0250755	526	500	524	28	3	9.333333333333334	498
FBgn0250757	501	500	501	1	1	1	500
FBgn0250785	541	500	504	78	4	19.5	463
FBgn0250786	519	500	515	23	6	3.8333333333333335	496
FBgn0250788	525	500	508	42	9	4.666666666666667	483
FBgn0250791	526	500	520	32	8	4	494
FBgn0250815	500	500	500	0	0	NA	500
FBgn0250816	504	500	152	356	4	89	148
FBgn0250817	523	500	501	45	9	5	478
FBgn0250819	529	500	484	74	10	7.4	455
FBgn0250820	422	419	401	24	4	6	398
FBgn0250822	510	500	509	11	2	5.5	499
FBgn0250823	533	500	532	34	2	17	499
FBgn0250825	524	500	491	57	11	5.181818181818182	467
FBgn0250827	504	500	454	54	6	9	450
FBgn0250831	520	500	517	23	4	5.75	497
FBgn0250832	500	500	227	273	3	91	227
FBgn0250833	501	500	496	6	3	2	495
FBgn0250834	529	500	521	37	4	9.25	492
FBgn0250835	500	500	497	3	1	3	497
FBgn0250836	512	500	483	41	5	8.2	471
FBgn0250837	500	500	295	205	1	205	295
FBgn0250838	509	500	496	22	4	5.5	487
FBgn0250839	531	500	459	103	8	12.875	428
FBgn0250841	500	500	481	19	4	4.75	481
FBgn0250842	376	342	374	36	6	6	340
FBgn0250843	505	500	505	5	1	5	500
FBgn0250844	516	500	510	22	3	7.333333333333333	494
FBgn0250845	505	500	476	34	2	17	471
FBgn0250846	510	500	425	95	4	23.75	415
FBgn0250847	521	500	506	36	6	6	485
FBgn0250848	528	500	492	64	7	9.142857142857142	464
FBgn0250850	501	500	495	7	3	2.3333333333333335	494
FBgn0250862	517	500	429	105	10	10.5	412
FBgn0250868	501	500	499	3	2	1.5	498
FBgn0250869	503	500	503	3	2	1.5	500
FBgn0250871	540	500	519	61	7	8.714285714285714	479
FBgn0250874	576	500	572	80	4	20	496
FBgn0250906	500	500	498	2	1	2	498
FBgn0250908	500	500	485	15	3	5	485
FBgn0250910	513	500	511	15	3	5	498
FBgn0259098	501	500	486	16	7	2.2857142857142856	485
FBgn0259099	520	500	505	35	6	5.833333333333333	485
FBgn0259108	500	500	486	14	1	14	486
FBgn0259110	531	500	520	42	9	4.666666666666667	489
FBgn0259111	502	500	490	14	6	2.3333333333333335	488
FBgn0259112	500	500	500	0	0	NA	500
FBgn0259113	509	500	378	140	6	23.333333333333332	369
FBgn0259139	510	500	461	59	6	9.833333333333334	451
FBgn0259143	508	500	495	21	5	4.2	487
FBgn0259145	501	500	493	9	3	3	492
FBgn0259146	502	500	500	4	3	1.3333333333333333	498
FBgn0259148	506	500	494	18	4	4.5	488
FBgn0259149	512	500	464	60	8	7.5	452
FBgn0259150	500	500	481	19	2	9.5	481
FBgn0259162	500	500	484	16	3	5.333333333333333	484
FBgn0259163	522	500	507	37	6	6.166666666666667	485
FBgn0259164	500	500	479	21	1	21	479
FBgn0259166	536	500	512	60	11	5.454545454545454	476
FBgn0259167	519	500	500	38	5	7.6	481
FBgn0259173	500	500	442	58	5	11.6	442
FBgn0259174	500	500	484	16	2	8	484
FBgn0259175	506	500	469	43	5	8.6	463
FBgn0259176	505	500	477	33	8	4.125	472
FBgn0259178	521	500	517	25	5	5	496
FBgn0259183	505	500	470	40	7	5.714285714285714	465
FBgn0259185	534	500	522	46	11	4.181818181818182	488
FBgn0259186	365	365	365	0	0	NA	365
FBgn0259188	537	500	536	38	6	6.333333333333333	499
FBgn0259189	378	376	303	77	5	15.4	301
FBgn0259190	524	500	484	64	8	8	460
FBgn0259192	414	414	413	1	1	1	413
FBgn0259193	538	500	463	113	9	12.555555555555555	425
FBgn0259194	369	369	317	52	3	17.333333333333332	317
FBgn0259209	514	500	489	39	4	9.75	475
FBgn0259210	500	500	459	41	2	20.5	459
FBgn0259211	512	500	510	14	3	4.666666666666667	498
FBgn0259213	508	500	493	23	5	4.6	485
FBgn0259214	518	500	421	115	5	23	403
FBgn0259215	500	500	498	2	2	1	498
FBgn0259216	506	500	392	120	7	17.142857142857142	386
FBgn0259219	523	500	447	99	5	19.8	424
FBgn0259221	561	500	544	78	6	13	483
FBgn0259222	514	500	506	22	3	7.333333333333333	492
FBgn0259223	520	500	494	46	6	7.666666666666667	474
FBgn0259224	518	500	516	20	5	4	498
FBgn0259226	512	500	500	24	4	6	488
FBgn0259227	513	500	508	18	5	3.6	495
FBgn0259228	511	500	511	11	2	5.5	500
FBgn0259229	518	500	517	19	2	9.5	499
FBgn0259230	500	500	489	11	3	3.6666666666666665	489
FBgn0259231	507	500	278	236	5	47.2	271
FBgn0259233	522	500	412	132	5	26.4	390
FBgn0259236	506	500	500	12	2	6	494
FBgn0259237	502	500	481	23	7	3.2857142857142856	479
FBgn0259239	500	500	470	30	2	15	470
FBgn0259241	502	500	499	5	2	2.5	497
FBgn0259242	500	500	498	2	2	1	498
FBgn0259243	503	500	503	3	3	1	500
FBgn0259244	501	500	396	106	4	26.5	395
FBgn0259245	508	500	492	24	4	6	484
FBgn0259246	522	500	514	30	6	5	492
FBgn0259481	502	500	501	3	3	1	499
FBgn0259482	372	372	371	1	1	1	371
FBgn0259483	506	500	505	7	2	3.5	499
FBgn0259676	462	454	448	22	7	3.142857142857143	440
FBgn0259677	504	500	486	22	6	3.6666666666666665	482
FBgn0259678	500	500	493	7	3	2.3333333333333335	493
FBgn0259682	500	500	259	241	1	241	259
FBgn0259683	526	500	506	46	6	7.666666666666667	480
FBgn0259685	520	500	508	32	7	4.571428571428571	488
FBgn0259701	513	500	513	13	3	4.333333333333333	500
FBgn0259702	517	500	495	39	5	7.8	478
FBgn0259710	516	500	496	36	7	5.142857142857143	480
FBgn0259712	509	500	506	12	2	6	497
FBgn0259713	500	500	497	3	2	1.5	497
FBgn0259714	500	500	470	30	4	7.5	470
FBgn0259722	515	500	513	17	5	3.4	498
FBgn0259728	505	500	478	32	6	5.333333333333333	473
FBgn0259734	564	500	562	66	8	8.25	498
FBgn0259735	541	500	531	51	4	12.75	490
FBgn0259736	516	500	510	22	3	7.333333333333333	494
FBgn0259740	501	500	488	14	6	2.3333333333333335	487
FBgn0259742	504	500	497	11	3	3.6666666666666665	493
FBgn0259745	519	500	477	61	12	5.083333333333333	458
FBgn0259748	508	500	504	12	5	2.4	496
FBgn0259785	502	500	493	11	2	5.5	491
FBgn0259789	526	500	488	64	10	6.4	462
FBgn0259791	514	500	514	14	2	7	500
FBgn0259794	509	500	452	66	8	8.25	443
FBgn0259795	521	500	479	63	10	6.3	458
FBgn0259818	383	376	358	32	2	16	351
FBgn0259821	500	500	359	141	5	28.2	359
FBgn0259823	519	500	491	47	7	6.714285714285714	472
FBgn0259831	501	500	488	14	3	4.666666666666667	487
FBgn0259832	528	500	524	32	4	8	496
FBgn0259876	534	500	485	83	8	10.375	451
FBgn0259878	513	500	509	17	6	2.8333333333333335	496
FBgn0259896	507	500	498	16	6	2.6666666666666665	491
FBgn0259916	501	500	463	39	5	7.8	462
FBgn0259917	400	387	389	24	3	8	376
FBgn0259922	501	500	494	8	4	2	493
FBgn0259926	502	500	485	19	4	4.75	483
FBgn0259935	511	500	505	17	4	4.25	494
FBgn0259936	509	500	499	19	6	3.1666666666666665	490
FBgn0259937	509	500	499	19	3	6.333333333333333	490
FBgn0259938	511	500	507	15	4	3.75	496
FBgn0259949	353	353	80	273	2	136.5	80
FBgn0259950	500	500	159	341	2	170.5	159
FBgn0259952	400	384	376	40	7	5.714285714285714	360
FBgn0259954	500	500	496	4	1	4	496
FBgn0259955	385	375	357	38	7	5.428571428571429	347
FBgn0259958	502	500	484	20	6	3.3333333333333335	482
FBgn0259959	528	500	523	33	7	4.714285714285714	495
FBgn0259962	501	500	482	20	3	6.666666666666667	481
FBgn0259964	517	500	438	96	5	19.2	421
FBgn0259966	520	500	491	49	6	8.166666666666666	471
FBgn0259967	514	500	487	41	5	8.2	473
FBgn0259969	509	500	500	18	4	4.5	491
FBgn0259970	500	500	497	3	2	1.5	497
FBgn0259971	510	500	177	343	5	68.6	167
FBgn0259972	500	500	490	10	2	5	490
FBgn0259973	506	500	491	21	3	7	485
FBgn0259974	510	500	497	23	5	4.6	487
FBgn0259977	502	500	502	2	2	1	500
FBgn0259978	500	500	119	381	3	127	119
FBgn0259982	502	500	489	15	5	3	487
FBgn0259985	536	500	532	40	2	20	496
FBgn0259986	515	500	506	24	5	4.8	491
FBgn0259992	505	500	496	14	5	2.8	491
FBgn0259994	518	500	504	32	7	4.571428571428571	486
FBgn0259996	504	500	481	27	6	4.5	477
FBgn0259998	524	500	487	61	8	7.625	463
FBgn0260000	500	500	498	2	1	2	498
FBgn0260003	522	500	497	47	3	15.666666666666666	475
FBgn0260004	536	500	490	82	5	16.4	454
FBgn0260005	503	500	484	22	3	7.333333333333333	481
FBgn0260006	501	500	436	66	5	13.2	435
FBgn0260008	502	500	143	361	3	120.33333333333333	141
FBgn0260012	536	500	532	40	2	20	496
FBgn0260027	522	500	512	32	7	4.571428571428571	490
FBgn0260049	500	500	244	256	1	256	244
FBgn0260243	501	500	498	4	3	1.3333333333333333	497
FBgn0260392	501	500	501	1	1	1	500
FBgn0260393	500	500	481	19	2	9.5	481
FBgn0260396	522	500	504	40	7	5.714285714285714	482
FBgn0260397	529	500	505	53	7	7.571428571428571	476
FBgn0260399	506	500	471	41	5	8.2	465
FBgn0260407	500	500	497	3	3	1	497
FBgn0260428	500	500	497	3	1	3	497
FBgn0260429	510	500	505	15	3	5	495
FBgn0260430	500	500	473	27	2	13.5	473
FBgn0260431	560	500	427	193	8	24.125	367
FBgn0260436	520	500	505	35	6	5.833333333333333	485
FBgn0260437	507	500	125	389	5	77.8	118
FBgn0260439	405	398	388	24	4	6	381
FBgn0260442	501	500	500	2	2	1	499
FBgn0260444	531	500	510	52	11	4.7272727272727275	479
FBgn0260446	511	500	501	21	6	3.5	490
FBgn0260447	467	450	160	324	3	108	143
FBgn0260462	553	500	430	176	10	17.6	377
FBgn0260474	506	500	503	9	4	2.25	497
FBgn0260477	505	500	199	311	4	77.75	194
FBgn0260482	504	500	482	26	8	3.25	478
FBgn0260486	501	500	482	20	6	3.3333333333333335	481
FBgn0260487	500	500	497	3	2	1.5	497
FBgn0260499	514	500	511	17	5	3.4	497
FBgn0260632	500	500	458	42	4	10.5	458
FBgn0260639	516	500	501	31	5	6.2	485
FBgn0260642	500	500	494	6	1	6	494
FBgn0260643	516	500	515	17	3	5.666666666666667	499
FBgn0260645	516	500	514	18	3	6	498
FBgn0260646	385	384	337	49	5	9.8	336
FBgn0260648	511	500	502	20	8	2.5	491
FBgn0260653	520	500	510	30	3	10	490
FBgn0260655	509	500	476	42	7	6	467
FBgn0260657	504	500	504	4	2	2	500
FBgn0260658	518	500	510	26	4	6.5	492
FBgn0260659	513	500	503	23	4	5.75	490
FBgn0260660	512	500	487	37	5	7.4	475
FBgn0260713	501	500	485	17	4	4.25	484
FBgn0260719	504	500	276	232	7	33.142857142857146	272
FBgn0260720	502	500	498	6	3	2	496
FBgn0260742	505	500	503	7	2	3.5	498
FBgn0260743	532	500	532	32	6	5.333333333333333	500
FBgn0260744	417	403	411	20	2	10	397
FBgn0260745	502	500	477	27	4	6.75	475
FBgn0260746	502	500	453	51	8	6.375	451
FBgn0260747	502	500	292	212	6	35.333333333333336	290
FBgn0260748	500	500	119	381	3	127	119
FBgn0260753	533	500	327	239	7	34.142857142857146	294
FBgn0260766	524	500	509	39	8	4.875	485
FBgn0260768	500	500	421	79	6	13.166666666666666	421
FBgn0260771	516	500	506	26	7	3.7142857142857144	490
FBgn0260777	509	500	496	22	4	5.5	487
FBgn0260779	500	500	498	2	2	1	498
FBgn0260789	515	500	509	21	4	5.25	494
FBgn0260795	507	500	503	11	6	1.8333333333333333	496
FBgn0260817	501	500	498	4	2	2	497
FBgn0260855	514	500	472	56	9	6.222222222222222	458
FBgn0260856	501	500	495	7	4	1.75	494
FBgn0260857	504	498	146	364	4	91	140
FBgn0260858	500	500	496	4	3	1.3333333333333333	496
FBgn0260860	482	482	479	3	1	3	479
FBgn0260861	501	500	484	18	4	4.5	483
FBgn0260862	363	363	340	23	3	7.666666666666667	340
FBgn0260866	544	500	528	60	7	8.571428571428571	484
FBgn0260873	504	500	389	119	6	19.833333333333332	385
FBgn0260874	532	500	517	47	8	5.875	485
FBgn0260932	529	500	527	31	6	5.166666666666667	498
FBgn0260933	485	483	479	8	4	2	477
FBgn0260935	515	500	500	30	6	5	485
FBgn0260938	500	500	498	2	1	2	498
FBgn0260940	513	500	498	28	8	3.5	485
FBgn0260942	503	500	498	8	4	2	495
FBgn0260943	506	500	465	47	3	15.666666666666666	459
FBgn0260944	502	500	486	18	5	3.6	484
FBgn0260955	501	500	493	9	4	2.25	492
FBgn0260959	507	500	443	71	9	7.888888888888889	436
FBgn0260960	515	500	493	37	6	6.166666666666667	478
FBgn0260962	502	500	349	155	6	25.833333333333332	347
FBgn0260964	515	500	493	37	9	4.111111111111111	478
FBgn0260965	510	500	486	34	6	5.666666666666667	476
FBgn0260968	500	500	495	5	2	2.5	495
FBgn0260969	513	500	503	23	6	3.8333333333333335	490
FBgn0260971	503	500	489	17	5	3.4	486
FBgn0260972	522	500	522	22	5	4.4	500
FBgn0260985	503	500	495	11	4	2.75	492
FBgn0260986	501	500	498	4	3	1.3333333333333333	497
FBgn0260987	505	500	209	301	5	60.2	204
FBgn0260991	500	500	499	1	1	1	499
FBgn0260997	501	500	188	314	5	62.8	187
FBgn0261004	523	500	382	164	6	27.333333333333332	359
FBgn0261020	509	500	476	42	9	4.666666666666667	467
FBgn0261041	507	500	453	61	7	8.714285714285714	446
FBgn0261046	501	500	492	10	2	5	491
FBgn0261049	510	500	508	12	4	3	498
FBgn0261053	500	500	482	18	3	6	482
FBgn0261054	520	500	499	41	8	5.125	479
FBgn0261055	509	500	487	31	5	6.2	478
FBgn0261057	438	429	251	196	5	39.2	242
FBgn0261059	512	500	502	22	3	7.333333333333333	490
FBgn0261061	517	500	497	37	5	7.4	480
FBgn0261064	511	500	484	38	6	6.333333333333333	473
FBgn0261065	524	500	510	38	5	7.6	486
FBgn0261067	501	500	320	182	4	45.5	319
FBgn0261068	526	500	515	37	7	5.285714285714286	489
FBgn0261085	517	500	513	21	5	4.2	496
FBgn0261086	522	500	515	29	7	4.142857142857143	493
FBgn0261089	501	500	498	4	2	2	497
FBgn0261090	501	500	490	12	2	6	489
FBgn0261108	512	500	485	39	5	7.8	473
FBgn0261109	507	500	507	7	3	2.3333333333333335	500
FBgn0261111	530	500	520	40	3	13.333333333333334	490
FBgn0261113	552	500	532	72	8	9	480
FBgn0261119	514	500	492	36	7	5.142857142857143	478
FBgn0261238	528	500	507	49	5	9.8	479
FBgn0261239	501	500	496	6	5	1.2	495
FBgn0261243	500	500	366	134	3	44.666666666666664	366
FBgn0261244	532	500	519	45	6	7.5	487
FBgn0261245	528	500	517	39	4	9.75	489
FBgn0261258	578	500	558	98	10	9.8	480
FBgn0261260	506	500	440	72	6	12	434
FBgn0261261	535	500	508	62	9	6.888888888888889	473
FBgn0261262	543	500	475	111	13	8.538461538461538	432
FBgn0261266	501	500	501	1	1	1	500
FBgn0261268	512	500	462	62	10	6.2	450
FBgn0261269	501	500	501	1	1	1	500
FBgn0261270	512	500	512	12	2	6	500
FBgn0261274	556	500	527	85	16	5.3125	471
FBgn0261276	519	500	511	27	7	3.857142857142857	492
FBgn0261283	506	500	495	17	7	2.4285714285714284	489
FBgn0261284	517	500	502	32	5	6.4	485
FBgn0261285	516	500	467	65	6	10.833333333333334	451
FBgn0261286	510	500	505	15	6	2.5	495
FBgn0261289	554	500	554	54	5	10.8	500
FBgn0261290	539	500	530	48	6	8	491
FBgn0261291	500	500	486	14	3	4.666666666666667	486
FBgn0261292	517	500	504	30	8	3.75	487
FBgn0261293	501	500	486	16	3	5.333333333333333	485
FBgn0261294	514	500	494	34	7	4.857142857142857	480
FBgn0261341	510	500	509	11	3	3.6666666666666665	499
FBgn0261356	386	341	381	50	6	8.333333333333334	336
FBgn0261363	541	500	509	73	10	7.3	468
FBgn0261373	500	500	498	2	1	2	498
FBgn0261380	502	500	473	31	7	4.428571428571429	471
FBgn0261383	501	500	475	27	4	6.75	474
FBgn0261385	515	500	514	16	5	3.2	499
FBgn0261393	395	361	346	83	9	9.222222222222221	312
FBgn0261394	503	500	276	230	8	28.75	273
FBgn0261395	533	500	523	43	9	4.777777777777778	490
FBgn0261397	506	500	502	10	4	2.5	496
FBgn0261401	501	500	501	1	1	1	500
FBgn0261429	501	500	482	20	7	2.857142857142857	481
FBgn0261434	509	500	509	9	3	3	500
FBgn0261436	517	500	450	84	9	9.333333333333334	433
FBgn0261437	501	500	500	2	2	1	499
FBgn0261439	390	390	388	2	1	2	388
FBgn0261445	526	500	404	148	6	24.666666666666668	378
FBgn0261446	521	500	496	46	6	7.666666666666667	475
FBgn0261456	513	500	449	77	8	9.625	436
FBgn0261461	521	500	515	27	6	4.5	494
FBgn0261479	500	500	500	0	0	NA	500
FBgn0261501	500	500	485	15	1	15	485
FBgn0261502	500	500	294	206	1	206	294
FBgn0261503	508	500	405	111	4	27.75	397
FBgn0261506	506	500	474	38	6	6.333333333333333	468
FBgn0261509	518	500	507	29	6	4.833333333333333	489
FBgn0261514	500	500	495	5	1	5	495
FBgn0261522	500	500	488	12	4	3	488
FBgn0261523	512	500	470	54	2	27	458
FBgn0261526	503	500	500	6	3	2	497
FBgn0261529	508	500	490	26	4	6.5	482
FBgn0261530	513	500	471	55	5	11	458
FBgn0261531	383	358	361	47	9	5.222222222222222	336
FBgn0261534	508	500	504	12	5	2.4	496
FBgn0261535	382	382	382	0	0	NA	382
FBgn0261545	549	500	544	54	6	9	495
FBgn0261547	505	500	463	47	6	7.833333333333333	458
FBgn0261549	527	500	431	123	8	15.375	404
FBgn0261552	504	500	470	38	2	19	466
FBgn0261553	504	500	455	53	4	13.25	451
FBgn0261554	506	500	500	12	3	4	494
FBgn0261555	514	500	508	20	2	10	494
FBgn0261556	536	500	528	44	9	4.888888888888889	492
FBgn0261560	505	500	496	14	5	2.8	491
FBgn0261561	506	500	467	45	3	15	461
FBgn0261562	512	500	500	24	5	4.8	488
FBgn0261563	536	500	449	123	7	17.571428571428573	413
FBgn0261564	521	500	510	32	5	6.4	489
FBgn0261565	382	381	380	3	3	1	379
FBgn0261567	501	500	324	178	3	59.333333333333336	323
FBgn0261568	500	500	496	4	3	1.3333333333333333	496
FBgn0261570	500	500	500	0	0	NA	500
FBgn0261571	506	500	506	6	4	1.5	500
FBgn0261573	500	500	488	12	2	6	488
FBgn0261574	510	500	494	26	5	5.2	484
FBgn0261581	515	500	107	423	3	141	92
FBgn0261582	502	500	490	14	4	3.5	488
FBgn0261583	501	500	201	301	4	75.25	200
FBgn0261584	515	500	488	42	11	3.8181818181818183	473
FBgn0261586	500	500	499	1	1	1	499
FBgn0261587	522	500	496	48	5	9.6	474
FBgn0261588	500	500	495	5	2	2.5	495
FBgn0261602	527	500	443	111	7	15.857142857142858	416
FBgn0261608	520	500	519	21	4	5.25	499
FBgn0261609	509	500	230	288	3	96	221
FBgn0261610	500	500	463	37	5	7.4	463
FBgn0261611	524	500	509	39	6	6.5	485
FBgn0261612	511	500	503	19	5	3.8	492
FBgn0261614	500	500	500	0	0	NA	500
FBgn0261615	506	500	489	23	7	3.2857142857142856	483
FBgn0261616	521	500	508	34	5	6.8	487
FBgn0261617	501	500	501	1	1	1	500
FBgn0261618	550	500	548	52	6	8.666666666666666	498
FBgn0261625	458	451	449	16	4	4	442
FBgn0261627	500	500	484	16	2	8	484
FBgn0261628	513	500	485	41	8	5.125	472
FBgn0261630	519	500	518	20	4	5	499
FBgn0261631	448	444	446	6	4	1.5	442
FBgn0261632	501	500	444	58	7	8.285714285714286	443
FBgn0261633	523	500	497	49	10	4.9	474
FBgn0261634	523	500	498	48	10	4.8	475
FBgn0261635	507	500	492	22	3	7.333333333333333	485
FBgn0261636	518	500	378	158	4	39.5	360
FBgn0261638	340	340	140	200	1	200	140
FBgn0261641	510	500	434	86	7	12.285714285714286	424
FBgn0261647	509	500	509	9	2	4.5	500
FBgn0261648	513	500	513	13	2	6.5	500
FBgn0261649	524	500	516	32	5	6.4	492
FBgn0261673	512	500	445	79	12	6.583333333333333	433
FBgn0261674	503	500	502	4	2	2	499
FBgn0261675	500	500	479	21	4	5.25	479
FBgn0261700	512	500	497	27	4	6.75	485
FBgn0261702	501	500	268	234	8	29.25	267
FBgn0261703	529	500	436	122	6	20.333333333333332	407
FBgn0261705	500	500	499	1	1	1	499
FBgn0261707	520	500	498	42	5	8.4	478
FBgn0261709	503	500	502	4	2	2	499
FBgn0261710	501	500	497	5	2	2.5	496
FBgn0261714	500	500	500	0	0	NA	500
FBgn0261722	525	500	491	59	8	7.375	466
FBgn0261723	506	500	487	25	5	5	481
FBgn0261786	500	500	493	7	2	3.5	493
FBgn0261787	502	500	497	7	5	1.4	495
FBgn0261788	546	500	544	48	4	12	498
FBgn0261789	524	500	521	27	5	5.4	497
FBgn0261791	547	500	534	60	8	7.5	487
FBgn0261792	525	500	506	44	7	6.285714285714286	481
FBgn0261793	523	500	522	24	8	3	499
FBgn0261794	514	500	513	15	5	3	499
FBgn0261797	500	500	494	6	2	3	494
FBgn0261799	500	500	449	51	4	12.75	449
FBgn0261800	593	500	561	125	10	12.5	468
FBgn0261801	510	500	509	11	3	3.6666666666666665	499
FBgn0261803	503	500	447	59	11	5.363636363636363	444
FBgn0261804	500	500	498	2	1	2	498
FBgn0261805	512	500	488	36	3	12	476
FBgn0261806	510	500	497	23	8	2.875	487
FBgn0261807	519	500	507	31	5	6.2	488
FBgn0261811	518	500	502	34	7	4.857142857142857	484
FBgn0261813	507	500	477	37	9	4.111111111111111	470
FBgn0261814	501	500	472	30	5	6	471
FBgn0261816	502	500	476	28	5	5.6	474
FBgn0261817	500	500	500	0	0	NA	500
FBgn0261823	518	500	505	31	8	3.875	487
FBgn0261832	505	500	477	33	8	4.125	472
FBgn0261833	513	500	446	80	3	26.666666666666668	433
FBgn0261836	503	500	488	18	5	3.6	485
FBgn0261847	514	500	498	30	6	5	484
FBgn0261850	503	500	313	193	5	38.6	310
FBgn0261854	501	500	488	14	4	3.5	487
FBgn0261857	601	500	576	126	6	21	475
FBgn0261860	500	500	487	13	3	4.333333333333333	487
FBgn0261861	500	500	495	5	2	2.5	495
FBgn0261862	513	500	459	67	9	7.444444444444445	446
FBgn0261871	501	500	501	1	1	1	500
FBgn0261872	515	500	501	29	4	7.25	486
FBgn0261873	521	500	521	21	4	5.25	500
FBgn0261885	507	500	445	69	5	13.8	438
FBgn0261924	511	500	494	28	4	7	483
FBgn0261927	529	500	496	62	5	12.4	467
FBgn0261929	500	500	467	33	6	5.5	467
FBgn0261930	505	500	504	6	3	2	499
FBgn0261931	504	500	497	11	4	2.75	493
FBgn0261932	500	500	500	0	0	NA	500
FBgn0261933	508	500	489	27	6	4.5	481
FBgn0261934	500	500	206	294	2	147	206
FBgn0261938	507	500	507	7	2	3.5	500
FBgn0261952	554	500	519	89	13	6.846153846153846	465
FBgn0261953	500	500	500	0	0	NA	500
FBgn0261954	442	442	430	12	1	12	430
FBgn0261955	522	500	521	23	5	4.6	499
FBgn0261963	500	500	499	1	1	1	499
FBgn0261976	500	500	500	0	0	NA	500
FBgn0261983	501	500	496	6	3	2	495
FBgn0261984	502	500	490	14	2	7	488
FBgn0261986	507	500	464	50	9	5.555555555555555	457
FBgn0261987	535	500	533	37	12	3.0833333333333335	498
FBgn0261988	527	500	518	36	4	9	491
FBgn0261989	514	500	487	41	8	5.125	473
FBgn0261990	516	500	498	34	7	4.857142857142857	482
FBgn0261994	500	500	500	0	0	NA	500
FBgn0261996	348	348	347	1	1	1	347
FBgn0261999	511	500	506	16	3	5.333333333333333	495
FBgn0262000	501	500	465	37	3	12.333333333333334	464
FBgn0262001	504	500	492	16	5	3.2	488
FBgn0262003	526	500	504	48	7	6.857142857142857	478
FBgn0262004	372	359	362	23	7	3.2857142857142856	349
FBgn0262005	542	500	527	57	4	14.25	485
FBgn0262006	505	500	487	23	4	5.75	482
FBgn0262007	525	500	443	107	5	21.4	418
FBgn0262008	500	500	485	15	3	5	485
FBgn0262009	511	500	499	23	5	4.6	488
FBgn0262018	503	500	413	93	3	31	410
FBgn0262020	538	500	526	50	9	5.555555555555555	488
FBgn0262021	511	500	484	38	9	4.222222222222222	473
FBgn0262022	507	500	394	120	6	20	387
FBgn0262024	506	500	497	15	6	2.5	491
FBgn0262025	500	500	498	2	2	1	498
FBgn0262028	512	500	503	21	3	7	491
FBgn0262029	506	472	469	71	6	11.833333333333334	435
FBgn0262030	506	500	485	27	5	5.4	479
FBgn0262033	520	500	503	37	4	9.25	483
FBgn0262057	501	500	337	165	6	27.5	336
FBgn0262081	505	500	499	11	5	2.2	494
FBgn0262097	513	500	499	27	4	6.75	486
FBgn0262098	504	500	501	7	2	3.5	497
FBgn0262100	561	500	529	93	11	8.454545454545455	468
FBgn0262102	516	500	490	42	8	5.25	474
FBgn0262104	508	500	458	58	8	7.25	450
FBgn0262105	521	500	512	30	4	7.5	491
FBgn0262106	509	500	446	72	5	14.4	437
FBgn0262107	505	500	491	19	5	3.8	486
FBgn0262108	501	500	499	3	3	1	498
FBgn0262111	500	500	500	0	0	NA	500
FBgn0262112	513	500	478	48	9	5.333333333333333	465
FBgn0262114	532	500	489	75	4	18.75	457
FBgn0262117	504	500	278	230	6	38.333333333333336	274
FBgn0262124	500	500	37	463	2	231.5	37
FBgn0262125	500	500	306	194	1	194	306
FBgn0262127	517	500	490	44	8	5.5	473
FBgn0262141	549	500	526	72	11	6.545454545454546	477
FBgn0262146	507	500	507	7	2	3.5	500
FBgn0262148	514	500	503	25	6	4.166666666666667	489
FBgn0262149	500	500	493	7	3	2.3333333333333335	493
FBgn0262150	513	500	475	51	4	12.75	462
FBgn0262160	505	500	504	6	3	2	499
FBgn0262166	500	500	488	12	1	12	488
FBgn0262167	503	500	451	55	2	27.5	448
FBgn0262169	513	500	507	19	6	3.1666666666666665	494
FBgn0262170	500	500	498	2	1	2	498
FBgn0262172	505	500	459	51	5	10.2	454
FBgn0262178	523	500	515	31	7	4.428571428571429	492
FBgn0262182	515	500	515	15	3	5	500
FBgn0262215	510	500	434	86	6	14.333333333333334	424
FBgn0262223	501	500	499	3	3	1	498
FBgn0262256	500	500	435	65	4	16.25	435
FBgn0262263	515	500	513	17	4	4.25	498
FBgn0262266	501	500	393	109	5	21.8	392
FBgn0262269	354	352	352	4	3	1.3333333333333333	350
FBgn0262302	510	500	485	35	8	4.375	475
FBgn0262330	559	500	537	81	4	20.25	478
FBgn0262333	500	500	479	21	3	7	479
FBgn0262334	500	500	465	35	3	11.666666666666666	465
FBgn0262338	517	500	479	55	15	3.6666666666666665	462
FBgn0262351	501	500	448	54	3	18	447
FBgn0262352	506	500	480	32	5	6.4	474
FBgn0262353	509	500	489	29	7	4.142857142857143	480
FBgn0262354	509	500	506	12	5	2.4	497
FBgn0262356	501	500	330	172	3	57.333333333333336	329
FBgn0262358	506	500	488	24	5	4.8	482
FBgn0262359	498	498	480	18	2	9	480
FBgn0262360	503	500	359	147	8	18.375	356
FBgn0262361	500	500	494	6	3	2	494
FBgn0262362	519	500	509	29	12	2.4166666666666665	490
FBgn0262364	500	500	492	8	3	2.6666666666666665	492
FBgn0262366	500	500	188	312	6	52	188
FBgn0262374	510	500	484	36	9	4	474
FBgn0262376	502	500	487	17	3	5.666666666666667	485
FBgn0262378	546	500	507	85	12	7.083333333333333	461
FBgn0262383	535	500	535	35	5	7	500
FBgn0262388	509	500	506	12	3	4	497
FBgn0262390	500	500	480	20	6	3.3333333333333335	480
FBgn0262396	533	500	516	50	6	8.333333333333334	483
FBgn0262400	504	500	495	13	4	3.25	491
FBgn0262401	500	500	495	5	1	5	495
FBgn0262415	500	500	494	6	1	6	494
FBgn0262428	508	500	490	26	3	8.666666666666666	482
FBgn0262433	505	500	464	46	7	6.571428571428571	459
FBgn0262437	501	500	460	42	5	8.4	459
FBgn0262440	507	500	495	19	4	4.75	488
FBgn0262441	455	448	431	31	6	5.166666666666667	424
FBgn0262445	531	500	484	78	9	8.666666666666666	453
FBgn0262446	524	500	474	74	9	8.222222222222221	450
FBgn0262467	503	500	474	32	6	5.333333333333333	471
FBgn0262473	525	500	482	68	8	8.5	457
FBgn0262475	504	500	498	10	4	2.5	494
FBgn0262476	525	500	524	26	4	6.5	499
FBgn0262477	457	456	419	39	7	5.571428571428571	418
FBgn0262479	502	500	360	144	5	28.8	358
FBgn0262480	504	500	497	11	4	2.75	493
FBgn0262483	524	500	524	24	4	6	500
FBgn0262484	508	500	484	32	9	3.5555555555555554	476
FBgn0262486	508	500	474	42	7	6	466
FBgn0262487	501	500	492	10	4	2.5	491
FBgn0262508	506	500	505	7	3	2.3333333333333335	499
FBgn0262509	501	500	478	24	8	3	477
FBgn0262510	386	368	375	29	4	7.25	357
FBgn0262512	577	500	573	81	11	7.363636363636363	496
FBgn0262513	495	491	461	38	6	6.333333333333333	457
FBgn0262514	418	417	411	8	3	2.6666666666666665	410
FBgn0262515	505	500	495	15	3	5	490
FBgn0262517	500	500	500	0	0	NA	500
FBgn0262518	500	500	500	0	0	NA	500
FBgn0262519	502	500	502	2	2	1	500
FBgn0262524	500	500	498	2	1	2	498
FBgn0262527	458	457	426	33	3	11	425
FBgn0262529	501	500	482	20	6	3.3333333333333335	481
FBgn0262530	456	446	432	34	5	6.8	422
FBgn0262531	500	500	439	61	6	10.166666666666666	439
FBgn0262534	515	500	510	20	6	3.3333333333333335	495
FBgn0262535	514	500	489	39	6	6.5	475
FBgn0262536	466	466	424	42	5	8.4	424
FBgn0262541	538	500	527	49	4	12.25	489
FBgn0262542	506	500	505	7	5	1.4	499
FBgn0262544	514	500	491	37	6	6.166666666666667	477
FBgn0262546	500	500	447	53	1	53	447
FBgn0262547	502	500	493	11	4	2.75	491
FBgn0262559	529	500	516	42	8	5.25	487
FBgn0262562	521	500	497	45	8	5.625	476
FBgn0262563	508	500	321	195	4	48.75	313
FBgn0262564	503	500	429	77	2	38.5	426
FBgn0262567	523	500	505	41	6	6.833333333333333	482
FBgn0262568	507	500	485	29	6	4.833333333333333	478
FBgn0262569	505	500	466	44	4	11	461
FBgn0262571	507	500	497	17	7	2.4285714285714284	490
FBgn0262572	501	500	438	64	7	9.142857142857142	437
FBgn0262574	517	500	506	28	4	7	489
FBgn0262576	507	500	466	48	7	6.857142857142857	459
FBgn0262577	500	500	497	3	2	1.5	497
FBgn0262580	521	500	499	43	6	7.166666666666667	478
FBgn0262581	506	500	472	40	4	10	466
FBgn0262583	443	419	390	77	7	11	366
FBgn0262587	500	500	410	90	1	90	410
FBgn0262592	530	500	486	74	7	10.571428571428571	456
FBgn0262593	517	500	506	28	4	7	489
FBgn0262594	501	500	500	2	2	1	499
FBgn0262598	519	500	505	33	8	4.125	486
FBgn0262599	536	500	535	37	5	7.4	499
FBgn0262601	511	500	508	14	4	3.5	497
FBgn0262604	539	500	481	97	9	10.777777777777779	442
FBgn0262605	500	500	472	28	5	5.6	472
FBgn0262606	513	500	376	150	14	10.714285714285714	363
FBgn0262607	500	500	452	48	10	4.8	452
FBgn0262608	519	500	515	23	8	2.875	496
FBgn0262609	525	500	430	120	5	24	405
FBgn0262611	520	500	506	34	7	4.857142857142857	486
FBgn0262612	500	500	492	8	3	2.6666666666666665	492
FBgn0262616	506	500	368	144	11	13.090909090909092	362
FBgn0262617	475	474	451	25	7	3.5714285714285716	450
FBgn0262619	522	500	513	31	6	5.166666666666667	491
FBgn0262622	502	500	488	16	3	5.333333333333333	486
FBgn0262623	521	500	516	26	6	4.333333333333333	495
FBgn0262624	509	500	468	50	4	12.5	459
FBgn0262636	559	500	557	61	5	12.2	498
FBgn0262647	508	500	508	8	2	4	500
FBgn0262679	538	500	503	73	6	12.166666666666666	465
FBgn0262680	537	500	476	98	6	16.333333333333332	439
FBgn0262685	504	500	490	18	5	3.6	486
FBgn0262686	520	500	402	138	9	15.333333333333334	382
FBgn0262687	500	500	32	468	1	468	32
FBgn0262690	558	500	538	78	5	15.6	480
FBgn0262699	507	500	493	21	2	10.5	486
FBgn0262714	514	500	486	42	11	3.8181818181818183	472
FBgn0262716	508	500	498	18	4	4.5	490
FBgn0262717	500	500	412	88	4	22	412
FBgn0262719	454	451	408	49	6	8.166666666666666	405
FBgn0262728	509	500	501	17	5	3.4	492
FBgn0262730	514	500	481	47	7	6.714285714285714	467
FBgn0262732	507	500	481	33	6	5.5	474
FBgn0262733	433	405	422	39	11	3.5454545454545454	394
FBgn0262734	514	500	456	72	6	12	442
FBgn0262736	503	500	467	39	8	4.875	464
FBgn0262737	502	500	502	2	1	2	500
FBgn0262738	518	500	495	41	8	5.125	477
FBgn0262739	518	500	514	22	5	4.4	496
FBgn0262743	509	500	509	9	3	3	500
FBgn0262782	516	500	516	16	3	5.333333333333333	500
FBgn0262786	507	500	430	84	4	21	423
FBgn0262787	532	500	515	49	5	9.8	483
FBgn0262788	500	500	484	16	2	8	484
FBgn0262794	504	500	480	28	3	9.333333333333334	476
FBgn0262801	546	500	535	57	8	7.125	489
FBgn0262810	505	500	501	9	3	3	496
FBgn0262811	500	500	496	4	2	2	496
FBgn0262812	386	374	367	31	8	3.875	355
FBgn0262813	523	500	500	46	9	5.111111111111111	477
FBgn0262814	500	500	499	1	1	1	499
FBgn0262816	404	380	352	76	13	5.846153846153846	328
FBgn0262817	510	500	500	20	7	2.857142857142857	490
FBgn0262819	504	500	494	14	3	4.666666666666667	490
FBgn0262820	500	500	499	1	1	1	499
FBgn0262821	518	500	510	26	10	2.6	492
FBgn0262822	502	500	491	13	2	6.5	489
FBgn0262827	511	500	447	75	6	12.5	436
FBgn0262838	512	500	489	35	7	5	477
FBgn0262839	564	500	564	64	5	12.8	500
FBgn0262840	500	500	500	0	0	NA	500
FBgn0262842	500	500	485	15	4	3.75	485
FBgn0262843	500	500	488	12	2	6	488
FBgn0262852	338	338	233	105	3	35	233
FBgn0262855	500	500	441	59	2	29.5	441
FBgn0262858	502	500	490	14	4	3.5	488
FBgn0262867	512	500	496	28	5	5.6	484
FBgn0262869	505	500	505	5	2	2.5	500
FBgn0262870	480	478	421	61	7	8.714285714285714	419
FBgn0262871	507	500	506	8	4	2	499
FBgn0262872	504	500	504	4	1	4	500
FBgn0262875	507	500	485	29	4	7.25	478
FBgn0262876	500	500	497	3	1	3	497
FBgn0262877	520	500	520	20	1	20	500
FBgn0262880	550	500	549	51	4	12.75	499
FBgn0262881	514	500	447	81	6	13.5	433
FBgn0262882	501	500	463	39	4	9.75	462
FBgn0262883	500	500	491	9	3	3	491
FBgn0262885	504	500	359	149	8	18.625	355
FBgn0262887	501	500	292	210	8	26.25	291
FBgn0262888	501	500	473	29	5	5.8	472
FBgn0262889	507	500	480	34	8	4.25	473
FBgn0262890	510	500	491	29	6	4.833333333333333	481
FBgn0262891	505	500	504	6	4	1.5	499
FBgn0262892	500	500	498	2	1	2	498
FBgn0262893	518	500	515	21	4	5.25	497
FBgn0262895	502	500	481	23	2	11.5	479
FBgn0262896	501	500	468	34	7	4.857142857142857	467
FBgn0262899	544	500	524	64	6	10.666666666666666	480
FBgn0262902	506	500	466	46	2	23	460
FBgn0262903	503	500	496	10	2	5	493
FBgn0262904	500	500	491	9	3	3	491
FBgn0262937	504	500	504	4	2	2	500
FBgn0262943	501	500	487	15	2	7.5	486
FBgn0262944	501	500	367	135	6	22.5	366
FBgn0262947	559	500	533	85	9	9.444444444444445	474
FBgn0262951	505	500	501	9	2	4.5	496
FBgn0262954	361	361	76	285	3	95	76
FBgn0262955	500	500	490	10	2	5	490
FBgn0262960	511	500	493	29	7	4.142857142857143	482
FBgn0262962	502	500	501	3	3	1	499
FBgn0262963	500	500	486	14	4	3.5	486
FBgn0262967	529	500	500	58	10	5.8	471
FBgn0262969	532	500	454	110	9	12.222222222222221	422
FBgn0262972	500	500	488	12	1	12	488
FBgn0262975	513	500	461	65	8	8.125	448
FBgn0262976	500	500	482	18	3	6	482
FBgn0262979	501	500	465	37	5	7.4	464
FBgn0262980	505	500	458	52	8	6.5	453
FBgn0262981	502	500	495	9	4	2.25	493
FBgn0262984	500	500	500	0	0	NA	500
FBgn0262985	500	500	498	2	1	2	498
FBgn0262986	502	500	477	27	5	5.4	475
FBgn0262987	512	500	510	14	4	3.5	498
FBgn0262988	500	500	498	2	1	2	498
FBgn0262989	523	500	519	27	7	3.857142857142857	496
FBgn0262990	561	500	542	80	9	8.88888888888889	481
FBgn0262992	521	500	504	38	3	12.666666666666666	483
FBgn0262994	500	500	477	23	2	11.5	477
FBgn0262995	535	500	521	49	8	6.125	486
FBgn0262996	503	500	484	22	5	4.4	481
FBgn0262998	500	500	335	165	3	55	335
FBgn0262999	515	500	500	30	6	5	485
FBgn0263000	501	483	493	26	2	13	475
FBgn0263001	411	396	180	246	2	123	165
FBgn0263004	516	500	515	17	3	5.666666666666667	499
FBgn0263005	501	500	177	325	3	108.33333333333333	176
FBgn0263006	511	500	507	15	3	5	496
FBgn0263019	502	500	482	22	4	5.5	480
FBgn0263020	455	455	426	29	7	4.142857142857143	426
FBgn0263021	508	500	410	106	5	21.2	402
FBgn0263022	522	500	503	41	8	5.125	481
FBgn0263024	504	500	474	34	9	3.7777777777777777	470
FBgn0263026	501	500	487	15	3	5	486
FBgn0263027	534	500	515	53	7	7.571428571428571	481
FBgn0263037	500	500	496	4	2	2	496
FBgn0263038	500	500	499	1	1	1	499
FBgn0263040	500	500	492	8	2	4	492
FBgn0263049	557	500	520	94	7	13.428571428571429	463
FBgn0263072	502	500	500	4	2	2	498
FBgn0263076	542	500	541	43	2	21.5	499
FBgn0263077	505	500	441	69	3	23	436
FBgn0263079	511	500	510	12	3	4	499
FBgn0263080	504	500	494	14	6	2.3333333333333335	490
FBgn0263081	501	500	295	207	4	51.75	294
FBgn0263082	504	500	502	6	3	2	498
FBgn0263083	502	500	502	2	1	2	500
FBgn0263084	532	500	459	105	5	21	427
FBgn0263085	500	500	500	0	0	NA	500
FBgn0263086	517	500	484	50	10	5	467
FBgn0263088	505	500	484	26	8	3.25	479
FBgn0263089	549	500	538	60	6	10	489
FBgn0263090	503	500	503	3	2	1.5	500
FBgn0263092	500	500	86	414	2	207	86
FBgn0263093	533	500	500	66	12	5.5	467
FBgn0263095	503	500	484	22	3	7.333333333333333	481
FBgn0263102	509	500	506	12	2	6	497
FBgn0263106	500	500	137	363	2	181.5	137
FBgn0263108	502	500	494	10	2	5	492
FBgn0263109	532	500	532	32	5	6.4	500
FBgn0263110	514	500	494	34	4	8.5	480
FBgn0263113	500	500	489	11	3	3.6666666666666665	489
FBgn0263114	501	500	498	4	2	2	497
FBgn0263116	512	500	508	16	4	4	496
FBgn0263117	504	500	498	10	2	5	494
FBgn0263118	503	500	471	35	2	17.5	468
FBgn0263130	505	500	497	13	3	4.333333333333333	492
FBgn0263131	501	500	489	13	4	3.25	488
FBgn0263132	508	500	478	38	6	6.333333333333333	470
FBgn0263133	507	500	456	58	8	7.25	449
FBgn0263143	500	500	500	0	0	NA	500
FBgn0263144	532	500	523	41	6	6.833333333333333	491
FBgn0263197	506	500	488	24	5	4.8	482
FBgn0263198	504	500	498	10	5	2	494
FBgn0263199	518	500	496	40	6	6.666666666666667	478
FBgn0263200	529	500	521	37	6	6.166666666666667	492
FBgn0263206	500	500	485	15	3	5	485
FBgn0263216	527	500	478	76	9	8.444444444444445	451
FBgn0263217	501	500	459	43	6	7.166666666666667	458
FBgn0263220	510	500	508	12	5	2.4	498
FBgn0263233	501	500	497	5	3	1.6666666666666667	496
FBgn0263234	505	500	447	63	6	10.5	442
FBgn0263235	528	500	503	53	6	8.833333333333334	475
FBgn0263236	502	500	477	27	4	6.75	475
FBgn0263237	523	500	520	26	6	4.333333333333333	497
FBgn0263239	500	500	499	1	1	1	499
FBgn0263240	503	500	493	13	4	3.25	490
FBgn0263241	572	500	520	124	14	8.857142857142858	448
FBgn0263246	508	500	500	16	3	5.333333333333333	492
FBgn0263247	550	500	498	102	8	12.75	448
FBgn0263249	514	500	511	17	8	2.125	497
FBgn0263256	503	500	497	9	3	3	494
FBgn0263257	503	500	453	53	7	7.571428571428571	450
FBgn0263258	517	500	504	30	7	4.285714285714286	487
FBgn0263260	488	475	482	19	6	3.1666666666666665	469
FBgn0263270	505	500	500	10	3	3.3333333333333335	495
FBgn0263314	392	390	383	11	5	2.2	381
FBgn0263316	519	500	460	78	6	13	441
FBgn0263320	510	500	444	76	3	25.333333333333332	434
FBgn0263321	500	500	477	23	5	4.6	477
FBgn0263322	502	500	492	12	3	4	490
FBgn0263323	501	500	444	58	2	29	443
FBgn0263325	501	500	498	4	3	1.3333333333333333	497
FBgn0263326	531	500	531	31	4	7.75	500
FBgn0263327	590	500	578	102	9	11.333333333333334	488
FBgn0263328	541	500	527	55	4	13.75	486
FBgn0263329	504	500	449	59	4	14.75	445
FBgn0263330	517	500	477	57	8	7.125	460
FBgn0263331	503	500	494	12	4	3	491
FBgn0263332	509	500	482	36	3	12	473
FBgn0263333	533	500	521	45	6	7.5	488
FBgn0263334	548	500	477	119	12	9.916666666666666	429
FBgn0263335	510	500	509	11	4	2.75	499
FBgn0263336	509	500	478	40	5	8	469
FBgn0263337	523	500	499	47	7	6.714285714285714	476
FBgn0263338	501	500	497	5	4	1.25	496
FBgn0263339	506	500	495	17	4	4.25	489
FBgn0263340	500	500	493	7	2	3.5	493
FBgn0263341	500	500	499	1	1	1	499
FBgn0263342	511	500	510	12	4	3	499
FBgn0263343	511	500	470	52	11	4.7272727272727275	459
FBgn0263351	501	500	490	12	4	3	489
FBgn0263353	509	500	502	16	4	4	493
FBgn0263355	500	500	259	241	2	120.5	259
FBgn0263376	505	500	483	27	5	5.4	478
FBgn0263378	500	500	484	16	3	5.333333333333333	484
FBgn0263379	500	500	497	3	1	3	497
FBgn0263380	523	500	485	61	5	12.2	462
FBgn0263381	549	500	535	63	11	5.7272727272727275	486
FBgn0263383	518	500	396	140	4	35	378
FBgn0263384	507	500	497	17	3	5.666666666666667	490
FBgn0263385	513	500	511	15	4	3.75	498
FBgn0263386	507	500	485	29	7	4.142857142857143	478
FBgn0263388	510	500	504	16	4	4	494
FBgn0263390	500	500	475	25	6	4.166666666666667	475
FBgn0263391	500	500	398	102	2	51	398
FBgn0263392	504	500	497	11	7	1.5714285714285714	493
FBgn0263395	503	500	279	227	6	37.833333333333336	276
FBgn0263396	533	500	517	49	6	8.166666666666666	484
FBgn0263397	524	500	494	54	5	10.8	470
FBgn0263398	501	500	487	15	6	2.5	486
FBgn0263399	502	500	483	21	5	4.2	481
FBgn0263400	502	500	501	3	2	1.5	499
FBgn0263401	512	500	504	20	5	4	492
FBgn0263402	513	500	477	49	7	7	464
FBgn0263403	500	500	500	0	0	NA	500
FBgn0263404	512	500	472	52	3	17.333333333333332	460
FBgn0263405	509	500	467	51	7	7.285714285714286	458
FBgn0263407	516	500	510	22	8	2.75	494
FBgn0263408	500	500	488	12	2	6	488
FBgn0263409	500	500	464	36	4	9	464
FBgn0263410	500	500	492	8	1	8	492
FBgn0263413	502	500	485	19	3	6.333333333333333	483
FBgn0263414	508	500	483	33	9	3.6666666666666665	475
FBgn0263441	542	500	536	48	4	12	494
FBgn0263442	506	500	463	49	5	9.8	457
FBgn0263443	500	500	492	8	1	8	492
FBgn0263444	504	500	503	5	3	1.6666666666666667	499
FBgn0263446	547	500	513	81	11	7.363636363636363	466
FBgn0263447	502	500	501	3	3	1	499
FBgn0263448	501	500	498	4	2	2	497
FBgn0263449	551	500	543	59	8	7.375	492
FBgn0263452	504	500	496	12	6	2	492
FBgn0263453	504	500	503	5	2	2.5	499
FBgn0263454	514	500	511	17	3	5.666666666666667	497
FBgn0263455	524	500	490	58	4	14.5	466
FBgn0263456	521	500	503	39	9	4.333333333333333	482
FBgn0263457	500	500	496	4	1	4	496
FBgn0263459	512	500	475	49	8	6.125	463
FBgn0263492	503	500	502	4	3	1.3333333333333333	499
FBgn0263493	501	500	501	1	1	1	500
FBgn0263494	510	500	493	27	5	5.4	483
FBgn0263495	501	500	481	21	5	4.2	480
FBgn0263496	525	500	525	25	2	12.5	500
FBgn0263498	505	500	490	20	4	5	485
FBgn0263500	500	500	495	5	2	2.5	495
FBgn0263501	500	500	495	5	2	2.5	495
FBgn0263502	500	500	494	6	2	3	494
FBgn0263503	504	500	493	15	3	5	489
FBgn0263504	526	500	300	252	6	42	274
FBgn0263505	518	500	512	24	6	4	494
FBgn0263506	527	500	517	37	6	6.166666666666667	490
FBgn0263507	504	500	501	7	4	1.75	497
FBgn0263509	519	500	476	62	9	6.888888888888889	457
FBgn0263510	549	500	482	116	9	12.88888888888889	433
FBgn0263511	500	500	490	10	2	5	490
FBgn0263512	503	500	503	3	1	3	500
FBgn0263517	530	500	530	30	2	15	500
FBgn0263528	500	500	500	0	0	NA	500
FBgn0263539	502	500	473	31	4	7.75	471
FBgn0263543	504	500	495	13	6	2.1666666666666665	491
FBgn0263548	522	500	515	29	6	4.833333333333333	493
FBgn0263552	508	500	508	8	1	8	500
FBgn0263553	369	369	369	0	0	NA	369
FBgn0263556	500	500	497	3	1	3	497
FBgn0263562	500	500	497	3	1	3	497
FBgn0263572	504	500	426	82	3	27.333333333333332	422
FBgn0263581	504	500	464	44	6	7.333333333333333	460
FBgn0263582	523	500	510	36	5	7.2	487
FBgn0263584	506	500	477	35	6	5.833333333333333	471
FBgn0263585	561	500	537	85	8	10.625	476
FBgn0263586	511	500	485	37	6	6.166666666666667	474
FBgn0263587	528	500	518	38	4	9.5	490
FBgn0263588	500	500	448	52	5	10.4	448
FBgn0263589	500	500	459	41	12	3.4166666666666665	459
FBgn0263590	509	500	502	16	3	5.333333333333333	493
FBgn0263594	501	500	386	116	3	38.666666666666664	385
FBgn0263595	500	500	478	22	7	3.142857142857143	478
FBgn0263597	394	391	246	151	8	18.875	243
FBgn0263598	500	500	273	227	4	56.75	273
FBgn0263599	523	500	515	31	5	6.2	492
FBgn0263600	504	500	479	29	11	2.6363636363636362	475
FBgn0263601	503	500	238	268	5	53.6	235
FBgn0263602	509	500	497	21	6	3.5	488
FBgn0263603	504	500	216	292	5	58.4	212
FBgn0263605	519	500	514	24	3	8	495
FBgn0263606	476	467	466	19	10	1.9	457
FBgn0263611	521	500	512	30	7	4.285714285714286	491
FBgn0263612	508	500	482	34	5	6.8	474
FBgn0263613	519	500	517	21	3	7	498
FBgn0263615	583	500	571	95	8	11.875	488
FBgn0263616	542	500	506	78	7	11.142857142857142	464
FBgn0263617	513	500	478	48	9	5.333333333333333	465
FBgn0263618	504	500	447	61	3	20.333333333333332	443
FBgn0263619	500	500	467	33	1	33	467
FBgn0263620	511	500	497	25	5	5	486
FBgn0263621	508	500	494	22	7	3.142857142857143	486
FBgn0263623	500	500	498	2	2	1	498
FBgn0263624	510	500	509	11	2	5.5	499
FBgn0263625	510	500	509	11	2	5.5	499
FBgn0263627	500	500	497	3	1	3	497
FBgn0263647	420	413	349	78	8	9.75	342
FBgn0263649	502	500	481	23	5	4.6	479
FBgn0263650	506	500	502	10	2	5	496
FBgn0263651	453	452	335	119	3	39.666666666666664	334
FBgn0263652	502	500	498	6	4	1.5	496
FBgn0263653	500	500	224	276	1	276	224
FBgn0263655	509	500	465	53	5	10.6	456
FBgn0263657	515	500	499	31	7	4.428571428571429	484
FBgn0263658	500	500	499	1	1	1	499
FBgn0263659	526	500	522	30	4	7.5	496
FBgn0263660	500	500	493	7	1	7	493
FBgn0263661	500	500	465	35	4	8.75	465
FBgn0263662	500	500	499	1	1	1	499
FBgn0263663	506	500	496	16	3	5.333333333333333	490
FBgn0263664	510	500	509	11	2	5.5	499
FBgn0263665	500	500	51	449	2	224.5	51
FBgn0263667	522	500	499	45	7	6.428571428571429	477
FBgn0263697	502	500	492	12	4	3	490
FBgn0263705	509	500	354	164	3	54.666666666666664	345
FBgn0263706	507	500	479	35	3	11.666666666666666	472
FBgn0263707	546	500	540	52	8	6.5	494
FBgn0263708	504	500	491	17	6	2.8333333333333335	487
FBgn0263709	501	500	501	1	1	1	500
FBgn0263741	335	335	324	11	3	3.6666666666666665	324
FBgn0263742	349	338	321	39	5	7.8	310
FBgn0263743	508	500	499	17	3	5.666666666666667	491
FBgn0263746	501	500	483	19	2	9.5	482
FBgn0263748	451	442	389	71	9	7.888888888888889	380
FBgn0263760	393	393	386	7	3	2.3333333333333335	386
FBgn0263764	507	500	467	47	5	9.4	460
FBgn0263765	501	500	470	32	3	10.666666666666666	469
FBgn0263766	500	500	487	13	5	2.6	487
FBgn0263769	505	500	490	20	6	3.3333333333333335	485
FBgn0263770	473	426	466	54	8	6.75	419
FBgn0263772	500	500	481	19	4	4.75	481
FBgn0263773	571	500	569	73	5	14.6	498
FBgn0263774	500	500	450	50	4	12.5	450
FBgn0263776	509	500	474	44	7	6.285714285714286	465
FBgn0263780	513	500	432	94	8	11.75	419
FBgn0263782	529	500	525	33	6	5.5	496
FBgn0263802	516	500	486	46	6	7.666666666666667	470
FBgn0263830	500	500	200	300	1	300	200
FBgn0263831	504	500	499	9	4	2.25	495
FBgn0263832	508	500	508	8	4	2	500
FBgn0263838	505	500	466	44	9	4.888888888888889	461
FBgn0263839	513	500	512	14	3	4.666666666666667	499
FBgn0263841	501	500	493	9	3	3	492
FBgn0263843	501	500	492	10	3	3.3333333333333335	491
FBgn0263845	518	500	496	40	4	10	478
FBgn0263846	500	500	500	0	0	NA	500
FBgn0263850	538	500	517	59	9	6.555555555555555	479
FBgn0263852	500	500	498	2	1	2	498
FBgn0263855	502	500	323	181	3	60.333333333333336	321
FBgn0263866	500	500	448	52	3	17.333333333333332	448
FBgn0263868	532	500	515	49	8	6.125	483
FBgn0263871	500	500	489	11	3	3.6666666666666665	489
FBgn0263872	500	500	446	54	2	27	446
FBgn0263873	524	500	509	39	9	4.333333333333333	485
FBgn0263874	519	500	503	35	4	8.75	484
FBgn0263911	500	500	170	330	1	330	170
FBgn0263916	513	500	501	25	7	3.5714285714285716	488
FBgn0263929	511	500	503	19	6	3.1666666666666665	492
FBgn0263930	515	500	461	69	7	9.857142857142858	446
FBgn0263934	528	500	493	63	2	31.5	465
FBgn0263967	501	500	493	9	2	4.5	492
FBgn0263968	439	438	433	7	4	1.75	432
FBgn0263970	523	500	480	66	4	16.5	457
FBgn0263971	501	500	498	4	3	1.3333333333333333	497
FBgn0263973	526	500	500	52	6	8.666666666666666	474
FBgn0263974	372	371	364	9	3	3	363
FBgn0263975	508	500	364	152	6	25.333333333333332	356
FBgn0263976	500	500	493	7	2	3.5	493
FBgn0263977	500	500	41	459	2	229.5	41
FBgn0263979	527	500	521	33	4	8.25	494
FBgn0263980	500	500	498	2	1	2	498
FBgn0263981	500	500	496	4	2	2	496
FBgn0263987	513	500	387	139	9	15.444444444444445	374
FBgn0263988	501	500	490	12	4	3	489
FBgn0263992	506	500	488	24	2	12	482
FBgn0263993	526	500	481	71	8	8.875	455
FBgn0263994	507	500	458	56	3	18.666666666666668	451
FBgn0263995	502	500	495	9	3	3	493
FBgn0263999	500	500	174	326	4	81.5	174
FBgn0264000	503	500	496	10	3	3.3333333333333335	493
FBgn0264001	511	500	509	13	2	6.5	498
FBgn0264002	501	500	487	15	4	3.75	486
FBgn0264005	500	500	498	2	2	1	498
FBgn0264006	500	500	454	46	4	11.5	454
FBgn0264075	503	500	489	17	4	4.25	486
FBgn0264078	503	500	494	12	4	3	491
FBgn0264081	533	500	494	72	9	8	461
FBgn0264083	515	500	481	49	9	5.444444444444445	466
FBgn0264084	501	500	494	8	5	1.6	493
FBgn0264085	501	500	493	9	4	2.25	492
FBgn0264087	526	500	513	39	7	5.571428571428571	487
FBgn0264089	507	500	507	7	1	7	500
FBgn0264090	508	500	473	43	3	14.333333333333334	465
FBgn0264253	502	500	355	149	4	37.25	353
FBgn0264260	503	500	455	51	6	8.5	452
FBgn0264261	503	500	476	30	5	6	473
FBgn0264262	522	500	189	355	2	177.5	167
FBgn0264263	502	500	500	4	4	1	498
FBgn0264264	503	500	492	14	2	7	489
FBgn0264265	505	500	497	13	3	4.333333333333333	492
FBgn0264266	547	500	535	59	12	4.916666666666667	488
FBgn0264267	539	500	539	39	5	7.8	500
FBgn0264268	504	500	492	16	5	3.2	488
FBgn0264270	505	500	500	10	4	2.5	495
FBgn0264271	508	500	502	14	5	2.8	494
FBgn0264272	510	500	481	39	4	9.75	471
FBgn0264273	504	500	348	160	8	20	344
FBgn0264291	501	500	500	2	2	1	499
FBgn0264294	501	500	489	13	5	2.6	488
FBgn0264296	501	500	399	103	7	14.714285714285714	398
FBgn0264307	513	500	467	59	7	8.428571428571429	454
FBgn0264308	504	500	500	8	3	2.6666666666666665	496
FBgn0264310	395	384	216	190	3	63.333333333333336	205
FBgn0264325	506	500	496	16	4	4	490
FBgn0264326	513	500	469	57	8	7.125	456
FBgn0264327	500	500	493	7	1	7	493
FBgn0264337	512	500	510	14	3	4.666666666666667	498
FBgn0264338	500	500	487	13	3	4.333333333333333	487
FBgn0264339	524	500	504	44	9	4.888888888888889	480
FBgn0264341	527	500	510	44	7	6.285714285714286	483
FBgn0264342	516	500	351	181	7	25.857142857142858	335
FBgn0264343	503	500	480	26	3	8.666666666666666	477
FBgn0264345	561	500	559	63	7	9	498
FBgn0264346	503	500	484	22	3	7.333333333333333	481
FBgn0264347	546	500	525	67	8	8.375	479
FBgn0264349	500	500	494	6	2	3	494
FBgn0264350	500	500	500	0	0	NA	500
FBgn0264351	507	500	494	20	4	5	487
FBgn0264352	508	500	484	32	4	8	476
FBgn0264353	510	500	493	27	5	5.4	483
FBgn0264357	527	500	487	67	4	16.75	460
FBgn0264359	511	500	510	12	4	3	499
FBgn0264360	500	500	496	4	1	4	496
FBgn0264361	526	500	518	34	6	5.666666666666667	492
FBgn0264363	403	403	370	33	5	6.6	370
FBgn0264365	534	500	524	44	3	14.666666666666666	490
FBgn0264366	506	500	492	20	5	4	486
FBgn0264367	510	500	502	18	4	4.5	492
FBgn0264368	569	500	552	86	10	8.6	483
FBgn0264369	526	500	516	36	5	7.2	490
FBgn0264370	526	500	507	45	7	6.428571428571429	481
FBgn0264371	501	500	490	12	3	4	489
FBgn0264372	512	500	501	23	5	4.6	489
FBgn0264374	519	500	505	33	4	8.25	486
FBgn0264377	501	500	499	3	3	1	498
FBgn0264378	505	500	456	54	5	10.8	451
FBgn0264379	500	500	412	88	3	29.333333333333332	412
FBgn0264380	528	500	495	61	6	10.166666666666666	467
FBgn0264381	502	500	493	11	4	2.75	491
FBgn0264382	500	500	468	32	7	4.571428571428571	468
FBgn0264384	507	500	480	34	6	5.666666666666667	473
FBgn0264385	564	500	547	81	9	9	483
FBgn0264386	508	500	508	8	2	4	500
FBgn0264391	500	500	274	226	1	226	274
FBgn0264392	502	500	492	12	6	2	490
FBgn0264393	456	456	434	22	2	11	434
FBgn0264394	526	500	494	58	9	6.444444444444445	468
FBgn0264428	533	500	527	39	3	13	494
FBgn0264429	500	500	496	4	1	4	496
FBgn0264430	502	500	493	11	3	3.6666666666666665	491
FBgn0264433	511	500	476	46	8	5.75	465
FBgn0264434	500	500	429	71	4	17.75	429
FBgn0264435	505	500	494	16	6	2.6666666666666665	489
FBgn0264436	500	500	492	8	3	2.6666666666666665	492
FBgn0264438	505	500	469	41	6	6.833333333333333	464
FBgn0264439	519	500	509	29	6	4.833333333333333	490
FBgn0264440	514	500	506	22	5	4.4	492
FBgn0264441	541	500	483	99	10	9.9	442
FBgn0264442	501	500	492	10	3	3.3333333333333335	491
FBgn0264443	516	500	423	109	5	21.8	407
FBgn0264445	510	500	507	13	6	2.1666666666666665	497
FBgn0264446	500	500	497	3	1	3	497
FBgn0264447	500	500	490	10	4	2.5	490
FBgn0264448	500	500	500	0	0	NA	500
FBgn0264460	534	500	529	39	4	9.75	495
FBgn0264467	502	500	413	91	5	18.2	411
FBgn0264468	500	500	500	0	0	NA	500
FBgn0264469	529	500	529	29	1	29	500
FBgn0264470	513	500	500	26	6	4.333333333333333	487
FBgn0264472	509	500	472	46	7	6.571428571428571	463
FBgn0264474	523	500	519	27	3	9	496
FBgn0264475	506	500	474	38	10	3.8	468
FBgn0264477	500	500	497	3	1	3	497
FBgn0264478	502	500	493	11	4	2.75	491
FBgn0264479	541	500	535	47	3	15.666666666666666	494
FBgn0264480	532	500	529	35	8	4.375	497
FBgn0264481	511	500	509	13	2	6.5	498
FBgn0264483	500	500	494	6	1	6	494
FBgn0264484	512	500	509	15	3	5	497
FBgn0264485	513	500	486	40	6	6.666666666666667	473
FBgn0264486	500	500	491	9	3	3	491
FBgn0264488	355	351	354	5	2	2.5	350
FBgn0264489	501	500	473	29	3	9.666666666666666	472
FBgn0264490	500	500	484	16	5	3.2	484
FBgn0264491	501	500	497	5	3	1.6666666666666667	496
FBgn0264492	524	500	406	142	4	35.5	382
FBgn0264493	526	500	513	39	6	6.5	487
FBgn0264494	501	500	493	9	4	2.25	492
FBgn0264495	524	500	508	40	7	5.714285714285714	484
FBgn0264496	504	500	487	21	7	3	483
FBgn0264500	502	500	492	12	3	4	490
FBgn0264502	512	500	486	38	9	4.222222222222222	474
FBgn0264503	514	500	453	75	9	8.333333333333334	439
FBgn0264504	500	500	497	3	2	1.5	497
FBgn0264505	500	500	499	1	1	1	499
FBgn0264506	500	500	468	32	3	10.666666666666666	468
FBgn0264508	508	500	508	8	1	8	500
FBgn0264509	530	500	508	52	10	5.2	478
FBgn0264510	502	500	493	11	4	2.75	491
FBgn0264512	523	500	516	30	5	6	493
FBgn0264513	500	500	301	199	3	66.33333333333333	301
FBgn0264514	553	500	549	57	5	11.4	496
FBgn0264515	509	500	505	13	3	4.333333333333333	496
FBgn0264516	506	500	479	33	5	6.6	473
FBgn0264517	502	500	497	7	2	3.5	495
FBgn0264518	545	500	529	61	5	12.2	484
FBgn0264539	527	500	518	36	4	9	491
FBgn0264540	554	500	469	139	14	9.928571428571429	415
FBgn0264542	502	500	495	9	4	2.25	493
FBgn0264543	500	500	497	3	1	3	497
FBgn0264546	505	500	497	13	8	1.625	492
FBgn0264547	502	500	491	13	3	4.333333333333333	489
FBgn0264550	500	500	448	52	6	8.666666666666666	448
FBgn0264551	514	500	514	14	2	7	500
FBgn0264552	500	500	467	33	3	11	467
FBgn0264554	507	500	484	30	4	7.5	477
FBgn0264556	549	500	533	65	11	5.909090909090909	484
FBgn0264560	500	500	498	2	1	2	498
FBgn0264561	545	500	545	45	4	11.25	500
FBgn0264562	514	500	500	28	6	4.666666666666667	486
FBgn0264563	501	500	491	11	4	2.75	490
FBgn0264566	505	500	500	10	6	1.6666666666666667	495
FBgn0264567	519	500	512	26	3	8.666666666666666	493
FBgn0264572	556	500	491	121	3	40.333333333333336	435
FBgn0264573	526	500	404	148	7	21.142857142857142	378
FBgn0264574	502	500	469	35	6	5.833333333333333	467
FBgn0264598	517	500	509	25	6	4.166666666666667	492
FBgn0264599	500	500	494	6	2	3	494
FBgn0264600	596	500	588	104	10	10.4	492
FBgn0264601	501	500	473	29	4	7.25	472
FBgn0264602	548	500	524	72	7	10.285714285714286	476
FBgn0264603	383	378	383	5	2	2.5	378
FBgn0264604	502	500	444	60	3	20	442
FBgn0264606	500	500	496	4	2	2	496
FBgn0264607	510	500	475	45	9	5	465
FBgn0264616	563	500	404	222	12	18.5	341
FBgn0264617	500	500	492	8	1	8	492
FBgn0264672	514	500	141	387	3	129	127
FBgn0264674	500	500	498	2	1	2	498
FBgn0264677	503	500	456	50	6	8.333333333333334	453
FBgn0264679	517	500	489	45	5	9	472
FBgn0264691	513	500	487	39	7	5.571428571428571	474
FBgn0264693	386	385	345	42	5	8.4	344
FBgn0264694	500	500	490	10	5	2	490
FBgn0264695	502	500	493	11	3	3.6666666666666665	491
FBgn0264696	503	500	501	5	2	2.5	498
FBgn0264697	542	500	536	48	4	12	494
FBgn0264700	503	500	469	37	5	7.4	466
FBgn0264702	577	500	572	82	9	9.11111111111111	495
FBgn0264705	507	500	453	61	8	7.625	446
FBgn0264707	533	500	511	55	9	6.111111111111111	478
FBgn0264708	500	500	470	30	1	30	470
FBgn0264709	532	500	520	44	5	8.8	488
FBgn0264710	500	500	500	0	0	NA	500
FBgn0264712	533	500	532	34	5	6.8	499
FBgn0264713	535	500	520	50	9	5.555555555555555	485
FBgn0264714	500	500	494	6	3	2	494
FBgn0264715	501	500	496	6	4	1.5	495
FBgn0264716	563	500	559	67	4	16.75	496
FBgn0264717	516	500	425	107	9	11.88888888888889	409
FBgn0264719	500	500	357	143	5	28.6	357
FBgn0264720	524	500	419	129	9	14.333333333333334	395
FBgn0264721	507	500	507	7	3	2.3333333333333335	500
FBgn0264722	516	500	515	17	4	4.25	499
FBgn0264724	501	500	501	1	1	1	500
FBgn0264725	500	500	463	37	3	12.333333333333334	463
FBgn0264726	539	500	515	63	5	12.6	476
FBgn0264738	511	500	502	20	2	10	491
FBgn0264748	390	388	366	26	8	3.25	364
FBgn0264751	511	500	510	12	5	2.4	499
FBgn0264753	502	500	490	14	2	7	488
FBgn0264775	500	500	424	76	5	15.2	424
FBgn0264785	525	500	510	40	4	10	485
FBgn0264786	525	500	464	86	2	43	439
FBgn0264787	509	500	448	70	7	10	439
FBgn0264788	500	500	490	10	1	10	490
FBgn0264789	507	500	498	16	6	2.6666666666666665	491
FBgn0264790	529	500	528	30	4	7.5	499
FBgn0264791	503	500	503	3	1	3	500
FBgn0264792	500	500	472	28	5	5.6	472
FBgn0264793	509	500	467	51	9	5.666666666666667	458
FBgn0264794	501	500	495	7	2	3.5	494
FBgn0264810	519	500	506	32	4	8	487
FBgn0264815	500	500	472	28	3	9.333333333333334	472
FBgn0264816	527	500	506	48	8	6	479
FBgn0264818	512	500	509	15	2	7.5	497
FBgn0264819	500	500	490	10	3	3.3333333333333335	490
FBgn0264821	500	500	499	1	1	1	499
FBgn0264824	500	500	500	0	0	NA	500
FBgn0264825	500	500	457	43	2	21.5	457
FBgn0264828	503	500	502	4	2	2	499
FBgn0264832	528	500	525	31	4	7.75	497
FBgn0264837	507	500	497	17	5	3.4	490
FBgn0264838	500	500	499	1	1	1	499
FBgn0264839	504	500	502	6	3	2	498
FBgn0264840	511	500	501	21	5	4.2	490
FBgn0264841	505	500	493	17	5	3.4	488
FBgn0264844	510	500	488	32	4	8	478
FBgn0264848	504	500	500	8	6	1.3333333333333333	496
FBgn0264857	500	500	500	0	0	NA	500
FBgn0264863	507	500	482	32	6	5.333333333333333	475
FBgn0264864	504	500	498	10	4	2.5	494
FBgn0264865	535	500	522	48	8	6	487
FBgn0264866	523	500	475	71	9	7.888888888888889	452
FBgn0264867	509	500	508	10	5	2	499
FBgn0264868	509	500	507	11	2	5.5	498
FBgn0264869	506	500	498	14	3	4.666666666666667	492
FBgn0264870	503	500	501	5	2	2.5	498
FBgn0264871	501	500	478	24	2	12	477
FBgn0264872	511	500	497	25	6	4.166666666666667	486
FBgn0264873	522	500	506	38	5	7.6	484
FBgn0264874	500	500	476	24	4	6	476
FBgn0264875	513	500	467	59	3	19.666666666666668	454
FBgn0264876	515	500	508	22	7	3.142857142857143	493
FBgn0264878	508	500	507	9	2	4.5	499
FBgn0264880	512	500	511	13	3	4.333333333333333	499
FBgn0264883	501	500	485	17	3	5.666666666666667	484
FBgn0264884	500	500	496	4	4	1	496
FBgn0264885	500	500	469	31	7	4.428571428571429	469
FBgn0264886	504	500	432	76	7	10.857142857142858	428
FBgn0264888	524	500	509	39	3	13	485
FBgn0264889	530	500	529	31	3	10.333333333333334	499
FBgn0264890	513	500	493	33	6	5.5	480
FBgn0264891	540	500	521	59	5	11.8	481
FBgn0264892	500	500	500	0	0	NA	500
FBgn0264893	501	500	476	26	4	6.5	475
FBgn0264894	508	500	508	8	3	2.6666666666666665	500
FBgn0264896	511	500	494	28	3	9.333333333333334	483
FBgn0264897	516	500	250	282	7	40.285714285714285	234
FBgn0264898	506	500	500	12	4	3	494
FBgn0264899	557	500	551	63	4	15.75	494
FBgn0264900	517	500	458	76	5	15.2	441
FBgn0264902	501	500	486	16	4	4	485
FBgn0264903	516	500	472	60	8	7.5	456
FBgn0264904	503	500	471	35	6	5.833333333333333	468
FBgn0264905	500	500	500	0	0	NA	500
FBgn0264907	505	500	488	22	5	4.4	483
FBgn0264912	500	500	450	50	4	12.5	450
FBgn0264915	500	500	494	6	1	6	494
FBgn0264916	516	500	510	22	4	5.5	494
FBgn0264939	500	500	500	0	0	NA	500
FBgn0264940	509	500	503	15	6	2.5	494
FBgn0264941	500	500	481	19	3	6.333333333333333	481
FBgn0264942	526	500	485	67	7	9.571428571428571	459
FBgn0264943	500	500	487	13	2	6.5	487
FBgn0264944	521	500	518	24	7	3.4285714285714284	497
FBgn0264945	537	500	532	42	6	7	495
FBgn0264946	511	500	482	40	5	8	471
FBgn0264947	500	500	499	1	1	1	499
FBgn0264950	500	500	500	0	0	NA	500
FBgn0264952	500	500	500	0	0	NA	500
FBgn0264953	517	500	406	128	4	32	389
FBgn0264955	536	500	515	57	5	11.4	479
FBgn0264956	506	500	496	16	4	4	490
FBgn0264957	513	500	397	129	9	14.333333333333334	384
FBgn0264959	509	500	477	41	10	4.1	468
FBgn0264960	521	500	403	139	7	19.857142857142858	382
FBgn0264961	545	500	433	157	8	19.625	388
FBgn0264962	536	500	524	48	9	5.333333333333333	488
FBgn0264975	509	500	475	43	6	7.166666666666667	466
FBgn0264978	553	500	552	54	4	13.5	499
FBgn0264979	506	500	485	27	6	4.5	479
FBgn0264984	442	442	422	20	5	4	422
FBgn0264985	505	500	489	21	7	3	484
FBgn0264986	500	500	497	3	1	3	497
FBgn0264987	511	500	381	141	5	28.2	370
FBgn0264988	520	500	504	36	9	4	484
FBgn0264991	511	500	244	278	4	69.5	233
FBgn0264993	501	500	470	32	4	8	469
FBgn0264994	507	500	489	25	5	5	482
FBgn0264995	500	500	464	36	6	6	464
FBgn0264996	500	500	500	0	0	NA	500
FBgn0264997	509	500	509	9	1	9	500
FBgn0264998	520	500	496	44	4	11	476
FBgn0264999	503	500	451	55	6	9.166666666666666	448
FBgn0265000	510	500	489	31	7	4.428571428571429	479
FBgn0265002	500	500	469	31	6	5.166666666666667	469
FBgn0265011	520	500	513	27	5	5.4	493
FBgn0265017	500	500	485	15	2	7.5	485
FBgn0265039	507	500	507	7	1	7	500
FBgn0265042	508	500	495	21	7	3	487
FBgn0265043	500	500	500	0	0	NA	500
FBgn0265045	451	442	448	12	2	6	439
FBgn0265047	552	500	478	126	7	18	426
FBgn0265048	514	500	507	21	4	5.25	493
FBgn0265050	500	500	491	9	2	4.5	491
FBgn0265051	517	500	482	52	8	6.5	465
FBgn0265052	504	500	492	16	7	2.2857142857142856	488
FBgn0265053	512	500	509	15	4	3.75	497
FBgn0265058	532	500	530	34	5	6.8	498
FBgn0265059	512	500	490	34	4	8.5	478
FBgn0265061	502	500	443	61	9	6.777777777777778	441
FBgn0265062	511	500	511	11	2	5.5	500
FBgn0265063	526	500	503	49	8	6.125	477
FBgn0265064	500	500	499	1	1	1	499
FBgn0265066	500	500	70	430	1	430	70
FBgn0265067	500	500	497	3	1	3	497
FBgn0265068	520	500	364	176	7	25.142857142857142	344
FBgn0265069	518	500	506	30	6	5	488
FBgn0265070	501	500	498	4	3	1.3333333333333333	497
FBgn0265071	500	500	482	18	2	9	482
FBgn0265072	502	500	482	22	6	3.6666666666666665	480
FBgn0265076	515	500	491	39	5	7.8	476
FBgn0265078	524	500	522	26	7	3.7142857142857144	498
FBgn0265079	523	500	523	23	2	11.5	500
FBgn0265080	502	500	490	14	7	2	488
FBgn0265081	500	500	494	6	2	3	494
FBgn0265085	503	500	481	25	5	5	478
FBgn0265086	510	500	510	10	2	5	500
FBgn0265087	503	500	497	9	3	3	494
FBgn0265088	565	500	539	91	11	8.272727272727273	474
FBgn0265089	500	500	487	13	2	6.5	487
FBgn0265095	501	500	501	1	1	1	500
FBgn0265097	505	500	490	20	7	2.857142857142857	485
FBgn0265098	501	500	491	11	5	2.2	490
FBgn0265099	501	500	477	25	5	5	476
FBgn0265101	503	500	469	37	3	12.333333333333334	466
FBgn0265102	502	500	490	14	7	2	488
FBgn0265103	500	500	493	7	5	1.4	493
FBgn0265104	500	500	494	6	1	6	494
FBgn0265105	502	500	502	2	1	2	500
FBgn0265106	511	500	490	32	4	8	479
FBgn0265107	522	500	520	24	4	6	498
FBgn0265137	507	500	456	58	7	8.285714285714286	449
FBgn0265139	500	500	486	14	2	7	486
FBgn0265141	450	416	445	39	6	6.5	411
FBgn0265142	506	500	498	14	2	7	492
FBgn0265143	506	500	506	6	1	6	500
FBgn0265144	486	469	460	43	5	8.6	443
FBgn0265145	524	500	520	28	7	4	496
FBgn0265147	514	500	499	29	3	9.666666666666666	485
FBgn0265148	505	500	473	37	5	7.4	468
FBgn0265149	502	500	500	4	2	2	498
FBgn0265150	500	500	375	125	2	62.5	375
FBgn0265151	501	500	285	217	2	108.5	284
FBgn0265152	503	500	503	3	1	3	500
FBgn0265153	514	500	513	15	4	3.75	499
FBgn0265155	513	500	442	84	6	14	429
FBgn0265156	504	500	501	7	3	2.3333333333333335	497
FBgn0265157	505	500	499	11	5	2.2	494
FBgn0265160	527	500	526	28	3	9.333333333333334	499
FBgn0265161	511	500	475	47	7	6.714285714285714	464
FBgn0265162	521	500	513	29	8	3.625	492
FBgn0265163	506	500	505	7	2	3.5	499
FBgn0265165	503	500	483	23	4	5.75	480
FBgn0265166	500	500	500	0	0	NA	500
FBgn0265167	501	500	480	22	4	5.5	479
FBgn0265169	500	500	479	21	5	4.2	479
FBgn0265174	500	500	499	1	1	1	499
FBgn0265177	509	500	506	12	3	4	497
FBgn0265182	530	500	521	39	4	9.75	491
FBgn0265187	500	500	491	9	3	3	491
FBgn0265192	500	500	491	9	4	2.25	491
FBgn0265193	516	500	505	27	4	6.75	489
FBgn0265196	504	500	488	20	4	5	484
FBgn0265197	500	500	486	14	3	4.666666666666667	486
FBgn0265198	518	500	513	23	6	3.8333333333333335	495
FBgn0265200	505	500	505	5	2	2.5	500
FBgn0265201	495	483	448	59	7	8.428571428571429	436
FBgn0265202	508	500	508	8	2	4	500
FBgn0265203	513	500	485	41	9	4.555555555555555	472
FBgn0265204	511	500	506	16	5	3.2	495
FBgn0265205	500	500	430	70	4	17.5	430
FBgn0265253	529	500	509	49	8	6.125	480
FBgn0265255	507	500	507	7	2	3.5	500
FBgn0265256	500	500	490	10	5	2	490
FBgn0265257	502	500	485	19	5	3.8	483
FBgn0265262	534	500	534	34	6	5.666666666666667	500
FBgn0265263	398	381	337	78	5	15.6	320
FBgn0265264	500	500	309	191	5	38.2	309
FBgn0265265	502	500	428	76	5	15.2	426
FBgn0265266	509	500	499	19	6	3.1666666666666665	490
FBgn0265267	502	500	500	4	3	1.3333333333333333	498
FBgn0265268	530	500	474	86	8	10.75	444
FBgn0265269	516	500	497	35	3	11.666666666666666	481
FBgn0265270	503	500	474	32	9	3.5555555555555554	471
FBgn0265271	500	500	452	48	4	12	452
FBgn0265274	504	500	477	31	4	7.75	473
FBgn0265276	518	500	497	39	4	9.75	479
FBgn0265295	501	500	491	11	5	2.2	490
FBgn0265296	523	500	517	29	3	9.666666666666666	494
FBgn0265297	514	500	508	20	5	4	494
FBgn0265298	500	500	496	4	2	2	496
FBgn0265299	506	500	502	10	5	2	496
FBgn0265300	507	500	229	285	4	71.25	222
FBgn0265301	536	500	533	39	3	13	497
FBgn0265302	500	500	487	13	4	3.25	487
FBgn0265304	508	500	501	15	4	3.75	493
FBgn0265305	533	500	526	40	7	5.714285714285714	493
FBgn0265306	523	500	492	54	6	9	469
FBgn0265308	503	500	463	43	6	7.166666666666667	460
FBgn0265309	554	500	549	59	9	6.555555555555555	495
FBgn0265310	527	500	525	29	3	9.666666666666666	498
FBgn0265311	505	500	423	87	6	14.5	418
FBgn0265312	513	500	504	22	5	4.4	491
FBgn0265314	500	500	498	2	1	2	498
FBgn0265315	508	500	504	12	4	3	496
FBgn0265316	523	500	521	25	6	4.166666666666667	498
FBgn0265317	513	500	489	37	7	5.285714285714286	476
FBgn0265318	516	500	509	23	6	3.8333333333333335	493
FBgn0265338	510	500	503	17	3	5.666666666666667	493
FBgn0265339	510	500	503	17	3	5.666666666666667	493
FBgn0265340	500	500	500	0	0	NA	500
FBgn0265341	500	500	467	33	3	11	467
FBgn0265342	401	388	353	61	8	7.625	340
FBgn0265344	518	500	221	315	4	78.75	203
FBgn0265345	501	500	501	1	1	1	500
FBgn0265348	524	500	470	78	16	4.875	446
FBgn0265349	524	500	478	70	9	7.777777777777778	454
FBgn0265351	547	500	503	91	8	11.375	456
FBgn0265356	511	500	511	11	1	11	500
FBgn0265363	511	500	509	13	2	6.5	498
FBgn0265364	500	500	476	24	5	4.8	476
FBgn0265365	518	500	489	47	6	7.833333333333333	471
FBgn0265366	502	500	245	259	3	86.33333333333333	243
FBgn0265367	500	500	498	2	2	1	498
FBgn0265368	508	500	450	66	2	33	442
FBgn0265369	515	500	464	66	6	11	449
FBgn0265370	482	482	465	17	2	8.5	465
FBgn0265371	587	500	581	93	9	10.333333333333334	494
FBgn0265372	531	500	511	51	8	6.375	480
FBgn0265373	519	500	485	53	10	5.3	466
FBgn0265374	506	500	497	15	7	2.142857142857143	491
FBgn0265375	508	500	501	15	4	3.75	493
FBgn0265376	541	500	490	92	13	7.076923076923077	449
FBgn0265379	500	500	494	6	1	6	494
FBgn0265380	516	500	486	46	5	9.2	470
FBgn0265381	505	500	489	21	4	5.25	484
FBgn0265382	516	500	490	42	6	7	474
FBgn0265413	453	447	438	21	7	3	432
FBgn0265414	553	500	527	79	8	9.875	474
FBgn0265416	537	500	513	61	10	6.1	476
FBgn0265419	505	500	490	20	3	6.666666666666667	485
FBgn0265422	500	500	448	52	3	17.333333333333332	448
FBgn0265423	517	500	455	79	6	13.166666666666666	438
FBgn0265424	514	500	207	321	2	160.5	193
FBgn0265425	506	500	501	11	3	3.6666666666666665	495
FBgn0265426	567	500	543	91	8	11.375	476
FBgn0265427	567	500	553	81	5	16.2	486
FBgn0265428	502	500	494	10	4	2.5	492
FBgn0265429	501	500	497	5	3	1.6666666666666667	496
FBgn0265443	568	500	547	89	11	8.090909090909092	479
FBgn0265444	500	500	476	24	2	12	476
FBgn0265445	503	500	450	56	7	8	447
FBgn0265446	533	500	503	63	10	6.3	470
FBgn0265448	525	500	515	35	8	4.375	490
FBgn0265449	518	500	439	97	8	12.125	421
FBgn0265451	500	500	500	0	0	NA	500
FBgn0265454	510	500	487	33	6	5.5	477
FBgn0265455	506	500	482	30	5	6	476
FBgn0265458	500	500	496	4	1	4	496
FBgn0265464	503	500	500	6	3	2	497
FBgn0265468	514	500	503	25	9	2.7777777777777777	489
FBgn0265469	543	500	509	77	7	11	466
FBgn0265470	512	500	507	17	4	4.25	495
FBgn0265487	502	500	502	2	1	2	500
FBgn0265496	561	500	549	73	9	8.11111111111111	488
FBgn0265497	498	490	447	59	4	14.75	439
FBgn0265498	507	500	460	54	6	9	453
FBgn0265499	502	500	483	21	5	4.2	481
FBgn0265500	500	500	499	1	1	1	499
FBgn0265508	514	500	512	16	4	4	498
FBgn0265509	500	500	499	1	1	1	499
FBgn0265510	525	500	518	32	7	4.571428571428571	493
FBgn0265511	505	500	501	9	6	1.5	496
FBgn0265523	520	500	461	79	10	7.9	441
FBgn0265524	529	500	521	37	6	6.166666666666667	492
FBgn0265525	522	500	496	48	8	6	474
FBgn0265526	503	500	498	8	4	2	495
FBgn0265527	513	500	510	16	5	3.2	497
FBgn0265529	503	500	502	4	3	1.3333333333333333	499
FBgn0265530	500	500	489	11	5	2.2	489
FBgn0265531	511	500	507	15	5	3	496
FBgn0265532	500	500	487	13	2	6.5	487
FBgn0265534	528	500	503	53	6	8.833333333333334	475
FBgn0265537	500	500	494	6	1	6	494
FBgn0265538	505	500	118	392	2	196	113
FBgn0265539	515	500	490	40	4	10	475
FBgn0265540	519	500	517	21	5	4.2	498
FBgn0265543	502	500	492	12	3	4	490
FBgn0265544	525	500	358	192	6	32	333
FBgn0265545	518	500	508	28	11	2.5454545454545454	490
FBgn0265549	501	500	469	33	5	6.6	468
FBgn0265550	505	500	505	5	2	2.5	500
FBgn0265551	537	500	528	46	7	6.571428571428571	491
FBgn0265574	500	500	489	11	3	3.6666666666666665	489
FBgn0265575	503	500	473	33	6	5.5	470
FBgn0265577	513	500	436	90	9	10	423
FBgn0265578	506	500	499	13	4	3.25	493
FBgn0265579	513	500	498	28	4	7	485
FBgn0265580	512	500	510	14	3	4.666666666666667	498
FBgn0265582	523	500	414	132	6	22	391
FBgn0265583	501	500	485	17	3	5.666666666666667	484
FBgn0265584	501	500	478	24	3	8	477
FBgn0265585	501	500	450	52	4	13	449
FBgn0265588	511	500	510	12	3	4	499
FBgn0265589	500	500	497	3	1	3	497
FBgn0265590	500	500	483	17	3	5.666666666666667	483
FBgn0265591	516	500	509	23	2	11.5	493
FBgn0265592	506	500	489	23	6	3.8333333333333335	483
FBgn0265593	502	500	455	49	4	12.25	453
FBgn0265594	508	500	492	24	4	6	484
FBgn0265595	515	500	499	31	5	6.2	484
FBgn0265596	523	500	492	54	10	5.4	469
FBgn0265597	512	500	492	32	4	8	480
FBgn0265605	503	500	486	20	7	2.857142857142857	483
FBgn0265606	501	500	497	5	3	1.6666666666666667	496
FBgn0265608	514	500	511	17	3	5.666666666666667	497
FBgn0265609	505	500	454	56	4	14	449
FBgn0265611	588	500	566	110	12	9.166666666666666	478
FBgn0265612	511	500	494	28	5	5.6	483
FBgn0265613	545	500	452	138	9	15.333333333333334	407
FBgn0265614	527	500	488	66	9	7.333333333333333	461
FBgn0265623	500	500	500	0	0	NA	500
FBgn0265625	516	500	498	34	6	5.666666666666667	482
FBgn0265630	503	500	502	4	2	2	499
FBgn0265631	503	500	495	11	4	2.75	492
FBgn0265632	517	500	510	24	5	4.8	493
FBgn0265635	510	500	501	19	4	4.75	491
FBgn0265636	523	500	522	24	4	6	499
FBgn0265637	503	500	393	113	2	56.5	390
FBgn0265638	512	500	511	13	2	6.5	499
FBgn0265639	529	500	478	80	8	10	449
FBgn0265640	504	500	416	92	5	18.4	412
FBgn0265641	518	500	494	42	9	4.666666666666667	476
FBgn0265642	503	500	494	12	5	2.4	491
FBgn0265643	507	500	499	15	5	3	492
FBgn0265644	350	350	321	29	1	29	321
FBgn0265645	504	500	492	16	8	2	488
FBgn0265646	502	500	496	8	4	2	494
FBgn0265648	500	500	490	10	3	3.3333333333333335	490
FBgn0265649	506	500	485	27	3	9	479
FBgn0265651	505	500	443	67	6	11.166666666666666	438
FBgn0265657	500	500	449	51	4	12.75	449
FBgn0265658	508	500	498	18	3	6	490
FBgn0265659	500	500	169	331	3	110.33333333333333	169
FBgn0265660	501	500	489	13	3	4.333333333333333	488
FBgn0265661	502	500	485	19	6	3.1666666666666665	483
FBgn0265662	505	500	480	30	7	4.285714285714286	475
FBgn0265663	500	500	472	28	4	7	472
FBgn0265664	512	500	405	119	9	13.222222222222221	393
FBgn0265665	506	500	488	24	4	6	482
FBgn0265666	532	500	527	37	4	9.25	495
FBgn0265670	501	500	487	15	3	5	486
FBgn0265671	500	500	472	28	6	4.666666666666667	472
FBgn0265672	526	500	522	30	5	6	496
FBgn0265673	506	500	497	15	3	5	491
FBgn0265674	508	500	499	17	4	4.25	491
FBgn0265675	500	500	474	26	2	13	474
FBgn0265676	505	500	189	321	2	160.5	184
FBgn0265677	505	500	499	11	4	2.75	494
FBgn0265678	500	500	482	18	2	9	482
FBgn0265679	501	500	493	9	3	3	492
FBgn0265680	514	500	500	28	4	7	486
FBgn0265681	502	500	486	18	7	2.5714285714285716	484
FBgn0265682	534	500	534	34	4	8.5	500
FBgn0265683	503	500	453	53	10	5.3	450
FBgn0265684	547	500	523	71	7	10.142857142857142	476
FBgn0265687	503	500	501	5	4	1.25	498
FBgn0265688	515	500	460	70	8	8.75	445
FBgn0265690	500	500	486	14	3	4.666666666666667	486
FBgn0265691	508	500	471	45	5	9	463
FBgn0265692	500	500	494	6	1	6	494
FBgn0265693	500	500	438	62	3	20.666666666666668	438
FBgn0265694	501	500	495	7	2	3.5	494
FBgn0265695	505	500	449	61	3	20.333333333333332	444
FBgn0265696	500	500	412	88	2	44	412
FBgn0265697	528	500	484	72	3	24	456
FBgn0265699	500	500	500	0	0	NA	500
FBgn0265700	537	500	518	56	6	9.333333333333334	481
FBgn0265701	528	500	482	74	8	9.25	454
FBgn0265702	514	500	503	25	8	3.125	489
FBgn0265704	530	500	525	35	5	7	495
FBgn0265705	512	500	490	34	6	5.666666666666667	478
FBgn0265706	514	500	501	27	6	4.5	487
FBgn0265707	505	500	503	7	4	1.75	498
FBgn0265708	503	500	496	10	5	2	493
FBgn0265710	562	500	524	100	7	14.285714285714286	462
FBgn0265711	501	500	330	172	5	34.4	329
FBgn0265712	503	500	482	24	6	4	479
FBgn0265713	507	500	432	82	3	27.333333333333332	425
FBgn0265715	512	500	496	28	7	4	484
FBgn0265716	500	500	491	9	3	3	491
FBgn0265717	473	440	461	45	7	6.428571428571429	428
FBgn0265718	503	500	501	5	3	1.6666666666666667	498
FBgn0265719	515	500	356	174	3	58	341
FBgn0265720	515	500	507	23	5	4.6	492
FBgn0265721	501	500	475	27	4	6.75	474
FBgn0265722	511	500	496	26	7	3.7142857142857144	485
FBgn0265723	504	500	464	44	3	14.666666666666666	460
FBgn0265724	500	500	499	1	1	1	499
FBgn0265725	509	500	505	13	2	6.5	496
FBgn0265726	554	500	512	96	10	9.6	458
FBgn0265727	503	500	380	126	8	15.75	377
FBgn0265728	515	500	503	27	5	5.4	488
FBgn0265729	505	500	500	10	2	5	495
FBgn0265730	500	500	451	49	1	49	451
FBgn0265731	527	500	499	55	8	6.875	472
FBgn0265732	500	500	496	4	1	4	496
FBgn0265733	516	500	465	67	6	11.166666666666666	449
FBgn0265735	512	500	500	24	4	6	488
FBgn0265736	505	500	485	25	6	4.166666666666667	480
FBgn0265737	517	500	515	19	3	6.333333333333333	498
FBgn0265738	502	500	498	6	2	3	496
FBgn0265739	500	500	496	4	2	2	496
FBgn0265740	524	500	456	92	7	13.142857142857142	432
FBgn0265741	514	500	510	18	2	9	496
FBgn0265742	500	500	498	2	2	1	498
FBgn0265743	549	500	528	70	10	7	479
FBgn0265744	516	500	501	31	5	6.2	485
FBgn0265745	501	500	484	18	3	6	483
FBgn0265746	523	500	507	39	6	6.5	484
FBgn0265747	517	500	515	19	5	3.8	498
FBgn0265749	509	500	498	20	3	6.666666666666667	489
FBgn0265751	512	500	494	30	3	10	482
FBgn0265752	501	500	497	5	2	2.5	496
FBgn0265753	517	500	474	60	6	10	457
FBgn0265754	518	500	516	20	6	3.3333333333333335	498
FBgn0265755	503	500	494	12	4	3	491
FBgn0265756	500	500	485	15	2	7.5	485
FBgn0265758	506	500	433	79	6	13.166666666666666	427
FBgn0265759	541	500	527	55	7	7.857142857142857	486
FBgn0265760	507	500	467	47	8	5.875	460
FBgn0265761	507	500	332	182	5	36.4	325
FBgn0265762	506	500	491	21	5	4.2	485
FBgn0265763	502	500	493	11	4	2.75	491
FBgn0265764	500	500	489	11	1	11	489
FBgn0265765	508	500	506	10	4	2.5	498
FBgn0265766	500	500	476	24	1	24	476
FBgn0265778	500	500	465	35	6	5.833333333333333	465
FBgn0265784	501	500	474	28	3	9.333333333333334	473
FBgn0265785	510	500	505	15	2	7.5	495
FBgn0265786	505	500	485	25	2	12.5	480
FBgn0265788	506	500	500	12	7	1.7142857142857142	494
FBgn0265789	500	500	483	17	2	8.5	483
FBgn0265790	514	500	511	17	5	3.4	497
FBgn0265791	501	500	491	11	3	3.6666666666666665	490
FBgn0265792	531	500	443	119	4	29.75	412
FBgn0265794	500	500	460	40	5	8	460
FBgn0265795	523	500	503	43	7	6.142857142857143	480
FBgn0265796	500	500	472	28	4	7	472
FBgn0265797	511	500	479	43	9	4.777777777777778	468
FBgn0265798	519	500	491	47	8	5.875	472
FBgn0265799	511	500	477	45	8	5.625	466
FBgn0265800	503	500	503	3	3	1	500
FBgn0265801	510	500	505	15	5	3	495
FBgn0265802	502	500	407	97	7	13.857142857142858	405
FBgn0265803	506	500	488	24	5	4.8	482
FBgn0265805	503	500	495	11	5	2.2	492
FBgn0265807	500	500	442	58	2	29	442
FBgn0265808	560	500	544	76	10	7.6	484
FBgn0265810	564	500	558	70	8	8.75	494
FBgn0265811	503	500	491	15	4	3.75	488
FBgn0265812	505	500	499	11	4	2.75	494
FBgn0265813	508	500	502	14	6	2.3333333333333335	494
FBgn0265814	500	500	472	28	4	7	472
FBgn0265815	506	500	471	41	4	10.25	465
FBgn0265817	508	500	508	8	1	8	500
FBgn0265818	521	500	518	24	5	4.8	497
FBgn0265819	508	500	505	11	5	2.2	497
FBgn0265820	523	500	520	26	5	5.2	497
FBgn0265821	500	500	482	18	5	3.6	482
FBgn0265823	500	500	439	61	7	8.714285714285714	439
FBgn0265824	500	500	494	6	4	1.5	494
FBgn0265826	500	500	483	17	2	8.5	483
FBgn0265827	503	500	478	28	4	7	475
FBgn0265828	506	500	504	8	2	4	498
FBgn0265829	511	500	506	16	6	2.6666666666666665	495
FBgn0265831	552	500	544	60	9	6.666666666666667	492
FBgn0265832	551	500	528	74	11	6.7272727272727275	477
FBgn0265833	515	500	503	27	8	3.375	488
FBgn0265834	505	500	503	7	2	3.5	498
FBgn0265837	532	500	527	37	6	6.166666666666667	495
FBgn0265838	500	500	498	2	1	2	498
FBgn0265839	500	500	475	25	2	12.5	475
FBgn0265840	500	500	495	5	1	5	495
FBgn0265841	509	500	495	23	3	7.666666666666667	486
FBgn0265842	500	500	403	97	2	48.5	403
FBgn0265843	505	500	463	47	7	6.714285714285714	458
FBgn0265844	500	500	493	7	1	7	493
FBgn0265845	502	500	501	3	2	1.5	499
FBgn0265846	502	500	488	16	5	3.2	486
FBgn0265849	508	500	508	8	2	4	500
FBgn0265850	500	500	494	6	3	2	494
FBgn0265851	509	500	418	100	8	12.5	409
FBgn0265853	504	500	493	15	6	2.5	489
FBgn0265854	501	500	495	7	3	2.3333333333333335	494
FBgn0265855	500	500	494	6	3	2	494
FBgn0265856	474	465	473	10	3	3.3333333333333335	464
FBgn0265857	502	500	480	24	5	4.8	478
FBgn0265858	508	500	492	24	6	4	484
FBgn0265859	513	500	490	36	6	6	477
FBgn0265861	506	500	452	60	5	12	446
FBgn0265862	513	500	495	31	6	5.166666666666667	482
FBgn0265863	516	500	469	63	7	9	453
FBgn0265864	512	500	511	13	2	6.5	499
FBgn0265865	509	500	432	86	8	10.75	423
FBgn0265866	503	500	488	18	5	3.6	485
FBgn0265869	503	500	421	85	6	14.166666666666666	418
FBgn0265870	520	500	514	26	4	6.5	494
FBgn0265872	500	500	455	45	5	9	455
FBgn0265873	506	500	498	14	5	2.8	492
FBgn0265874	501	500	451	51	5	10.2	450
FBgn0265875	503	500	426	80	5	16	423
FBgn0265876	500	500	482	18	1	18	482
FBgn0265878	502	500	482	22	5	4.4	480
FBgn0265879	502	500	473	31	4	7.75	471
FBgn0265880	506	500	484	28	5	5.6	478
FBgn0265881	454	400	404	104	10	10.4	350
FBgn0265882	502	500	468	36	4	9	466
FBgn0265883	504	500	456	52	7	7.428571428571429	452
FBgn0265884	500	500	417	83	3	27.666666666666668	417
FBgn0265885	501	500	471	31	4	7.75	470
FBgn0265886	500	500	450	50	2	25	450
FBgn0265887	556	500	553	59	6	9.833333333333334	497
FBgn0265889	549	500	539	59	9	6.555555555555555	490
FBgn0265890	500	500	475	25	4	6.25	475
FBgn0265891	553	500	536	70	6	11.666666666666666	483
FBgn0265892	516	500	500	32	7	4.571428571428571	484
FBgn0265893	504	500	503	5	2	2.5	499
FBgn0265894	503	500	432	74	6	12.333333333333334	429
FBgn0265895	507	500	504	10	3	3.3333333333333335	497
FBgn0265897	529	500	520	38	8	4.75	491
FBgn0265898	504	500	493	15	6	2.5	489
FBgn0265900	513	500	486	40	2	20	473
FBgn0265901	503	500	497	9	5	1.8	494
FBgn0265902	509	500	508	10	3	3.3333333333333335	499
FBgn0265903	503	500	503	3	3	1	500
FBgn0265904	504	500	476	32	6	5.333333333333333	472
FBgn0265905	504	500	460	48	3	16	456
FBgn0265908	502	500	496	8	3	2.6666666666666665	494
FBgn0265909	366	363	352	17	4	4.25	349
FBgn0265910	515	493	491	46	8	5.75	469
FBgn0265911	513	500	506	20	5	4	493
FBgn0265912	526	500	496	56	10	5.6	470
FBgn0265913	501	500	492	10	4	2.5	491
FBgn0265914	511	500	438	84	5	16.8	427
FBgn0265915	500	500	486	14	2	7	486
FBgn0265916	508	500	493	23	3	7.666666666666667	485
FBgn0265917	514	500	491	37	5	7.4	477
FBgn0265918	504	500	473	35	5	7	469
FBgn0265919	503	500	426	80	7	11.428571428571429	423
FBgn0265921	527	500	527	27	2	13.5	500
FBgn0265922	517	500	451	83	11	7.545454545454546	434
FBgn0265924	544	500	511	77	8	9.625	467
FBgn0265926	503	500	485	21	6	3.5	482
FBgn0265927	535	500	488	82	11	7.454545454545454	453
FBgn0265928	510	500	484	36	4	9	474
FBgn0265930	512	500	487	37	5	7.4	475
FBgn0265931	529	500	512	46	13	3.5384615384615383	483
FBgn0265932	500	475	436	89	8	11.125	411
FBgn0265933	529	500	517	41	6	6.833333333333333	488
FBgn0265934	549	500	523	75	9	8.333333333333334	474
FBgn0265935	388	356	386	34	5	6.8	354
FBgn0265937	513	500	507	19	3	6.333333333333333	494
FBgn0265938	531	500	528	34	5	6.8	497
FBgn0265939	502	500	491	13	6	2.1666666666666665	489
FBgn0265940	512	500	498	26	7	3.7142857142857144	486
FBgn0265942	505	500	496	14	4	3.5	491
FBgn0265943	500	500	491	9	2	4.5	491
FBgn0265944	509	500	504	14	5	2.8	495
FBgn0265945	512	500	506	18	4	4.5	494
FBgn0265946	503	500	499	7	3	2.3333333333333335	496
FBgn0265947	513	500	511	15	3	5	498
FBgn0265948	530	500	529	31	3	10.333333333333334	499
FBgn0265949	500	500	493	7	2	3.5	493
FBgn0265950	516	500	510	22	3	7.333333333333333	494
FBgn0265951	527	500	512	42	9	4.666666666666667	485
FBgn0265952	503	500	481	25	5	5	478
FBgn0265953	552	500	462	142	9	15.777777777777779	410
FBgn0265954	509	500	492	26	4	6.5	483
FBgn0265955	529	500	520	38	6	6.333333333333333	491
FBgn0265956	503	500	481	25	4	6.25	478
FBgn0265957	503	500	473	33	7	4.714285714285714	470
FBgn0265958	511	500	485	37	3	12.333333333333334	474
FBgn0265959	504	500	504	4	2	2	500
FBgn0265960	500	500	492	8	1	8	492
FBgn0265961	513	500	513	13	2	6.5	500
FBgn0265962	511	500	463	59	9	6.555555555555555	452
FBgn0265963	504	500	492	16	4	4	488
FBgn0265964	505	500	499	11	7	1.5714285714285714	494
FBgn0265965	509	500	491	27	4	6.75	482
FBgn0265967	500	500	499	1	1	1	499
FBgn0265974	500	500	498	2	2	1	498
FBgn0265976	500	500	499	1	1	1	499
FBgn0265977	508	500	502	14	3	4.666666666666667	494
FBgn0265979	500	500	488	12	2	6	488
FBgn0265980	500	500	499	1	1	1	499
FBgn0265981	500	500	498	2	1	2	498
FBgn0265982	563	500	548	78	6	13	485
FBgn0265983	500	500	500	0	0	NA	500
FBgn0265986	508	500	457	59	9	6.555555555555555	449
FBgn0265991	500	500	494	6	1	6	494
FBgn0265992	507	500	507	7	4	1.75	500
FBgn0265993	500	500	497	3	2	1.5	497
FBgn0265994	500	500	484	16	2	8	484
FBgn0265995	519	500	519	19	3	6.333333333333333	500
FBgn0265996	519	500	517	21	4	5.25	498
FBgn0265997	533	500	529	37	5	7.4	496
FBgn0265998	509	500	509	9	1	9	500
FBgn0266000	502	500	488	16	5	3.2	486
FBgn0266001	503	500	400	106	4	26.5	397
FBgn0266002	501	500	482	20	3	6.666666666666667	481
FBgn0266003	520	500	504	36	8	4.5	484
FBgn0266004	520	500	508	32	6	5.333333333333333	488
FBgn0266005	411	403	411	8	2	4	403
FBgn0266007	521	500	472	70	7	10	451
FBgn0266008	500	500	491	9	2	4.5	491
FBgn0266009	504	500	476	32	2	16	472
FBgn0266010	538	500	520	56	9	6.222222222222222	482
FBgn0266011	503	500	500	6	3	2	497
FBgn0266019	502	500	462	42	6	7	460
FBgn0266020	511	500	448	74	4	18.5	437
FBgn0266021	502	500	487	17	5	3.4	485
FBgn0266022	503	500	476	30	4	7.5	473
FBgn0266023	501	500	499	3	2	1.5	498
FBgn0266024	506	500	494	18	5	3.6	488
FBgn0266025	534	500	499	69	8	8.625	465
FBgn0266026	502	500	501	3	2	1.5	499
FBgn0266027	508	500	489	27	5	5.4	481
FBgn0266028	500	500	500	0	0	NA	500
FBgn0266029	502	500	433	71	5	14.2	431
FBgn0266030	501	500	463	39	5	7.8	462
FBgn0266032	528	500	524	32	6	5.333333333333333	496
FBgn0266033	500	500	495	5	2	2.5	495
FBgn0266034	520	500	500	40	11	3.6363636363636362	480
FBgn0266035	353	342	348	16	4	4	337
FBgn0266036	512	500	512	12	1	12	500
FBgn0266037	503	500	503	3	1	3	500
FBgn0266039	522	500	477	67	4	16.75	455
FBgn0266040	504	500	471	37	7	5.285714285714286	467
FBgn0266041	500	500	497	3	2	1.5	497
FBgn0266042	502	500	485	19	4	4.75	483
FBgn0266043	542	500	539	45	4	11.25	497
FBgn0266045	513	500	511	15	6	2.5	498
FBgn0266046	500	500	495	5	1	5	495
FBgn0266048	502	500	496	8	2	4	494
FBgn0266049	504	500	486	22	7	3.142857142857143	482
FBgn0266051	504	500	474	34	7	4.857142857142857	470
FBgn0266053	520	500	484	56	8	7	464
FBgn0266064	503	500	475	31	6	5.166666666666667	472
FBgn0266065	567	500	565	69	6	11.5	498
FBgn0266066	508	500	498	18	4	4.5	490
FBgn0266067	505	500	505	5	2	2.5	500
FBgn0266068	500	500	492	8	4	2	492
FBgn0266070	524	500	502	46	5	9.2	478
FBgn0266071	500	500	483	17	1	17	483
FBgn0266072	500	500	490	10	3	3.3333333333333335	490
FBgn0266073	500	500	426	74	5	14.8	426
FBgn0266074	514	500	509	19	6	3.1666666666666665	495
FBgn0266083	517	500	515	19	5	3.8	498
FBgn0266084	518	500	491	45	6	7.5	473
FBgn0266086	510	500	510	10	1	10	500
FBgn0266087	500	500	500	0	0	NA	500
FBgn0266088	501	500	482	20	2	10	481
FBgn0266094	534	500	448	120	10	12	414
FBgn0266095	500	500	500	0	0	NA	500
FBgn0266096	533	500	529	37	8	4.625	496
FBgn0266097	528	500	498	58	6	9.666666666666666	470
FBgn0266099	514	500	512	16	3	5.333333333333333	498
FBgn0266100	527	500	486	68	9	7.555555555555555	459
FBgn0266111	530	500	522	38	4	9.5	492
FBgn0266115	523	500	512	34	3	11.333333333333334	489
FBgn0266124	500	500	461	39	4	9.75	461
FBgn0266137	508	500	505	11	3	3.6666666666666665	497
FBgn0266139	501	500	501	1	1	1	500
FBgn0266141	500	500	498	2	1	2	498
FBgn0266142	508	500	487	29	3	9.666666666666666	479
FBgn0266143	391	385	387	10	3	3.3333333333333335	381
FBgn0266144	501	500	429	73	3	24.333333333333332	428
FBgn0266145	502	500	492	12	5	2.4	490
FBgn0266146	500	500	500	0	0	NA	500
FBgn0266147	509	500	502	16	4	4	493
FBgn0266148	500	500	497	3	1	3	497
FBgn0266149	512	500	512	12	1	12	500
FBgn0266150	503	500	488	18	5	3.6	485
FBgn0266151	501	500	438	64	3	21.333333333333332	437
FBgn0266153	534	500	514	54	9	6	480
FBgn0266155	501	500	438	64	2	32	437
FBgn0266156	512	500	495	29	3	9.666666666666666	483
FBgn0266157	507	500	496	18	3	6	489
FBgn0266158	500	500	491	9	2	4.5	491
FBgn0266159	515	500	453	77	7	11	438
FBgn0266160	525	500	525	25	4	6.25	500
FBgn0266161	506	500	496	16	3	5.333333333333333	490
FBgn0266162	529	495	509	54	11	4.909090909090909	475
FBgn0266163	508	500	507	9	2	4.5	499
FBgn0266164	501	500	490	12	4	3	489
FBgn0266165	503	500	496	10	4	2.5	493
FBgn0266166	502	500	477	27	10	2.7	475
FBgn0266167	548	500	542	54	6	9	494
FBgn0266168	474	463	351	134	9	14.88888888888889	340
FBgn0266169	502	500	461	43	7	6.142857142857143	459
FBgn0266179	530	500	530	30	4	7.5	500
FBgn0266180	505	500	439	71	7	10.142857142857142	434
FBgn0266181	474	474	473	1	1	1	473
FBgn0266182	510	500	497	23	5	4.6	487
FBgn0266183	507	500	504	10	3	3.3333333333333335	497
FBgn0266186	501	500	468	34	5	6.8	467
FBgn0266196	513	500	487	39	4	9.75	474
FBgn0266197	515	500	510	20	4	5	495
FBgn0266198	522	500	505	39	6	6.5	483
FBgn0266201	500	500	494	6	1	6	494
FBgn0266202	500	500	490	10	3	3.3333333333333335	490
FBgn0266204	513	500	500	26	4	6.5	487
FBgn0266207	511	500	510	12	4	3	499
FBgn0266208	500	500	499	1	1	1	499
FBgn0266209	512	500	512	12	2	6	500
FBgn0266210	500	500	492	8	3	2.6666666666666665	492
FBgn0266211	509	500	378	140	4	35	369
FBgn0266212	518	500	512	24	5	4.8	494
FBgn0266214	531	500	446	116	8	14.5	415
FBgn0266215	511	500	510	12	2	6	499
FBgn0266216	502	500	498	6	4	1.5	496
FBgn0266217	510	500	497	23	5	4.6	487
FBgn0266218	542	500	517	67	6	11.166666666666666	475
FBgn0266220	504	500	504	4	3	1.3333333333333333	500
FBgn0266221	500	500	474	26	2	13	474
FBgn0266222	501	500	140	362	4	90.5	139
FBgn0266223	509	500	502	16	4	4	493
FBgn0266225	502	500	487	17	4	4.25	485
FBgn0266226	501	500	494	8	2	4	493
FBgn0266228	552	500	514	90	9	10	462
FBgn0266229	502	500	475	29	4	7.25	473
FBgn0266230	509	500	508	10	3	3.3333333333333335	499
FBgn0266231	502	500	500	4	2	2	498
FBgn0266232	525	500	485	65	8	8.125	460
FBgn0266233	502	500	502	2	2	1	500
FBgn0266234	511	500	511	11	1	11	500
FBgn0266235	509	500	465	53	5	10.6	456
FBgn0266236	500	500	500	0	0	NA	500
FBgn0266237	501	500	493	9	5	1.8	492
FBgn0266238	500	500	489	11	3	3.6666666666666665	489
FBgn0266239	589	500	588	90	6	15	499
FBgn0266240	543	500	529	57	6	9.5	486
FBgn0266241	535	500	534	36	4	9	499
FBgn0266242	507	500	497	17	8	2.125	490
FBgn0266243	513	500	495	31	6	5.166666666666667	482
FBgn0266244	516	500	511	21	4	5.25	495
FBgn0266245	518	500	487	49	6	8.166666666666666	469
FBgn0266247	534	500	534	34	5	6.8	500
FBgn0266248	507	500	450	64	6	10.666666666666666	443
FBgn0266250	506	500	487	25	4	6.25	481
FBgn0266251	503	500	498	8	3	2.6666666666666665	495
FBgn0266252	500	500	498	2	2	1	498
FBgn0266254	500	500	499	1	1	1	499
FBgn0266255	523	500	509	37	3	12.333333333333334	486
FBgn0266256	500	500	491	9	2	4.5	491
FBgn0266257	504	500	498	10	4	2.5	494
FBgn0266259	523	500	523	23	2	11.5	500
FBgn0266260	526	500	522	30	4	7.5	496
FBgn0266263	500	500	314	186	4	46.5	314
FBgn0266264	500	500	500	0	0	NA	500
FBgn0266268	527	500	523	31	4	7.75	496
FBgn0266275	446	427	441	24	3	8	422
FBgn0266276	520	500	516	24	3	8	496
FBgn0266278	501	500	441	61	6	10.166666666666666	440
FBgn0266279	518	500	440	96	10	9.6	422
FBgn0266280	516	500	503	29	4	7.25	487
FBgn0266281	503	500	478	28	2	14	475
FBgn0266282	525	500	519	31	8	3.875	494
FBgn0266302	504	500	480	28	5	5.6	476
FBgn0266303	501	500	501	1	1	1	500
FBgn0266305	546	500	539	53	7	7.571428571428571	493
FBgn0266307	501	500	461	41	3	13.666666666666666	460
FBgn0266309	518	500	515	21	5	4.2	497
FBgn0266310	542	500	526	58	6	9.666666666666666	484
FBgn0266311	509	500	507	11	3	3.6666666666666665	498
FBgn0266312	502	500	477	27	5	5.4	475
FBgn0266313	503	500	484	22	2	11	481
FBgn0266314	503	500	488	18	4	4.5	485
FBgn0266315	500	500	499	1	1	1	499
FBgn0266316	501	500	496	6	3	2	495
FBgn0266317	501	500	500	2	2	1	499
FBgn0266318	530	500	496	64	7	9.142857142857142	466
FBgn0266319	514	500	494	34	7	4.857142857142857	480
FBgn0266320	500	500	496	4	2	2	496
FBgn0266321	506	500	466	46	6	7.666666666666667	460
FBgn0266322	531	500	526	36	7	5.142857142857143	495
FBgn0266323	500	500	425	75	7	10.714285714285714	425
FBgn0266324	522	500	506	38	4	9.5	484
FBgn0266325	500	500	466	34	4	8.5	466
FBgn0266326	500	500	496	4	2	2	496
FBgn0266327	510	500	484	36	6	6	474
FBgn0266328	524	500	501	47	10	4.7	477
FBgn0266329	500	500	92	408	1	408	92
FBgn0266330	515	500	353	177	10	17.7	338
FBgn0266331	529	500	502	56	7	8	473
FBgn0266346	505	500	463	47	12	3.9166666666666665	458
FBgn0266347	520	500	489	51	11	4.636363636363637	469
FBgn0266348	505	500	503	7	3	2.3333333333333335	498
FBgn0266349	518	500	514	22	4	5.5	496
FBgn0266351	503	500	439	67	8	8.375	436
FBgn0266352	514	500	469	59	7	8.428571428571429	455
FBgn0266354	518	500	408	128	7	18.285714285714285	390
FBgn0266355	522	500	496	48	5	9.6	474
FBgn0266356	501	500	496	6	3	2	495
FBgn0266358	519	500	505	33	9	3.6666666666666665	486
FBgn0266359	500	500	496	4	2	2	496
FBgn0266360	502	500	502	2	1	2	500
FBgn0266365	483	465	458	43	4	10.75	440
FBgn0266371	504	500	489	19	3	6.333333333333333	485
FBgn0266372	516	500	515	17	4	4.25	499
FBgn0266377	500	500	493	7	2	3.5	493
FBgn0266379	503	500	502	4	2	2	499
FBgn0266381	500	500	460	40	3	13.333333333333334	460
FBgn0266382	500	500	500	0	0	NA	500
FBgn0266383	521	500	519	23	4	5.75	498
FBgn0266384	501	500	495	7	3	2.3333333333333335	494
FBgn0266388	506	500	429	83	2	41.5	423
FBgn0266389	515	500	483	47	8	5.875	468
FBgn0266391	504	500	495	13	5	2.6	491
FBgn0266392	500	500	465	35	4	8.75	465
FBgn0266395	505	500	498	12	3	4	493
FBgn0266396	515	500	488	42	5	8.4	473
FBgn0266397	500	500	490	10	3	3.3333333333333335	490
FBgn0266398	502	500	497	7	3	2.3333333333333335	495
FBgn0266399	500	500	500	0	0	NA	500
FBgn0266401	501	500	498	4	3	1.3333333333333333	497
FBgn0266402	510	500	492	28	3	9.333333333333334	482
FBgn0266403	503	500	470	36	3	12	467
FBgn0266404	516	500	510	22	6	3.6666666666666665	494
FBgn0266408	500	500	440	60	6	10	440
FBgn0266410	504	500	480	28	2	14	476
FBgn0266412	500	500	484	16	2	8	484
FBgn0266413	531	500	510	52	4	13	479
FBgn0266414	500	500	488	12	2	6	488
FBgn0266415	500	500	500	0	0	NA	500
FBgn0266416	508	500	506	10	3	3.3333333333333335	498
FBgn0266417	500	500	495	5	1	5	495
FBgn0266418	501	500	500	2	2	1	499
FBgn0266419	501	500	479	23	5	4.6	478
FBgn0266420	531	500	525	37	5	7.4	494
FBgn0266421	500	500	320	180	2	90	320
FBgn0266428	500	500	292	208	5	41.6	292
FBgn0266429	517	500	493	41	12	3.4166666666666665	476
FBgn0266430	522	500	517	27	5	5.4	495
FBgn0266431	500	500	490	10	3	3.3333333333333335	490
FBgn0266433	500	500	487	13	3	4.333333333333333	487
FBgn0266437	519	500	515	23	5	4.6	496
FBgn0266442	500	500	459	41	4	10.25	459
FBgn0266443	525	500	508	42	6	7	483
FBgn0266449	514	500	486	42	11	3.8181818181818183	472
FBgn0266450	507	500	501	13	5	2.6	494
FBgn0266452	354	354	329	25	2	12.5	329
FBgn0266454	521	500	496	46	5	9.2	475
FBgn0266465	521	500	520	22	5	4.4	499
FBgn0266518	501	500	501	1	1	1	500
FBgn0266521	533	500	512	54	5	10.8	479
FBgn0266534	500	500	495	5	2	2.5	495
FBgn0266535	505	500	504	6	3	2	499
FBgn0266536	509	500	499	19	5	3.8	490
FBgn0266537	500	500	451	49	4	12.25	451
FBgn0266549	501	500	493	9	3	3	492
FBgn0266557	370	370	357	13	5	2.6	357
FBgn0266564	514	500	430	98	9	10.88888888888889	416
FBgn0266565	521	500	518	24	7	3.4285714285714284	497
FBgn0266566	500	500	500	0	0	NA	500
FBgn0266568	545	500	455	135	11	12.272727272727273	410
FBgn0266573	503	500	449	57	2	28.5	446
FBgn0266574	501	500	501	1	1	1	500
FBgn0266577	509	500	467	51	5	10.2	458
FBgn0266579	514	500	513	15	2	7.5	499
FBgn0266580	500	500	105	395	1	395	105
FBgn0266581	500	500	500	0	0	NA	500
FBgn0266586	508	500	476	40	9	4.444444444444445	468
FBgn0266587	506	500	501	11	4	2.75	495
FBgn0266588	509	500	509	9	1	9	500
FBgn0266589	520	500	520	20	2	10	500
FBgn0266590	500	500	499	1	1	1	499
FBgn0266591	508	500	508	8	3	2.6666666666666665	500
FBgn0266593	515	500	503	27	7	3.857142857142857	488
FBgn0266594	500	500	460	40	4	10	460
FBgn0266595	500	500	489	11	2	5.5	489
FBgn0266596	366	337	326	69	6	11.5	297
FBgn0266598	507	500	490	24	5	4.8	483
FBgn0266599	524	500	523	25	5	5	499
FBgn0266618	511	500	510	12	3	4	499
FBgn0266620	500	500	397	103	2	51.5	397
FBgn0266622	500	500	489	11	2	5.5	489
FBgn0266623	505	500	502	8	2	4	497
FBgn0266624	500	500	493	7	4	1.75	493
FBgn0266625	507	500	507	7	1	7	500
FBgn0266626	521	500	520	22	3	7.333333333333333	499
FBgn0266627	500	500	478	22	2	11	478
FBgn0266628	501	500	494	8	3	2.6666666666666665	493
FBgn0266629	525	500	497	53	12	4.416666666666667	472
FBgn0266630	500	500	500	0	0	NA	500
FBgn0266632	519	500	518	20	3	6.666666666666667	499
FBgn0266634	532	500	531	33	3	11	499
FBgn0266635	517	500	511	23	5	4.6	494
FBgn0266636	500	500	495	5	2	2.5	495
FBgn0266637	501	500	498	4	2	2	497
FBgn0266638	506	500	502	10	2	5	496
FBgn0266639	511	500	480	42	6	7	469
FBgn0266640	506	500	493	19	4	4.75	487
FBgn0266641	511	500	506	16	3	5.333333333333333	495
FBgn0266643	509	500	471	47	5	9.4	462
FBgn0266644	500	500	500	0	0	NA	500
FBgn0266645	500	500	500	0	0	NA	500
FBgn0266646	510	500	493	27	6	4.5	483
FBgn0266648	514	500	443	85	4	21.25	429
FBgn0266649	510	500	507	13	6	2.1666666666666665	497
FBgn0266650	514	500	514	14	2	7	500
FBgn0266651	506	500	498	14	5	2.8	492
FBgn0266652	503	500	87	419	3	139.66666666666666	84
FBgn0266654	568	500	552	84	10	8.4	484
FBgn0266655	516	500	403	129	4	32.25	387
FBgn0266656	500	500	498	2	2	1	498
FBgn0266657	500	500	494	6	1	6	494
FBgn0266666	515	500	468	62	8	7.75	453
FBgn0266667	501	500	490	12	4	3	489
FBgn0266669	501	500	501	1	1	1	500
FBgn0266670	520	500	519	21	5	4.2	499
FBgn0266671	501	500	468	34	6	5.666666666666667	467
FBgn0266673	502	500	502	2	2	1	500
FBgn0266674	521	500	512	30	7	4.285714285714286	491
FBgn0266675	507	500	483	31	2	15.5	476
FBgn0266676	500	500	404	96	4	24	404
FBgn0266677	504	500	498	10	4	2.5	494
FBgn0266678	505	500	504	6	3	2	499
FBgn0266679	500	500	444	56	2	28	444
FBgn0266680	500	500	492	8	4	2	492
FBgn0266681	501	500	495	7	4	1.75	494
FBgn0266682	504	500	500	8	2	4	496
FBgn0266685	503	500	499	7	3	2.3333333333333335	496
FBgn0266686	500	500	494	6	1	6	494
FBgn0266688	513	500	513	13	2	6.5	500
FBgn0266692	501	500	418	84	11	7.636363636363637	417
FBgn0266693	532	500	503	61	8	7.625	471
FBgn0266696	500	500	499	1	1	1	499
FBgn0266697	509	500	506	12	3	4	497
FBgn0266699	513	500	503	23	8	2.875	490
FBgn0266700	503	500	501	5	3	1.6666666666666667	498
FBgn0266701	501	500	494	8	5	1.6	493
FBgn0266703	500	500	499	1	1	1	499
FBgn0266705	513	500	504	22	3	7.333333333333333	491
FBgn0266706	500	500	488	12	1	12	488
FBgn0266707	508	500	468	48	9	5.333333333333333	460
FBgn0266708	506	500	415	97	9	10.777777777777779	409
FBgn0266711	505	500	493	17	6	2.8333333333333335	488
FBgn0266717	500	500	499	1	1	1	499
FBgn0266719	500	500	500	0	0	NA	500
FBgn0266721	514	500	502	26	8	3.25	488
FBgn0266722	500	500	499	1	1	1	499
FBgn0266723	501	500	492	10	4	2.5	491
FBgn0266724	531	500	522	40	12	3.3333333333333335	491
FBgn0266725	502	500	493	11	4	2.75	491
FBgn0266729	500	500	494	6	2	3	494
FBgn0266731	502	500	492	12	6	2	490
FBgn0266733	410	408	379	33	3	11	377
FBgn0266734	525	500	507	43	6	7.166666666666667	482
FBgn0266735	500	500	491	9	1	9	491
FBgn0266736	515	500	514	16	3	5.333333333333333	499
FBgn0266737	518	500	504	32	8	4	486
FBgn0266738	520	500	519	21	6	3.5	499
FBgn0266741	500	500	494	6	2	3	494
FBgn0266742	508	500	491	25	6	4.166666666666667	483
FBgn0266744	500	500	500	0	0	NA	500
FBgn0266745	512	500	499	25	5	5	487
FBgn0266750	500	500	498	2	1	2	498
FBgn0266751	500	500	492	8	3	2.6666666666666665	492
FBgn0266752	500	500	491	9	2	4.5	491
FBgn0266756	508	500	468	48	8	6	460
FBgn0266757	500	500	484	16	5	3.2	484
FBgn0266758	510	500	500	20	5	4	490
FBgn0266763	502	500	450	54	4	13.5	448
FBgn0266764	500	500	483	17	2	8.5	483
FBgn0266766	501	500	497	5	3	1.6666666666666667	496
FBgn0266768	500	500	460	40	4	10	460
FBgn0266769	517	500	392	142	7	20.285714285714285	375
FBgn0266771	501	500	489	13	2	6.5	488
FBgn0266772	527	500	525	29	3	9.666666666666666	498
FBgn0266773	507	500	504	10	2	5	497
FBgn0266774	507	500	453	61	9	6.777777777777778	446
FBgn0266775	500	500	500	0	0	NA	500
FBgn0266776	500	500	496	4	3	1.3333333333333333	496
FBgn0266777	520	500	505	35	6	5.833333333333333	485
FBgn0266778	557	500	542	72	9	8	485
FBgn0266780	500	500	455	45	4	11.25	455
FBgn0266781	500	500	498	2	2	1	498
FBgn0266782	508	500	454	62	9	6.888888888888889	446
FBgn0266783	500	500	477	23	5	4.6	477
FBgn0266784	500	500	484	16	5	3.2	484
FBgn0266785	542	500	529	55	6	9.166666666666666	487
FBgn0266786	530	500	508	52	10	5.2	478
FBgn0266787	500	500	500	0	0	NA	500
FBgn0266788	500	500	332	168	2	84	332
FBgn0266789	500	500	495	5	2	2.5	495
FBgn0266790	500	500	493	7	2	3.5	493
FBgn0266795	512	500	503	21	5	4.2	491
FBgn0266796	501	500	496	6	2	3	495
FBgn0266797	508	500	501	15	5	3	493
FBgn0266798	500	500	499	1	1	1	499
FBgn0266799	520	500	457	83	7	11.857142857142858	437
FBgn0266800	521	500	520	22	2	11	499
FBgn0266801	500	500	328	172	1	172	328
FBgn0266802	500	500	94	406	2	203	94
FBgn0266803	501	500	501	1	1	1	500
FBgn0266804	528	500	498	58	5	11.6	470
FBgn0266805	500	500	498	2	1	2	498
FBgn0266806	500	500	462	38	2	19	462
FBgn0266807	514	500	497	31	7	4.428571428571429	483
FBgn0266808	500	500	500	0	0	NA	500
FBgn0266809	523	500	523	23	2	11.5	500
FBgn0266810	512	500	507	17	5	3.4	495
FBgn0266811	501	500	497	5	2	2.5	496
FBgn0266812	515	500	515	15	1	15	500
FBgn0266813	530	500	528	32	4	8	498
FBgn0266814	500	500	418	82	2	41	418
FBgn0266815	511	500	504	18	5	3.6	493
FBgn0266816	503	500	503	3	3	1	500
FBgn0266817	505	500	474	36	6	6	469
FBgn0266818	516	500	457	75	11	6.818181818181818	441
FBgn0266819	509	500	494	24	6	4	485
FBgn0266821	503	500	503	3	2	1.5	500
FBgn0266822	501	500	388	114	3	38	387
FBgn0266824	513	500	496	30	6	5	483
FBgn0266825	500	500	489	11	4	2.75	489
FBgn0266827	508	500	486	30	4	7.5	478
FBgn0266828	500	500	474	26	5	5.2	474
FBgn0266829	503	500	490	16	2	8	487
FBgn0266830	505	500	503	7	2	3.5	498
FBgn0266831	500	500	496	4	3	1.3333333333333333	496
FBgn0266834	500	500	485	15	3	5	485
FBgn0266835	514	500	496	32	7	4.571428571428571	482
FBgn0266836	500	500	497	3	1	3	497
FBgn0266837	506	500	470	42	5	8.4	464
FBgn0266841	500	500	486	14	4	3.5	486
FBgn0266842	503	500	500	6	5	1.2	497
FBgn0266843	504	500	480	28	6	4.666666666666667	476
FBgn0266844	536	500	516	56	12	4.666666666666667	480
FBgn0266845	500	500	492	8	3	2.6666666666666665	492
FBgn0266846	518	500	517	19	3	6.333333333333333	499
FBgn0266849	500	500	489	11	3	3.6666666666666665	489
FBgn0266850	506	500	495	17	4	4.25	489
FBgn0266851	500	500	500	0	0	NA	500
FBgn0266852	511	500	509	13	4	3.25	498
FBgn0266853	548	500	508	88	7	12.571428571428571	460
FBgn0266854	519	500	445	93	12	7.75	426
FBgn0266855	505	500	466	44	6	7.333333333333333	461
FBgn0266856	504	500	343	165	4	41.25	339
FBgn0266858	504	500	457	51	4	12.75	453
FBgn0266859	511	500	511	11	2	5.5	500
FBgn0266860	502	500	477	27	2	13.5	475
FBgn0266861	504	500	503	5	2	2.5	499
FBgn0266862	503	500	249	257	3	85.66666666666667	246
FBgn0266863	506	500	483	29	5	5.8	477
FBgn0266865	518	500	511	25	3	8.333333333333334	493
FBgn0266866	501	500	497	5	2	2.5	496
FBgn0266867	504	500	489	19	2	9.5	485
FBgn0266868	508	500	490	26	6	4.333333333333333	482
FBgn0266870	512	500	494	30	9	3.3333333333333335	482
FBgn0266872	500	500	498	2	2	1	498
FBgn0266873	505	500	458	52	4	13	453
FBgn0266874	500	500	494	6	4	1.5	494
FBgn0266875	505	500	355	155	2	77.5	350
FBgn0266876	372	356	358	30	4	7.5	342
FBgn0266877	503	500	503	3	1	3	500
FBgn0266880	517	500	513	21	6	3.5	496
FBgn0266881	500	500	470	30	2	15	470
FBgn0266882	500	500	470	30	3	10	470
FBgn0266883	357	343	344	27	6	4.5	330
FBgn0266884	506	500	496	16	4	4	490
FBgn0266885	500	500	486	14	2	7	486
FBgn0266886	511	500	474	48	8	6	463
FBgn0266887	500	500	457	43	5	8.6	457
FBgn0266888	531	500	507	55	6	9.166666666666666	476
FBgn0266889	505	500	504	6	3	2	499
FBgn0266891	500	500	416	84	4	21	416
FBgn0266892	571	500	536	106	8	13.25	465
FBgn0266893	507	500	495	19	9	2.111111111111111	488
FBgn0266894	482	473	182	309	6	51.5	173
FBgn0266895	524	500	509	39	11	3.5454545454545454	485
FBgn0266896	501	500	498	4	2	2	497
FBgn0266898	500	500	476	24	2	12	476
FBgn0266900	449	427	447	24	6	4	425
FBgn0266901	500	500	462	38	5	7.6	462
FBgn0266904	500	500	498	2	2	1	498
FBgn0266905	501	500	492	10	4	2.5	491
FBgn0266906	437	437	435	2	1	2	435
FBgn0266909	553	500	535	71	4	17.75	482
FBgn0266910	523	500	487	59	6	9.833333333333334	464
FBgn0266911	507	500	482	32	4	8	475
FBgn0266912	434	434	415	19	3	6.333333333333333	415
FBgn0266914	500	500	500	0	0	NA	500
FBgn0266915	516	500	343	189	4	47.25	327
FBgn0266916	519	500	505	33	9	3.6666666666666665	486
FBgn0266917	518	500	485	51	4	12.75	467
FBgn0266918	500	500	481	19	3	6.333333333333333	481
FBgn0266925	509	500	509	9	2	4.5	500
FBgn0266926	500	500	499	1	1	1	499
FBgn0266927	503	500	485	21	3	7	482
FBgn0266928	500	500	474	26	3	8.666666666666666	474
FBgn0266931	504	500	504	4	1	4	500
FBgn0266932	536	500	507	65	8	8.125	471
FBgn0266933	521	500	516	26	8	3.25	495
FBgn0266934	504	500	200	308	3	102.66666666666667	196
FBgn0266935	516	500	248	284	3	94.66666666666667	232
FBgn0266937	508	500	472	44	5	8.8	464
FBgn0266939	521	500	476	66	7	9.428571428571429	455
FBgn0266940	525	500	504	46	6	7.666666666666667	479
FBgn0266941	501	500	475	27	7	3.857142857142857	474
FBgn0266942	508	500	478	38	5	7.6	470
FBgn0266944	500	500	123	377	2	188.5	123
FBgn0266945	500	500	497	3	1	3	497
FBgn0266946	500	500	486	14	1	14	486
FBgn0266947	504	500	494	14	5	2.8	490
FBgn0266948	500	500	473	27	4	6.75	473
FBgn0266949	508	500	418	98	6	16.333333333333332	410
FBgn0266950	500	500	486	14	2	7	486
FBgn0266951	510	500	299	221	5	44.2	289
FBgn0266952	503	500	498	8	3	2.6666666666666665	495
FBgn0266953	522	500	510	34	9	3.7777777777777777	488
FBgn0266954	516	500	472	60	7	8.571428571428571	456
FBgn0266955	509	500	359	159	5	31.8	350
FBgn0266956	522	500	507	37	6	6.166666666666667	485
FBgn0266957	501	500	495	7	4	1.75	494
FBgn0266958	500	500	497	3	1	3	497
FBgn0266959	500	500	467	33	5	6.6	467
FBgn0266960	500	500	491	9	3	3	491
FBgn0266961	510	500	494	26	6	4.333333333333333	484
FBgn0266962	510	500	459	61	4	15.25	449
FBgn0266963	509	500	494	24	5	4.8	485
FBgn0266964	507	500	502	12	3	4	495
FBgn0266965	508	500	500	16	5	3.2	492
FBgn0266966	500	500	495	5	2	2.5	495
FBgn0266967	502	500	497	7	3	2.3333333333333335	495
FBgn0266968	513	500	490	36	6	6	477
FBgn0266969	500	500	491	9	1	9	491
FBgn0266970	501	500	463	39	4	9.75	462
FBgn0266971	514	500	468	60	7	8.571428571428571	454
FBgn0266972	500	500	476	24	3	8	476
FBgn0266973	512	500	492	32	9	3.5555555555555554	480
FBgn0266974	502	500	502	2	2	1	500
FBgn0266975	509	500	507	11	3	3.6666666666666665	498
FBgn0266976	500	500	487	13	3	4.333333333333333	487
FBgn0266977	501	500	501	1	1	1	500
FBgn0266978	502	500	498	6	3	2	496
FBgn0266979	518	500	518	18	2	9	500
FBgn0266980	500	500	499	1	1	1	499
FBgn0266981	428	426	405	25	4	6.25	403
FBgn0266983	510	500	509	11	3	3.6666666666666665	499
FBgn0266984	509	500	476	42	5	8.4	467
FBgn0266985	511	500	499	23	4	5.75	488
FBgn0266986	505	500	428	82	8	10.25	423
FBgn0266987	502	500	496	8	7	1.1428571428571428	494
FBgn0266989	500	500	497	3	1	3	497
FBgn0266990	501	500	494	8	2	4	493
FBgn0266992	551	500	542	60	9	6.666666666666667	491
FBgn0266994	501	500	432	70	3	23.333333333333332	431
FBgn0266995	502	500	502	2	2	1	500
FBgn0267002	350	348	344	8	3	2.6666666666666665	342
FBgn0267003	519	500	500	38	6	6.333333333333333	481
FBgn0267004	537	500	529	45	8	5.625	492
FBgn0267005	500	500	464	36	8	4.5	464
FBgn0267006	516	500	498	34	9	3.7777777777777777	482
FBgn0267007	500	500	457	43	6	7.166666666666667	457
FBgn0267008	500	500	496	4	1	4	496
FBgn0267010	517	500	505	29	6	4.833333333333333	488
FBgn0267011	519	500	514	24	5	4.8	495
FBgn0267012	500	500	431	69	4	17.25	431
FBgn0267014	512	500	360	164	3	54.666666666666664	348
FBgn0267017	514	500	474	54	3	18	460
FBgn0267018	500	500	497	3	2	1.5	497
FBgn0267019	500	500	500	0	0	NA	500
FBgn0267020	503	500	385	121	5	24.2	382
FBgn0267021	509	500	455	63	4	15.75	446
FBgn0267022	504	500	477	31	8	3.875	473
FBgn0267023	512	500	510	14	4	3.5	498
FBgn0267024	500	500	500	0	0	NA	500
FBgn0267025	500	500	500	0	0	NA	500
FBgn0267026	530	500	485	75	12	6.25	455
FBgn0267029	514	500	324	204	6	34	310
FBgn0267030	514	500	514	14	3	4.666666666666667	500
FBgn0267032	507	500	488	26	5	5.2	481
FBgn0267033	510	500	501	19	4	4.75	491
FBgn0267034	500	500	89	411	1	411	89
FBgn0267036	513	500	513	13	3	4.333333333333333	500
FBgn0267037	503	500	451	55	9	6.111111111111111	448
FBgn0267038	501	500	470	32	8	4	469
FBgn0267040	500	500	452	48	12	4	452
FBgn0267041	537	500	520	54	9	6	483
FBgn0267056	500	500	489	11	4	2.75	489
FBgn0267057	513	500	513	13	1	13	500
FBgn0267059	500	500	388	112	4	28	388
FBgn0267063	381	381	367	14	2	7	367
FBgn0267065	510	500	504	16	5	3.2	494
FBgn0267066	506	500	485	27	4	6.75	479
FBgn0267068	507	500	507	7	1	7	500
FBgn0267069	502	500	488	16	5	3.2	486
FBgn0267070	500	500	500	0	0	NA	500
FBgn0267071	506	500	478	34	6	5.666666666666667	472
FBgn0267072	505	500	480	30	7	4.285714285714286	475
FBgn0267074	503	500	478	28	6	4.666666666666667	475
FBgn0267075	505	500	479	31	5	6.2	474
FBgn0267076	503	500	503	3	1	3	500
FBgn0267077	543	500	504	82	9	9.11111111111111	461
FBgn0267078	500	500	460	40	5	8	460
FBgn0267079	501	500	453	49	7	7	452
FBgn0267080	527	500	521	33	5	6.6	494
FBgn0267081	503	500	487	19	3	6.333333333333333	484
FBgn0267083	531	500	516	46	9	5.111111111111111	485
FBgn0267084	555	500	537	73	5	14.6	482
FBgn0267085	435	434	408	28	7	4	407
FBgn0267086	501	500	494	8	4	2	493
FBgn0267087	514	500	485	43	5	8.6	471
FBgn0267088	523	500	479	67	4	16.75	456
FBgn0267089	517	500	505	29	8	3.625	488
FBgn0267090	500	500	459	41	8	5.125	459
FBgn0267091	504	500	453	55	7	7.857142857142857	449
FBgn0267096	505	500	433	77	7	11	428
FBgn0267097	508	500	469	47	10	4.7	461
FBgn0267098	509	500	474	44	12	3.6666666666666665	465
FBgn0267099	519	500	510	28	6	4.666666666666667	491
FBgn0267100	502	500	494	10	3	3.3333333333333335	492
FBgn0267101	504	500	443	65	4	16.25	439
FBgn0267102	515	500	510	20	5	4	495
FBgn0267103	500	500	322	178	4	44.5	322
FBgn0267104	509	500	481	37	6	6.166666666666667	472
FBgn0267105	501	500	499	3	2	1.5	498
FBgn0267106	536	500	519	53	5	10.6	483
FBgn0267107	500	500	493	7	4	1.75	493
FBgn0267109	500	500	241	259	1	259	241
FBgn0267110	509	500	495	23	8	2.875	486
FBgn0267112	515	500	482	48	7	6.857142857142857	467
FBgn0267113	504	500	500	8	2	4	496
FBgn0267114	500	500	500	0	0	NA	500
FBgn0267115	500	500	492	8	2	4	492
FBgn0267116	522	500	489	55	10	5.5	467
FBgn0267119	508	500	507	9	4	2.25	499
FBgn0267120	518	500	496	40	7	5.714285714285714	478
FBgn0267121	500	500	485	15	2	7.5	485
FBgn0267122	502	500	495	9	2	4.5	493
FBgn0267123	502	500	484	20	6	3.3333333333333335	482
FBgn0267124	509	500	485	33	8	4.125	476
FBgn0267125	500	500	486	14	1	14	486
FBgn0267126	506	500	460	52	9	5.777777777777778	454
FBgn0267127	511	500	509	13	2	6.5	498
FBgn0267128	523	500	504	42	6	7	481
FBgn0267129	501	500	376	126	6	21	375
FBgn0267131	500	500	500	0	0	NA	500
FBgn0267134	509	500	489	29	8	3.625	480
FBgn0267135	524	500	500	48	2	24	476
FBgn0267136	509	500	509	9	3	3	500
FBgn0267137	518	500	515	21	5	4.2	497
FBgn0267139	500	500	493	7	1	7	493
FBgn0267140	518	500	496	40	6	6.666666666666667	478
FBgn0267141	505	500	502	8	2	4	497
FBgn0267142	505	500	499	11	4	2.75	494
FBgn0267143	504	500	496	12	3	4	492
FBgn0267144	503	500	495	11	5	2.2	492
FBgn0267145	506	500	490	22	3	7.333333333333333	484
FBgn0267146	511	500	499	23	6	3.8333333333333335	488
FBgn0267147	500	500	493	7	2	3.5	493
FBgn0267148	500	500	494	6	2	3	494
FBgn0267149	528	500	525	31	7	4.428571428571429	497
FBgn0267150	509	500	506	12	4	3	497
FBgn0267151	527	500	515	39	7	5.571428571428571	488
FBgn0267153	508	500	495	21	4	5.25	487
FBgn0267154	509	500	496	22	4	5.5	487
FBgn0267155	526	500	517	35	6	5.833333333333333	491
FBgn0267157	501	500	491	11	3	3.6666666666666665	490
FBgn0267158	500	500	388	112	4	28	388
FBgn0267159	500	500	497	3	2	1.5	497
FBgn0267160	500	500	488	12	3	4	488
FBgn0267161	530	500	525	35	7	5	495
FBgn0267162	510	500	367	153	7	21.857142857142858	357
FBgn0267164	533	500	493	73	6	12.166666666666666	460
FBgn0267165	524	500	509	39	7	5.571428571428571	485
FBgn0267166	519	500	507	31	5	6.2	488
FBgn0267167	500	500	475	25	5	5	475
FBgn0267169	530	500	488	72	14	5.142857142857143	458
FBgn0267170	516	500	420	112	4	28	404
FBgn0267171	512	500	489	35	8	4.375	477
FBgn0267173	522	500	502	42	5	8.4	480
FBgn0267174	517	500	166	368	3	122.66666666666667	149
FBgn0267176	504	500	499	9	4	2.25	495
FBgn0267178	500	500	496	4	2	2	496
FBgn0267179	564	500	523	105	12	8.75	459
FBgn0267180	504	500	493	15	5	3	489
FBgn0267181	508	500	505	11	4	2.75	497
FBgn0267182	518	500	449	87	5	17.4	431
FBgn0267183	504	500	501	7	3	2.3333333333333335	497
FBgn0267184	516	500	312	220	5	44	296
FBgn0267185	563	500	511	115	8	14.375	448
FBgn0267186	508	500	195	321	4	80.25	187
FBgn0267187	510	500	503	17	5	3.4	493
FBgn0267188	520	500	486	54	4	13.5	466
FBgn0267189	505	500	479	31	5	6.2	474
FBgn0267190	507	500	454	60	10	6	447
FBgn0267191	503	500	491	15	4	3.75	488
FBgn0267192	502	500	496	8	4	2	494
FBgn0267194	500	500	500	0	0	NA	500
FBgn0267195	520	500	486	54	8	6.75	466
FBgn0267196	406	406	406	0	0	NA	406
FBgn0267197	371	370	289	83	6	13.833333333333334	288
FBgn0267198	527	500	524	30	3	10	497
FBgn0267200	500	500	495	5	1	5	495
FBgn0267201	491	490	479	13	4	3.25	478
FBgn0267202	510	500	507	13	4	3.25	497
FBgn0267203	501	500	445	57	4	14.25	444
FBgn0267205	500	500	467	33	6	5.5	467
FBgn0267206	500	500	493	7	3	2.3333333333333335	493
FBgn0267207	500	500	310	190	3	63.333333333333336	310
FBgn0267208	500	500	495	5	1	5	495
FBgn0267209	501	500	484	18	4	4.5	483
FBgn0267210	515	500	427	103	4	25.75	412
FBgn0267212	511	500	468	54	4	13.5	457
FBgn0267213	514	500	482	46	7	6.571428571428571	468
FBgn0267214	502	500	441	63	3	21	439
FBgn0267215	484	459	470	39	7	5.571428571428571	445
FBgn0267216	513	500	499	27	5	5.4	486
FBgn0267217	513	500	499	27	5	5.4	486
FBgn0267218	505	500	438	72	7	10.285714285714286	433
FBgn0267219	500	500	483	17	2	8.5	483
FBgn0267220	513	500	491	35	6	5.833333333333333	478
FBgn0267221	504	500	484	24	5	4.8	480
FBgn0267222	502	500	476	28	6	4.666666666666667	474
FBgn0267223	490	481	447	52	9	5.777777777777778	438
FBgn0267228	501	500	380	122	2	61	379
FBgn0267229	503	500	502	4	3	1.3333333333333333	499
FBgn0267230	512	500	508	16	5	3.2	496
FBgn0267232	507	500	424	90	7	12.857142857142858	417
FBgn0267233	543	500	514	72	10	7.2	471
FBgn0267234	500	500	487	13	4	3.25	487
FBgn0267235	500	500	489	11	2	5.5	489
FBgn0267236	501	500	501	1	1	1	500
FBgn0267237	526	500	512	40	11	3.6363636363636362	486
FBgn0267238	503	500	495	11	4	2.75	492
FBgn0267239	500	500	484	16	3	5.333333333333333	484
FBgn0267240	500	500	476	24	4	6	476
FBgn0267241	500	500	496	4	1	4	496
FBgn0267242	533	500	517	49	7	7	484
FBgn0267243	563	500	549	77	7	11	486
FBgn0267244	500	500	495	5	3	1.6666666666666667	495
FBgn0267245	500	500	482	18	3	6	482
FBgn0267246	507	500	492	22	5	4.4	485
FBgn0267247	500	500	494	6	3	2	494
FBgn0267248	500	500	380	120	3	40	380
FBgn0267249	500	500	491	9	1	9	491
FBgn0267252	518	500	518	18	5	3.6	500
FBgn0267253	512	500	478	46	9	5.111111111111111	466
FBgn0267255	520	500	520	20	3	6.666666666666667	500
FBgn0267256	517	500	488	46	6	7.666666666666667	471
FBgn0267257	501	500	499	3	3	1	498
FBgn0267259	503	500	482	24	5	4.8	479
FBgn0267260	500	500	488	12	2	6	488
FBgn0267261	501	500	498	4	3	1.3333333333333333	497
FBgn0267262	518	500	502	34	4	8.5	484
FBgn0267263	500	500	491	9	4	2.25	491
FBgn0267264	517	500	500	34	5	6.8	483
FBgn0267265	500	500	497	3	3	1	497
FBgn0267266	500	500	478	22	3	7.333333333333333	478
FBgn0267267	500	500	158	342	1	342	158
FBgn0267268	504	500	314	194	5	38.8	310
FBgn0267269	500	500	499	1	1	1	499
FBgn0267270	526	500	526	26	3	8.666666666666666	500
FBgn0267271	500	500	472	28	6	4.666666666666667	472
FBgn0267273	500	500	448	52	4	13	448
FBgn0267274	500	500	470	30	3	10	470
FBgn0267275	541	500	502	80	9	8.88888888888889	461
FBgn0267276	500	500	499	1	1	1	499
FBgn0267278	500	500	311	189	2	94.5	311
FBgn0267279	527	500	519	35	7	5	492
FBgn0267280	528	500	506	50	8	6.25	478
FBgn0267281	546	500	517	75	10	7.5	471
FBgn0267282	533	500	521	45	5	9	488
FBgn0267283	517	500	496	38	5	7.6	479
FBgn0267284	506	500	504	8	5	1.6	498
FBgn0267286	515	500	471	59	14	4.214285714285714	456
FBgn0267288	502	500	488	16	2	8	486
FBgn0267289	501	500	499	3	2	1.5	498
FBgn0267290	501	500	494	8	4	2	493
FBgn0267291	503	500	486	20	3	6.666666666666667	483
FBgn0267292	527	500	506	48	6	8	479
FBgn0267293	508	500	412	104	5	20.8	404
FBgn0267294	505	500	505	5	2	2.5	500
FBgn0267295	500	500	392	108	6	18	392
FBgn0267296	509	500	482	36	5	7.2	473
FBgn0267297	504	500	483	25	2	12.5	479
FBgn0267298	500	500	493	7	3	2.3333333333333335	493
FBgn0267301	500	500	458	42	2	21	458
FBgn0267302	538	500	537	39	4	9.75	499
FBgn0267303	501	500	501	1	1	1	500
FBgn0267304	529	500	518	40	3	13.333333333333334	489
FBgn0267305	501	500	458	44	7	6.285714285714286	457
FBgn0267306	506	500	502	10	5	2	496
FBgn0267307	528	500	518	38	6	6.333333333333333	490
FBgn0267308	500	500	500	0	0	NA	500
FBgn0267309	502	500	502	2	1	2	500
FBgn0267310	502	500	486	18	4	4.5	484
FBgn0267312	526	500	525	27	4	6.75	499
FBgn0267313	502	500	501	3	3	1	499
FBgn0267314	508	500	508	8	1	8	500
FBgn0267316	522	500	496	48	13	3.6923076923076925	474
FBgn0267317	500	500	441	59	7	8.428571428571429	441
FBgn0267318	505	500	334	176	5	35.2	329
FBgn0267319	518	500	479	57	7	8.142857142857142	461
FBgn0267320	524	500	521	27	5	5.4	497
FBgn0267322	501	500	478	24	5	4.8	477
FBgn0267323	501	500	470	32	6	5.333333333333333	469
FBgn0267326	365	365	342	23	2	11.5	342
FBgn0267327	541	500	532	50	8	6.25	491
FBgn0267330	511	500	511	11	3	3.6666666666666665	500
FBgn0267337	500	500	500	0	0	NA	500
FBgn0267339	416	398	403	31	6	5.166666666666667	385
FBgn0267348	500	500	492	8	2	4	492
FBgn0267350	504	500	486	22	5	4.4	482
FBgn0267351	500	500	500	0	0	NA	500
FBgn0267376	500	500	496	4	2	2	496
FBgn0267378	500	500	500	0	0	NA	500
FBgn0267383	503	500	483	23	5	4.6	480
FBgn0267384	511	500	494	28	6	4.666666666666667	483
FBgn0267390	515	500	454	76	8	9.5	439
FBgn0267399	503	500	497	9	4	2.25	494
FBgn0267400	500	500	466	34	3	11.333333333333334	466
FBgn0267408	516	500	506	26	8	3.25	490
FBgn0267411	545	500	522	68	9	7.555555555555555	477
FBgn0267428	530	500	516	44	4	11	486
FBgn0267435	454	454	414	40	6	6.666666666666667	414
FBgn0267438	500	500	483	17	3	5.666666666666667	483
FBgn0267439	557	499	532	83	3	27.666666666666668	474
FBgn0267440	510	500	496	24	5	4.8	486
FBgn0267442	538	500	515	61	6	10.166666666666666	477
FBgn0267445	522	500	341	203	7	29	319
FBgn0267447	500	500	455	45	6	7.5	455
FBgn0267448	501	500	345	157	2	78.5	344
FBgn0267450	509	500	509	9	1	9	500
FBgn0267451	506	500	467	45	6	7.5	461
FBgn0267452	543	500	532	54	8	6.75	489
FBgn0267453	570	500	521	119	9	13.222222222222221	451
FBgn0267454	504	500	500	8	4	2	496
FBgn0267455	503	500	497	9	4	2.25	494
FBgn0267456	509	500	256	262	5	52.4	247
FBgn0267457	501	500	491	11	3	3.6666666666666665	490
FBgn0267461	503	500	502	4	2	2	499
FBgn0267462	500	500	484	16	1	16	484
FBgn0267463	525	500	524	26	4	6.5	499
FBgn0267464	500	500	496	4	1	4	496
FBgn0267465	502	500	477	27	3	9	475
FBgn0267468	500	500	500	0	0	NA	500
FBgn0267469	523	500	426	120	8	15	403
FBgn0267470	500	500	496	4	1	4	496
FBgn0267471	500	500	489	11	2	5.5	489
FBgn0267472	500	500	497	3	1	3	497
FBgn0267473	501	500	467	35	7	5	466
FBgn0267474	500	500	495	5	1	5	495
FBgn0267476	500	500	492	8	1	8	492
FBgn0267479	500	500	486	14	4	3.5	486
FBgn0267480	542	500	517	67	9	7.444444444444445	475
FBgn0267482	529	500	520	38	4	9.5	491
FBgn0267484	506	500	467	45	4	11.25	461
FBgn0267485	500	500	497	3	1	3	497
FBgn0267487	500	500	432	68	6	11.333333333333334	432
FBgn0267488	501	500	474	28	5	5.6	473
FBgn0267525	507	500	463	51	6	8.5	456
FBgn0267526	500	500	482	18	2	9	482
FBgn0267527	500	500	442	58	8	7.25	442
FBgn0267528	502	500	438	66	3	22	436
FBgn0267529	507	500	503	11	4	2.75	496
FBgn0267531	500	500	500	0	0	NA	500
FBgn0267535	500	500	494	6	1	6	494
FBgn0267541	501	500	478	24	6	4	477
FBgn0267544	533	500	530	36	6	6	497
FBgn0267545	521	500	520	22	5	4.4	499
FBgn0267546	519	500	515	23	6	3.8333333333333335	496
FBgn0267547	553	500	545	61	7	8.714285714285714	492
FBgn0267548	511	500	488	34	4	8.5	477
FBgn0267549	512	500	496	28	7	4	484
FBgn0267551	510	500	500	20	3	6.666666666666667	490
FBgn0267555	547	500	527	67	8	8.375	480
FBgn0267556	507	500	504	10	2	5	497
FBgn0267560	511	500	499	23	3	7.666666666666667	488
FBgn0267561	503	500	502	4	2	2	499
FBgn0267564	517	500	501	33	4	8.25	484
FBgn0267566	501	500	494	8	3	2.6666666666666665	493
FBgn0267567	524	500	519	29	3	9.666666666666666	495
FBgn0267568	518	500	509	27	6	4.5	491
FBgn0267569	502	500	489	15	3	5	487
FBgn0267570	504	500	504	4	3	1.3333333333333333	500
FBgn0267571	514	500	426	102	9	11.333333333333334	412
FBgn0267572	500	500	484	16	2	8	484
FBgn0267573	543	500	505	81	9	9	462
FBgn0267574	518	500	517	19	3	6.333333333333333	499
FBgn0267575	500	500	498	2	1	2	498
FBgn0267576	502	500	500	4	2	2	498
FBgn0267577	500	500	492	8	1	8	492
FBgn0267579	505	500	504	6	3	2	499
FBgn0267580	539	500	539	39	4	9.75	500
FBgn0267586	519	500	429	109	9	12.11111111111111	410
FBgn0267587	500	500	493	7	2	3.5	493
FBgn0267589	500	500	500	0	0	NA	500
FBgn0267590	500	500	497	3	1	3	497
FBgn0267591	508	500	491	25	5	5	483
FBgn0267597	535	500	500	70	12	5.833333333333333	465
FBgn0267598	531	500	512	50	5	10	481
FBgn0267599	501	500	478	24	5	4.8	477
FBgn0267601	523	500	445	101	5	20.2	422
FBgn0267604	516	500	506	26	7	3.7142857142857144	490
FBgn0267605	501	500	500	2	2	1	499
FBgn0267606	574	500	562	86	8	10.75	488
FBgn0267607	517	500	491	43	4	10.75	474
FBgn0267611	528	500	487	69	7	9.857142857142858	459
FBgn0267620	505	500	505	5	1	5	500
FBgn0267621	513	500	507	19	4	4.75	494
FBgn0267622	517	500	502	32	6	5.333333333333333	485
FBgn0267625	502	500	474	30	4	7.5	472
FBgn0267626	516	500	511	21	4	5.25	495
FBgn0267628	500	500	494	6	2	3	494
FBgn0267629	507	500	497	17	4	4.25	490
FBgn0267630	504	500	490	18	5	3.6	486
FBgn0267631	501	500	498	4	3	1.3333333333333333	497
FBgn0267632	500	500	499	1	1	1	499
FBgn0267633	510	500	501	19	5	3.8	491
FBgn0267635	537	500	474	100	6	16.666666666666668	437
FBgn0267636	500	500	473	27	4	6.75	473
FBgn0267637	341	341	336	5	2	2.5	336
FBgn0267639	502	500	473	31	6	5.166666666666667	471
FBgn0267642	500	500	496	4	1	4	496
FBgn0267644	518	500	492	44	12	3.6666666666666665	474
FBgn0267647	510	500	510	10	1	10	500
FBgn0267653	503	500	502	4	3	1.3333333333333333	499
FBgn0267655	512	500	499	25	5	5	487
FBgn0267658	529	500	515	43	4	10.75	486
FBgn0267660	543	500	532	54	9	6	489
FBgn0267661	512	500	490	34	6	5.666666666666667	478
FBgn0267663	500	500	450	50	3	16.666666666666668	450
FBgn0267664	500	500	457	43	4	10.75	457
FBgn0267665	508	500	497	19	4	4.75	489
FBgn0267666	504	500	499	9	4	2.25	495
FBgn0267668	500	500	495	5	2	2.5	495
FBgn0267671	500	500	497	3	2	1.5	497
FBgn0267672	500	500	489	11	2	5.5	489
FBgn0267674	536	500	535	37	4	9.25	499
FBgn0267675	514	500	501	27	7	3.857142857142857	487
FBgn0267676	500	500	499	1	1	1	499
FBgn0267679	501	500	474	28	4	7	473
FBgn0267681	508	500	508	8	3	2.6666666666666665	500
FBgn0267682	504	500	495	13	5	2.6	491
FBgn0267683	516	500	502	30	6	5	486
FBgn0267685	501	500	494	8	3	2.6666666666666665	493
FBgn0267686	409	405	388	25	3	8.333333333333334	384
FBgn0267689	506	500	501	11	4	2.75	495
FBgn0267690	501	500	414	88	7	12.571428571428571	413
FBgn0267691	363	355	361	10	3	3.3333333333333335	353
FBgn0267692	500	500	498	2	1	2	498
FBgn0267693	519	500	480	58	6	9.666666666666666	461
FBgn0267694	511	500	470	52	5	10.4	459
FBgn0267695	500	500	500	0	0	NA	500
FBgn0267697	503	500	501	5	4	1.25	498
FBgn0267698	410	383	399	38	7	5.428571428571429	372
FBgn0267702	501	500	453	49	6	8.166666666666666	452
FBgn0267703	538	500	535	41	5	8.2	497
FBgn0267707	512	500	469	55	8	6.875	457
FBgn0267708	506	500	477	35	6	5.833333333333333	471
FBgn0267710	505	500	500	10	5	2	495
FBgn0267711	500	500	363	137	2	68.5	363
FBgn0267712	544	500	539	49	10	4.9	495
FBgn0267713	500	500	406	94	7	13.428571428571429	406
FBgn0267716	516	500	490	42	11	3.8181818181818183	474
FBgn0267717	506	500	448	64	5	12.8	442
FBgn0267721	501	500	460	42	5	8.4	459
FBgn0267722	500	500	498	2	2	1	498
FBgn0267723	502	500	490	14	5	2.8	488
FBgn0267725	500	500	465	35	5	7	465
FBgn0267728	516	500	507	25	9	2.7777777777777777	491
FBgn0267729	500	500	482	18	2	9	482
FBgn0267730	500	500	465	35	3	11.666666666666666	465
FBgn0267732	526	500	515	37	7	5.285714285714286	489
FBgn0267734	500	500	469	31	1	31	469
FBgn0267735	564	500	544	84	10	8.4	480
FBgn0267736	512	500	479	45	7	6.428571428571429	467
FBgn0267737	556	500	529	83	7	11.857142857142858	473
FBgn0267738	508	500	508	8	2	4	500
FBgn0267739	500	500	500	0	0	NA	500
FBgn0267740	514	500	485	43	8	5.375	471
FBgn0267742	512	500	512	12	1	12	500
FBgn0267743	500	500	500	0	0	NA	500
FBgn0267744	519	500	511	27	4	6.75	492
FBgn0267745	507	500	471	43	6	7.166666666666667	464
FBgn0267746	500	500	496	4	3	1.3333333333333333	496
FBgn0267747	501	500	487	15	5	3	486
FBgn0267748	503	500	447	59	3	19.666666666666668	444
FBgn0267750	371	367	361	14	3	4.666666666666667	357
FBgn0267751	547	500	537	57	7	8.142857142857142	490
FBgn0267753	501	500	499	3	3	1	498
FBgn0267754	507	500	507	7	2	3.5	500
FBgn0267755	500	500	499	1	1	1	499
FBgn0267756	500	500	500	0	0	NA	500
FBgn0267760	500	500	500	0	0	NA	500
FBgn0267761	540	500	539	41	4	10.25	499
FBgn0267762	503	500	501	5	3	1.6666666666666667	498
FBgn0267763	500	500	435	65	3	21.666666666666668	435
FBgn0267765	509	500	500	18	5	3.6	491
FBgn0267766	501	500	474	28	3	9.333333333333334	473
FBgn0267767	511	500	501	21	5	4.2	490
FBgn0267768	500	500	500	0	0	NA	500
FBgn0267769	503	500	487	19	5	3.8	484
FBgn0267770	500	500	497	3	1	3	497
FBgn0267771	506	500	471	41	6	6.833333333333333	465
FBgn0267773	550	500	548	52	6	8.666666666666666	498
FBgn0267774	534	500	498	70	7	10	464
FBgn0267775	500	500	472	28	4	7	472
FBgn0267776	507	500	507	7	2	3.5	500
FBgn0267778	500	500	500	0	0	NA	500
FBgn0267779	509	500	447	71	6	11.833333333333334	438
FBgn0267782	517	500	493	41	6	6.833333333333333	476
FBgn0267783	500	500	485	15	6	2.5	485
FBgn0267785	500	500	500	0	0	NA	500
FBgn0267788	506	500	492	20	9	2.2222222222222223	486
FBgn0267789	508	500	494	22	5	4.4	486
FBgn0267790	503	500	464	42	2	21	461
FBgn0267791	523	500	514	32	6	5.333333333333333	491
FBgn0267792	501	500	243	259	2	129.5	242
FBgn0267793	501	500	488	14	3	4.666666666666667	487
FBgn0267794	500	500	450	50	4	12.5	450
FBgn0267795	500	500	497	3	2	1.5	497
FBgn0267796	534	500	528	40	4	10	494
FBgn0267803	500	500	500	0	0	NA	500
FBgn0267804	529	500	522	36	7	5.142857142857143	493
FBgn0267805	528	500	526	30	7	4.285714285714286	498
FBgn0267806	502	500	464	40	5	8	462
FBgn0267807	517	500	513	21	4	5.25	496
FBgn0267809	504	500	491	17	6	2.8333333333333335	487
FBgn0267810	544	500	521	67	10	6.7	477
FBgn0267811	521	500	521	21	3	7	500
FBgn0267812	500	500	499	1	1	1	499
FBgn0267814	502	500	257	247	4	61.75	255
FBgn0267817	505	500	464	46	4	11.5	459
FBgn0267819	503	500	503	3	1	3	500
FBgn0267820	515	500	508	22	5	4.4	493
FBgn0267821	503	500	273	233	4	58.25	270
FBgn0267823	500	500	500	0	0	NA	500
FBgn0267826	539	500	454	124	9	13.777777777777779	415
FBgn0267827	500	500	483	17	5	3.4	483
FBgn0267828	500	500	495	5	2	2.5	495
FBgn0267849	519	500	503	35	7	5	484
FBgn0267865	501	500	496	6	4	1.5	495
FBgn0267868	507	500	463	51	7	7.285714285714286	456
FBgn0267903	535	500	247	323	6	53.833333333333336	212
FBgn0267912	526	500	520	32	6	5.333333333333333	494
FBgn0267914	507	500	494	20	5	4	487
FBgn0267915	562	500	518	106	7	15.142857142857142	456
FBgn0267916	504	500	501	7	5	1.4	497
FBgn0267917	509	500	509	9	2	4.5	500
FBgn0267918	518	500	518	18	3	6	500
FBgn0267919	509	500	499	19	6	3.1666666666666665	490
FBgn0267921	524	500	362	186	11	16.90909090909091	338
FBgn0267922	504	500	489	19	8	2.375	485
FBgn0267923	510	500	502	18	6	3	492
FBgn0267924	382	382	346	36	6	6	346
FBgn0267925	516	500	471	61	7	8.714285714285714	455
FBgn0267926	505	500	504	6	4	1.5	499
FBgn0267927	502	500	494	10	3	3.3333333333333335	492
FBgn0267928	500	500	491	9	1	9	491
FBgn0267930	512	500	506	18	4	4.5	494
FBgn0267932	517	500	510	24	7	3.4285714285714284	493
FBgn0267933	506	500	506	6	2	3	500
FBgn0267934	500	500	447	53	6	8.833333333333334	447
FBgn0267935	514	500	486	42	7	6	472
FBgn0267936	500	500	455	45	3	15	455
FBgn0267937	501	500	498	4	2	2	497
FBgn0267938	501	500	468	34	4	8.5	467
FBgn0267939	500	500	482	18	1	18	482
FBgn0267940	514	500	493	35	5	7	479
FBgn0267941	502	500	495	9	2	4.5	493
FBgn0267945	502	500	484	20	4	5	482
FBgn0267946	501	500	475	27	4	6.75	474
FBgn0267947	522	500	521	23	6	3.8333333333333335	499
FBgn0267948	507	500	470	44	6	7.333333333333333	463
FBgn0267950	501	500	481	21	6	3.5	480
FBgn0267952	507	500	493	21	4	5.25	486
FBgn0267953	500	500	498	2	1	2	498
FBgn0267954	507	500	506	8	3	2.6666666666666665	499
FBgn0267955	382	381	292	91	3	30.333333333333332	291
FBgn0267956	507	500	481	33	6	5.5	474
FBgn0267957	500	500	333	167	4	41.75	333
FBgn0267958	500	500	431	69	3	23	431
FBgn0267959	510	500	508	12	4	3	498
FBgn0267960	521	500	454	88	12	7.333333333333333	433
FBgn0267961	503	500	480	26	5	5.2	477
FBgn0267962	515	500	472	58	8	7.25	457
FBgn0267963	527	500	423	131	11	11.909090909090908	396
FBgn0267966	504	500	454	54	5	10.8	450
FBgn0267969	500	500	470	30	5	6	470
FBgn0267970	500	500	487	13	3	4.333333333333333	487
FBgn0267972	504	500	476	32	5	6.4	472
FBgn0267975	440	394	406	80	10	8	360
FBgn0267976	512	500	365	159	12	13.25	353
FBgn0267977	514	500	504	24	6	4	490
FBgn0267978	503	500	472	34	9	3.7777777777777777	469
FBgn0267982	510	500	500	20	4	5	490
FBgn0267984	523	500	485	61	8	7.625	462
FBgn0267987	504	500	213	295	4	73.75	209
FBgn0267988	520	500	476	64	8	8	456
FBgn0267989	506	500	495	17	3	5.666666666666667	489
FBgn0267992	500	500	488	12	2	6	488
FBgn0267993	500	500	478	22	4	5.5	478
FBgn0267994	527	500	527	27	4	6.75	500
FBgn0267995	505	500	481	29	3	9.666666666666666	476
FBgn0267996	503	500	501	5	2	2.5	498
FBgn0268063	510	500	490	30	4	7.5	480
FBgn0270924	512	500	429	95	7	13.571428571428571	417
FBgn0270925	501	500	483	19	3	6.333333333333333	482
FBgn0270927	500	500	485	15	5	3	485
FBgn0275432	501	500	498	4	3	1.3333333333333333	497
FBgn0275434	506	500	471	41	5	8.2	465
FBgn0275436	542	500	522	62	6	10.333333333333334	480
FBgn0278597	500	500	500	0	0	NA	500
FBgn0278599	500	500	491	9	2	4.5	491
FBgn0278600	543	500	543	43	3	14.333333333333334	500
FBgn0278604	500	500	499	1	1	1	499
FBgn0283426	501	500	474	28	6	4.666666666666667	473
FBgn0283427	509	500	494	24	5	4.8	485
FBgn0283437	500	500	445	55	6	9.166666666666666	445
FBgn0283438	502	500	498	6	3	2	496
FBgn0283451	531	500	529	33	6	5.5	498
FBgn0283461	519	500	501	37	3	12.333333333333334	482
FBgn0283467	503	500	499	7	5	1.4	496
FBgn0283468	510	500	504	16	4	4	494
FBgn0283469	533	500	531	35	5	7	498
FBgn0283471	502	500	472	32	8	4	470
FBgn0283472	502	500	501	3	2	1.5	499
FBgn0283476	542	500	522	62	7	8.857142857142858	480
FBgn0283477	503	500	496	10	4	2.5	493
FBgn0283478	500	500	494	6	2	3	494
FBgn0283479	500	500	492	8	3	2.6666666666666665	492
FBgn0283480	523	500	478	68	7	9.714285714285714	455
FBgn0283499	507	500	426	88	7	12.571428571428571	419
FBgn0283500	500	500	497	3	2	1.5	497
FBgn0283501	521	500	520	22	5	4.4	499
FBgn0283508	520	500	505	35	5	7	485
FBgn0283509	511	500	511	11	2	5.5	500
FBgn0283510	500	500	363	137	1	137	363
FBgn0283521	551	500	544	58	4	14.5	493
FBgn0283525	509	500	489	29	3	9.666666666666666	480
FBgn0283531	537	500	495	79	5	15.8	458
FBgn0283535	511	500	507	15	5	3	496
FBgn0283536	508	500	502	14	8	1.75	494
FBgn0283547	500	500	477	23	2	11.5	477
FBgn0283548	500	500	497	3	2	1.5	497
FBgn0283554	539	500	539	39	2	19.5	500
FBgn0283557	500	500	488	12	3	4	488
FBgn0283560	500	500	500	0	0	NA	500
FBgn0283625	559	500	556	62	6	10.333333333333334	497
FBgn0283627	546	500	465	127	6	21.166666666666668	419
FBgn0283649	532	500	532	32	3	10.666666666666666	500
FBgn0283651	501	500	496	6	3	2	495
FBgn0283657	501	500	501	1	1	1	500
FBgn0283658	516	500	473	59	8	7.375	457
FBgn0283659	500	500	494	6	4	1.5	494
FBgn0283666	513	500	493	33	8	4.125	480
FBgn0283678	500	500	482	18	3	6	482
FBgn0283680	511	500	499	23	5	4.6	488
FBgn0283681	500	500	498	2	1	2	498
FBgn0283682	504	500	492	16	3	5.333333333333333	488
FBgn0283712	510	500	499	21	9	2.3333333333333335	489
FBgn0283724	519	500	513	25	6	4.166666666666667	494
FBgn0283728	500	500	500	0	0	NA	500
FBgn0284084	500	500	499	1	1	1	499
FBgn0284220	502	500	451	53	10	5.3	449
FBgn0284221	523	500	448	98	13	7.538461538461538	425
FBgn0284243	526	500	495	57	12	4.75	469
FBgn0284244	500	500	437	63	7	9	437
FBgn0284245	501	500	498	4	2	2	497
FBgn0284247	500	500	498	2	1	2	498
FBgn0284248	482	479	480	5	3	1.6666666666666667	477
FBgn0284249	504	500	491	17	4	4.25	487
FBgn0284252	546	500	531	61	11	5.545454545454546	485
FBgn0284253	502	500	492	12	3	4	490
FBgn0284255	523	500	514	32	8	4	491
FBgn0284256	511	500	497	25	5	5	486
FBgn0284408	500	500	475	25	4	6.25	475
FBgn0284409	500	500	460	40	4	10	460
FBgn0284410	503	500	499	7	3	2.3333333333333335	496
FBgn0284411	503	500	466	40	6	6.666666666666667	463
FBgn0284412	504	500	467	41	6	6.833333333333333	463
FBgn0284413	523	500	504	42	6	7	481
FBgn0284414	513	500	508	18	4	4.5	495
FBgn0284415	506	500	497	15	3	5	491
FBgn0284416	552	500	536	68	6	11.333333333333334	484
FBgn0284418	509	500	487	31	5	6.2	478
FBgn0284419	501	500	487	15	3	5	486
FBgn0284420	506	500	501	11	5	2.2	495
FBgn0284421	508	500	494	22	2	11	486
FBgn0284435	503	500	495	11	5	2.2	492
FBgn0284444	506	500	450	62	9	6.888888888888889	444
FBgn0285879	502	500	499	5	3	1.6666666666666667	497
FBgn0285892	520	500	497	43	5	8.6	477
FBgn0285910	474	474	167	307	2	153.5	167
FBgn0285917	501	500	499	3	2	1.5	498
FBgn0285926	512	500	499	25	6	4.166666666666667	487
FBgn0285937	351	348	348	6	3	2	345
FBgn0285940	523	500	498	48	5	9.6	475
FBgn0285941	500	500	490	10	1	10	490
FBgn0285943	505	500	497	13	4	3.25	492
FBgn0285944	500	500	492	8	2	4	492
FBgn0285947	500	500	483	17	5	3.4	483
FBgn0285950	512	500	511	13	2	6.5	499
FBgn0285951	457	453	446	15	8	1.875	442
FBgn0285954	502	500	498	6	4	1.5	496
FBgn0285955	500	500	499	1	1	1	499
FBgn0285962	519	500	494	44	8	5.5	475
FBgn0285963	513	500	485	41	9	4.555555555555555	472
FBgn0285971	522	500	520	24	4	6	498
FBgn0286005	502	500	492	12	3	4	490
FBgn0286027	506	500	501	11	4	2.75	495
FBgn0286028	511	500	501	21	4	5.25	490
FBgn0286029	502	500	478	26	7	3.7142857142857144	476
FBgn0286031	517	500	517	17	3	5.666666666666667	500
FBgn0286032	509	500	497	21	2	10.5	488
FBgn0286033	509	500	509	9	2	4.5	500
FBgn0286051	509	500	494	24	4	6	485
FBgn0286070	500	500	483	17	2	8.5	483
FBgn0286071	509	500	488	30	7	4.285714285714286	479
FBgn0286075	503	500	503	3	1	3	500
FBgn0286198	522	500	512	32	6	5.333333333333333	490
FBgn0286203	500	500	500	0	0	NA	500
FBgn0286204	507	500	485	29	4	7.25	478
FBgn0286222	515	500	511	19	4	4.75	496
FBgn0286506	412	410	405	9	3	3	403
FBgn0286507	524	500	523	25	3	8.333333333333334	499
FBgn0286508	505	500	403	107	10	10.7	398
FBgn0286511	534	500	522	46	9	5.111111111111111	488
FBgn0286516	507	500	492	22	7	3.142857142857143	485
FBgn0286567	508	500	507	9	4	2.25	499
FBgn0286723	518	500	513	23	6	3.8333333333333335	495
FBgn0286726	503	500	503	3	1	3	500
FBgn0286728	500	500	496	4	2	2	496
FBgn0286731	515	500	513	17	7	2.4285714285714284	498
FBgn0286732	545	500	540	50	5	10	495
FBgn0286733	520	500	520	20	3	6.666666666666667	500
FBgn0286734	514	500	503	25	4	6.25	489
FBgn0286735	515	500	492	38	6	6.333333333333333	477
FBgn0286740	500	500	476	24	3	8	476
FBgn0286778	519	500	440	98	6	16.333333333333332	421
FBgn0286781	504	500	458	50	9	5.555555555555555	454
FBgn0286782	526	500	325	227	6	37.833333333333336	299
FBgn0286783	525	500	492	58	7	8.285714285714286	467
FBgn0286784	502	500	496	8	2	4	494
FBgn0286785	541	500	541	41	7	5.857142857142857	500
FBgn0286786	563	500	546	80	7	11.428571428571429	483
FBgn0286813	501	500	499	3	2	1.5	498
FBgn0286818	412	408	406	10	4	2.5	402
FBgn0286827	502	500	459	45	3	15	457
FBgn0286828	506	500	505	7	4	1.75	499
FBgn0286833	501	500	501	1	1	1	500
FBgn0286834	507	500	506	8	4	2	499
FBgn0286852	538	500	503	73	10	7.3	465
FBgn0286868	506	500	498	14	6	2.3333333333333335	492
FBgn0286873	551	500	542	60	10	6	491
FBgn0286874	502	500	499	5	3	1.6666666666666667	497
FBgn0286875	538	500	530	46	11	4.181818181818182	492
FBgn0286880	502	500	449	55	6	9.166666666666666	447
FBgn0286881	550	500	488	112	6	18.666666666666668	438
FBgn0286882	501	500	500	2	2	1	499
FBgn0286891	500	500	492	8	1	8	492
FBgn0286892	509	500	485	33	3	11	476
FBgn0286893	541	500	515	67	10	6.7	474
FBgn0286898	501	500	499	3	2	1.5	498
FBgn0286913	514	500	358	170	5	34	344
FBgn0286915	500	500	402	98	3	32.666666666666664	402
FBgn0286916	500	500	499	1	1	1	499
FBgn0286918	511	500	452	70	5	14	441
FBgn0286921	539	500	515	63	6	10.5	476
FBgn0286926	506	500	498	14	3	4.666666666666667	492
FBgn0286927	517	500	461	73	8	9.125	444
FBgn0286933	501	500	486	16	6	2.6666666666666665	485
FBgn0286976	500	500	499	1	1	1	499
FBgn0286977	529	500	506	52	7	7.428571428571429	477
FBgn0287182	510	500	478	42	7	6	468
FBgn0287184	512	500	491	33	6	5.5	479
FBgn0287185	539	500	527	51	8	6.375	488
FBgn0287186	500	500	496	4	1	4	496
FBgn0287204	504	500	67	441	3	147	63
FBgn0287211	508	500	455	61	7	8.714285714285714	447
FBgn0287213	501	500	497	5	3	1.6666666666666667	496
FBgn0287214	515	500	515	15	2	7.5	500
FBgn0287215	426	426	408	18	3	6	408
FBgn0287216	500	500	498	2	1	2	498
FBgn0287218	511	500	511	11	1	11	500
FBgn0287225	502	500	495	9	3	3	493
FBgn0287234	503	500	494	12	4	3	491
FBgn0287423	506	500	489	23	7	3.2857142857142856	483
FBgn0287454	530	500	528	32	3	10.666666666666666	498
FBgn0287462	501	500	501	1	1	1	500
FBgn0287463	500	500	498	2	1	2	498
FBgn0287464	539	500	515	63	10	6.3	476
FBgn0287465	501	500	497	5	2	2.5	496
FBgn0287466	374	371	283	94	4	23.5	280
FBgn0287585	523	500	520	26	7	3.7142857142857144	497
FBgn0287587	500	500	498	2	1	2	498
FBgn0287591	521	500	516	26	4	6.5	495
FBgn0287594	530	500	468	92	9	10.222222222222221	438
FBgn0287596	383	383	383	0	0	NA	383
FBgn0287597	501	500	197	305	3	101.66666666666667	196
FBgn0287600	500	500	497	3	2	1.5	497
FBgn0287601	507	500	506	8	4	2	499
FBgn0287602	508	500	498	18	5	3.6	490
FBgn0287604	533	500	473	93	11	8.454545454545455	440
FBgn0287605	509	500	493	25	5	5	484
FBgn0287609	508	500	492	24	6	4	484
FBgn0287611	508	500	286	230	8	28.75	278
FBgn0287615	500	500	444	56	9	6.222222222222222	444
FBgn0287616	507	500	363	151	6	25.166666666666668	356
FBgn0287617	500	500	483	17	2	8.5	483
FBgn0287619	507	500	218	296	8	37	211
FBgn0287621	505	500	495	15	5	3	490
FBgn0287631	502	500	487	17	4	4.25	485
FBgn0287633	511	500	406	116	10	11.6	395
FBgn0287645	526	500	496	56	8	7	470
FBgn0287667	501	500	497	5	3	1.6666666666666667	496
FBgn0287668	511	500	507	15	3	5	496
FBgn0287670	501	500	491	11	5	2.2	490
FBgn0287695	519	500	517	21	7	3	498
FBgn0287696	502	500	495	9	3	3	493
FBgn0287720	514	500	487	41	8	5.125	473
FBgn0287767	500	500	163	337	1	337	163
FBgn0287768	506	500	499	13	4	3.25	493
FBgn0287775	500	500	493	7	2	3.5	493
FBgn0287788	500	500	497	3	1	3	497
FBgn0287825	500	500	500	0	0	NA	500
FBgn0287828	500	500	480	20	4	5	480
FBgn0287831	436	435	355	82	7	11.714285714285714	354
FBgn0287844	513	500	498	28	6	4.666666666666667	485
FBgn0287864	502	500	484	20	5	4	482
FBgn0287873	515	500	507	23	5	4.6	492
FBgn0288232	461	453	458	11	3	3.6666666666666665	450
FBgn0288433	509	500	509	9	1	9	500
