gene	gapped_len	mel_len	sim_len	gap_num	indel_num	indel_mean_len	ungapped_len
FBgn0000008	816	750	794	88	10	8.8	728
FBgn0000014	750	750	745	5	3	1.6666666666666667	745
FBgn0000015	750	750	748	2	2	1	748
FBgn0000018	612	608	214	402	3	134	210
FBgn0000022	774	750	772	26	6	4.333333333333333	748
FBgn0000024	775	750	750	50	10	5	725
FBgn0000028	760	750	749	21	4	5.25	739
FBgn0000036	772	750	764	30	6	5	742
FBgn0000037	752	750	742	12	4	3	740
FBgn0000038	753	750	741	15	7	2.142857142857143	738
FBgn0000039	764	750	754	24	7	3.4285714285714284	740
FBgn0000043	767	750	368	416	6	69.33333333333333	351
FBgn0000044	755	750	701	59	7	8.428571428571429	696
FBgn0000046	760	750	719	51	8	6.375	709
FBgn0000047	832	750	823	91	9	10.11111111111111	741
FBgn0000052	766	750	755	27	5	5.4	739
FBgn0000053	778	750	764	42	8	5.25	736
FBgn0000057	787	750	781	43	5	8.6	744
FBgn0000061	750	750	749	1	1	1	749
FBgn0000063	758	750	743	23	7	3.2857142857142856	735
FBgn0000064	756	750	754	8	3	2.6666666666666665	748
FBgn0000071	800	750	778	72	7	10.285714285714286	728
FBgn0000077	751	750	744	8	3	2.6666666666666665	743
FBgn0000079	770	750	765	25	6	4.166666666666667	745
FBgn0000083	817	750	802	82	10	8.2	735
FBgn0000084	766	750	690	92	11	8.363636363636363	674
FBgn0000092	761	750	731	41	4	10.25	720
FBgn0000094	813	750	802	74	12	6.166666666666667	739
FBgn0000097	755	750	748	12	6	2	743
FBgn0000100	760	750	760	10	1	10	750
FBgn0000108	773	750	739	57	10	5.7	716
FBgn0000109	759	750	717	51	6	8.5	708
FBgn0000114	750	750	239	511	2	255.5	239
FBgn0000115	752	750	752	2	2	1	750
FBgn0000116	766	750	743	39	6	6.5	727
FBgn0000119	569	557	535	46	7	6.571428571428571	523
FBgn0000120	806	750	791	71	7	10.142857142857142	735
FBgn0000121	751	750	748	4	3	1.3333333333333333	747
FBgn0000137	751	750	741	11	3	3.6666666666666665	740
FBgn0000139	753	750	752	4	2	2	749
FBgn0000147	754	750	544	214	3	71.33333333333333	540
FBgn0000152	797	750	794	50	7	7.142857142857143	747
FBgn0000153	757	750	724	40	5	8	717
FBgn0000157	759	750	759	9	2	4.5	750
FBgn0000158	778	750	694	112	16	7	666
FBgn0000166	757	750	665	99	11	9	658
FBgn0000173	770	750	769	21	4	5.25	749
FBgn0000179	750	750	738	12	4	3	738
FBgn0000180	771	750	739	53	9	5.888888888888889	718
FBgn0000183	754	750	740	18	5	3.6	736
FBgn0000206	554	552	552	4	3	1.3333333333333333	550
FBgn0000212	750	750	740	10	2	5	740
FBgn0000216	753	750	746	10	4	2.5	743
FBgn0000221	754	750	752	6	2	3	748
FBgn0000227	750	750	732	18	2	9	732
FBgn0000228	751	750	459	293	5	58.6	458
FBgn0000229	750	750	750	0	0	NA	750
FBgn0000233	754	750	754	4	1	4	750
FBgn0000239	786	750	783	39	8	4.875	747
FBgn0000244	770	750	730	60	8	7.5	710
FBgn0000246	750	750	746	4	2	2	746
FBgn0000247	770	750	769	21	3	7	749
FBgn0000251	769	750	765	23	4	5.75	746
FBgn0000253	787	750	644	180	16	11.25	607
FBgn0000256	759	750	751	17	4	4.25	742
FBgn0000257	751	750	590	162	8	20.25	589
FBgn0000261	723	631	688	127	17	7.470588235294118	596
FBgn0000273	813	750	795	81	8	10.125	732
FBgn0000274	768	750	767	19	4	4.75	749
FBgn0000276	655	653	592	65	9	7.222222222222222	590
FBgn0000278	773	750	729	67	12	5.583333333333333	706
FBgn0000279	764	750	739	39	5	7.8	725
FBgn0000286	751	750	749	3	3	1	748
FBgn0000287	773	750	770	26	6	4.333333333333333	747
FBgn0000289	750	750	750	0	0	NA	750
FBgn0000299	777	750	692	112	6	18.666666666666668	665
FBgn0000308	780	750	724	86	10	8.6	694
FBgn0000317	799	750	787	61	6	10.166666666666666	738
FBgn0000318	751	750	675	77	4	19.25	674
FBgn0000320	809	750	778	90	9	10	719
FBgn0000326	750	750	658	92	3	30.666666666666668	658
FBgn0000330	807	750	793	71	4	17.75	736
FBgn0000337	785	750	688	132	14	9.428571428571429	653
FBgn0000339	751	750	743	9	3	3	742
FBgn0000352	763	750	750	26	7	3.7142857142857144	737
FBgn0000355	762	750	758	16	4	4	746
FBgn0000356	801	750	783	69	4	17.25	732
FBgn0000357	753	750	753	3	2	1.5	750
FBgn0000358	762	750	408	366	5	73.2	396
FBgn0000359	763	750	725	51	14	3.642857142857143	712
FBgn0000360	751	750	684	68	5	13.6	683
FBgn0000370	769	750	698	90	14	6.428571428571429	679
FBgn0000382	760	750	756	14	4	3.5	746
FBgn0000384	774	750	476	322	12	26.833333333333332	452
FBgn0000394	750	750	739	11	3	3.6666666666666665	739
FBgn0000395	811	750	803	69	9	7.666666666666667	742
FBgn0000404	843	750	792	144	15	9.6	699
FBgn0000405	764	750	758	20	6	3.3333333333333335	744
FBgn0000406	767	750	730	54	8	6.75	713
FBgn0000411	755	750	578	182	5	36.4	573
FBgn0000414	775	750	775	25	3	8.333333333333334	750
FBgn0000416	767	750	746	38	6	6.333333333333333	729
FBgn0000422	765	750	704	76	9	8.444444444444445	689
FBgn0000426	750	750	745	5	2	2.5	745
FBgn0000427	769	750	715	73	7	10.428571428571429	696
FBgn0000439	791	750	772	60	7	8.571428571428571	731
FBgn0000442	752	750	742	12	6	2	740
FBgn0000447	768	750	768	18	5	3.6	750
FBgn0000451	751	750	711	41	7	5.857142857142857	710
FBgn0000455	750	750	750	0	0	NA	750
FBgn0000459	768	750	768	18	1	18	750
FBgn0000463	634	598	621	49	9	5.444444444444445	585
FBgn0000477	754	750	730	28	6	4.666666666666667	726
FBgn0000482	762	750	743	31	8	3.875	731
FBgn0000489	757	750	740	24	10	2.4	733
FBgn0000490	760	750	747	23	5	4.6	737
FBgn0000492	758	750	747	19	3	6.333333333333333	739
FBgn0000499	751	750	729	23	5	4.6	728
FBgn0000500	792	750	698	136	10	13.6	656
FBgn0000524	776	750	747	55	11	5	721
FBgn0000527	750	750	446	304	4	76	446
FBgn0000529	751	750	736	16	4	4	735
FBgn0000533	774	750	746	52	7	7.428571428571429	722
FBgn0000536	755	750	734	26	7	3.7142857142857144	729
FBgn0000543	785	750	737	83	9	9.222222222222221	702
FBgn0000551	757	750	750	14	3	4.666666666666667	743
FBgn0000552	799	750	789	59	11	5.363636363636363	740
FBgn0000557	599	568	535	95	9	10.555555555555555	504
FBgn0000560	757	750	732	32	4	8	725
FBgn0000564	760	750	745	25	6	4.166666666666667	735
FBgn0000567	813	750	795	81	10	8.1	732
FBgn0000568	784	750	729	89	10	8.9	695
FBgn0000575	763	750	757	19	5	3.8	744
FBgn0000576	762	750	754	20	3	6.666666666666667	742
FBgn0000577	751	750	751	1	1	1	750
FBgn0000578	771	725	734	83	13	6.384615384615385	688
FBgn0000579	757	750	746	18	6	3	739
FBgn0000581	752	750	744	10	5	2	742
FBgn0000591	753	750	752	4	2	2	749
FBgn0000592	764	750	721	57	8	7.125	707
FBgn0000606	750	750	744	6	2	3	744
FBgn0000611	787	750	764	60	9	6.666666666666667	727
FBgn0000615	760	750	758	12	2	6	748
FBgn0000617	761	750	730	42	7	6	719
FBgn0000618	751	750	750	2	2	1	749
FBgn0000625	753	750	716	40	5	8	713
FBgn0000629	763	750	739	37	6	6.166666666666667	726
FBgn0000633	791	750	748	84	16	5.25	707
FBgn0000635	765	750	719	61	6	10.166666666666666	704
FBgn0000636	779	750	674	134	7	19.142857142857142	645
FBgn0000639	767	750	755	29	3	9.666666666666666	738
FBgn0000640	692	683	673	28	4	7	664
FBgn0000644	765	750	742	38	14	2.7142857142857144	727
FBgn0000662	759	750	756	12	5	2.4	747
FBgn0000709	768	750	753	33	6	5.5	735
FBgn0000711	769	750	345	443	5	88.6	326
FBgn0000715	752	750	746	8	5	1.6	744
FBgn0000721	758	750	701	65	13	5	693
FBgn0000723	774	750	693	105	12	8.75	669
FBgn0000810	771	750	766	26	5	5.2	745
FBgn0000928	754	750	722	36	9	4	718
FBgn0000964	772	750	758	36	11	3.272727272727273	736
FBgn0000996	806	750	798	64	15	4.266666666666667	742
FBgn0001075	788	750	765	61	11	5.545454545454546	727
FBgn0001077	750	750	748	2	2	1	748
FBgn0001079	783	750	761	55	8	6.875	728
FBgn0001083	778	750	715	91	20	4.55	687
FBgn0001085	753	750	727	29	5	5.8	724
FBgn0001086	750	750	747	3	2	1.5	747
FBgn0001087	778	750	705	101	9	11.222222222222221	677
FBgn0001089	761	750	685	87	12	7.25	674
FBgn0001090	761	750	733	39	6	6.5	722
FBgn0001091	750	750	727	23	7	3.2857142857142856	727
FBgn0001092	759	750	743	25	8	3.125	734
FBgn0001104	752	750	597	157	6	26.166666666666668	595
FBgn0001105	750	750	215	535	1	535	215
FBgn0001108	797	750	745	99	9	11	698
FBgn0001112	790	750	786	44	9	4.888888888888889	746
FBgn0001114	760	750	716	54	7	7.714285714285714	706
FBgn0001120	795	750	772	68	9	7.555555555555555	727
FBgn0001122	794	750	756	82	12	6.833333333333333	712
FBgn0001123	536	523	525	24	4	6	512
FBgn0001124	759	750	759	9	3	3	750
FBgn0001125	750	750	741	9	4	2.25	741
FBgn0001128	759	750	713	55	9	6.111111111111111	704
FBgn0001133	750	750	748	2	2	1	748
FBgn0001134	751	750	750	2	2	1	749
FBgn0001137	622	610	582	52	9	5.777777777777778	570
FBgn0001138	750	750	743	7	3	2.3333333333333335	743
FBgn0001139	765	750	637	143	12	11.916666666666666	622
FBgn0001145	779	750	760	48	11	4.363636363636363	731
FBgn0001147	754	750	751	7	2	3.5	747
FBgn0001148	815	750	797	83	7	11.857142857142858	732
FBgn0001149	772	750	754	40	11	3.6363636363636362	732
FBgn0001150	752	750	691	63	4	15.75	689
FBgn0001168	752	750	697	57	4	14.25	695
FBgn0001169	777	750	757	47	9	5.222222222222222	730
FBgn0001174	861	750	823	149	11	13.545454545454545	712
FBgn0001180	763	750	757	19	4	4.75	744
FBgn0001185	763	750	753	23	6	3.8333333333333335	740
FBgn0001186	770	750	733	57	10	5.7	713
FBgn0001187	763	750	763	13	3	4.333333333333333	750
FBgn0001189	752	750	751	3	2	1.5	749
FBgn0001206	773	750	754	42	7	6	731
FBgn0001208	757	750	742	22	4	5.5	735
FBgn0001215	750	750	264	486	2	243	264
FBgn0001216	769	750	697	91	9	10.11111111111111	678
FBgn0001222	765	750	748	32	14	2.2857142857142856	733
FBgn0001224	754	750	675	83	5	16.6	671
FBgn0001225	679	674	673	11	6	1.8333333333333333	668
FBgn0001226	752	750	732	22	6	3.6666666666666665	730
FBgn0001227	751	750	732	20	4	5	731
FBgn0001228	753	750	753	3	1	3	750
FBgn0001229	753	750	734	22	5	4.4	731
FBgn0001230	771	750	706	86	11	7.818181818181818	685
FBgn0001235	762	750	750	24	6	4	738
FBgn0001247	760	750	725	45	6	7.5	715
FBgn0001248	759	750	748	20	6	3.3333333333333335	739
FBgn0001250	763	750	709	67	7	9.571428571428571	696
FBgn0001253	760	750	711	59	7	8.428571428571429	701
FBgn0001254	795	750	737	103	12	8.583333333333334	692
FBgn0001256	750	750	720	30	4	7.5	720
FBgn0001257	760	750	756	14	5	2.8	746
FBgn0001259	764	750	728	50	9	5.555555555555555	714
FBgn0001269	751	750	623	129	2	64.5	622
FBgn0001276	762	750	750	24	8	3	738
FBgn0001280	750	750	749	1	1	1	749
FBgn0001291	758	750	739	27	9	3	731
FBgn0001296	666	664	663	5	4	1.25	661
FBgn0001297	758	750	725	41	8	5.125	717
FBgn0001301	870	750	824	166	12	13.833333333333334	704
FBgn0001308	750	750	747	3	2	1.5	747
FBgn0001311	778	750	762	44	10	4.4	734
FBgn0001316	790	750	782	48	8	6	742
FBgn0001319	773	750	736	60	6	10	713
FBgn0001320	763	750	742	34	7	4.857142857142857	729
FBgn0001321	753	750	715	41	9	4.555555555555555	712
FBgn0001323	759	750	740	28	4	7	731
FBgn0001325	750	750	750	0	0	NA	750
FBgn0001330	776	750	767	35	7	5	741
FBgn0001341	786	750	780	42	10	4.2	744
FBgn0001404	752	750	698	56	11	5.090909090909091	696
FBgn0001491	764	750	758	20	5	4	744
FBgn0001612	773	750	741	55	10	5.5	718
FBgn0001624	787	750	763	61	8	7.625	726
FBgn0001941	774	750	730	68	13	5.230769230769231	706
FBgn0001942	780	750	727	83	9	9.222222222222221	697
FBgn0001961	756	750	731	31	7	4.428571428571429	725
FBgn0001965	754	750	249	509	5	101.8	245
FBgn0001967	755	750	711	49	10	4.9	706
FBgn0001970	789	750	710	118	12	9.833333333333334	671
FBgn0001977	751	750	730	22	4	5.5	729
FBgn0001978	601	565	584	53	6	8.833333333333334	548
FBgn0001983	758	750	757	9	3	3	749
FBgn0001987	800	750	628	222	18	12.333333333333334	578
FBgn0001991	789	750	771	57	4	14.25	732
FBgn0001992	774	750	756	42	9	4.666666666666667	732
FBgn0001994	778	750	766	40	7	5.714285714285714	738
FBgn0001995	820	750	789	101	17	5.9411764705882355	719
FBgn0002022	754	739	747	22	9	2.4444444444444446	732
FBgn0002023	750	750	749	1	1	1	749
FBgn0002044	770	750	728	62	7	8.857142857142858	708
FBgn0002121	548	542	511	43	7	6.142857142857143	505
FBgn0002174	773	750	760	36	6	6	737
FBgn0002283	721	674	701	67	8	8.375	654
FBgn0002306	766	750	735	47	9	5.222222222222222	719
FBgn0002354	752	750	747	7	4	1.75	745
FBgn0002413	795	750	768	72	14	5.142857142857143	723
FBgn0002431	764	750	722	56	8	7	708
FBgn0002440	782	750	780	34	3	11.333333333333334	748
FBgn0002441	752	750	749	5	4	1.25	747
FBgn0002522	807	750	781	83	11	7.545454545454546	724
FBgn0002524	761	750	728	44	5	8.8	717
FBgn0002525	756	750	749	13	4	3.25	743
FBgn0002526	781	750	776	36	7	5.142857142857143	745
FBgn0002531	821	750	769	123	13	9.461538461538462	698
FBgn0002533	786	750	767	55	9	6.111111111111111	731
FBgn0002534	792	750	775	59	9	6.555555555555555	733
FBgn0002542	755	750	712	48	3	16	707
FBgn0002552	775	750	767	33	5	6.6	742
FBgn0002561	754	750	751	7	2	3.5	747
FBgn0002562	756	750	636	126	6	21	630
FBgn0002563	750	750	695	55	6	9.166666666666666	695
FBgn0002564	797	750	612	232	3	77.33333333333333	565
FBgn0002565	755	750	751	9	4	2.25	746
FBgn0002569	776	750	716	86	14	6.142857142857143	690
FBgn0002570	798	750	790	56	8	7	742
FBgn0002571	753	750	738	18	5	3.6	735
FBgn0002573	760	750	720	50	6	8.333333333333334	710
FBgn0002576	770	750	707	83	4	20.75	687
FBgn0002579	765	750	764	16	4	4	749
FBgn0002592	557	556	475	83	3	27.666666666666668	474
FBgn0002593	750	750	747	3	3	1	747
FBgn0002626	757	750	749	15	6	2.5	742
FBgn0002629	750	750	749	1	1	1	749
FBgn0002631	750	750	715	35	2	17.5	715
FBgn0002632	758	750	755	11	5	2.2	747
FBgn0002638	750	750	737	13	2	6.5	737
FBgn0002641	758	750	754	12	3	4	746
FBgn0002643	781	750	764	48	9	5.333333333333333	733
FBgn0002645	775	750	765	35	8	4.375	740
FBgn0002673	774	750	732	66	7	9.428571428571429	708
FBgn0002715	758	750	756	10	3	3.3333333333333335	748
FBgn0002732	750	750	750	0	0	NA	750
FBgn0002734	757	750	716	48	7	6.857142857142857	709
FBgn0002735	750	750	748	2	1	2	748
FBgn0002736	756	750	749	13	3	4.333333333333333	743
FBgn0002772	793	750	786	50	10	5	743
FBgn0002773	757	750	746	18	3	6	739
FBgn0002774	763	750	347	429	7	61.285714285714285	334
FBgn0002775	762	750	761	13	3	4.333333333333333	749
FBgn0002778	679	675	677	6	4	1.5	673
FBgn0002780	787	750	786	38	2	19	749
FBgn0002783	759	750	755	13	4	3.25	746
FBgn0002787	750	750	744	6	2	3	744
FBgn0002789	789	750	771	57	12	4.75	732
FBgn0002791	542	533	525	26	3	8.666666666666666	516
FBgn0002838	778	750	771	35	4	8.75	743
FBgn0002842	755	750	700	60	6	10	695
FBgn0002862	757	750	707	57	5	11.4	700
FBgn0002863	764	750	747	31	8	3.875	733
FBgn0002865	751	750	736	16	5	3.2	735
FBgn0002868	760	750	755	15	5	3	745
FBgn0002872	750	750	731	19	3	6.333333333333333	731
FBgn0002878	783	750	777	39	5	7.8	744
FBgn0002899	769	750	743	45	10	4.5	724
FBgn0002901	791	750	760	72	3	24	719
FBgn0002905	752	750	503	251	10	25.1	501
FBgn0002906	785	750	779	41	4	10.25	744
FBgn0002917	758	750	757	9	3	3	749
FBgn0002921	782	750	711	103	12	8.583333333333334	679
FBgn0002922	757	750	729	35	10	3.5	722
FBgn0002924	752	750	751	3	2	1.5	749
FBgn0002926	757	750	709	55	8	6.875	702
FBgn0002930	750	750	743	7	1	7	743
FBgn0002931	767	750	528	256	10	25.6	511
FBgn0002932	752	750	750	4	4	1	748
FBgn0002936	568	564	529	43	6	7.166666666666667	525
FBgn0002937	768	750	718	68	11	6.181818181818182	700
FBgn0002939	801	750	793	59	7	8.428571428571429	742
FBgn0002940	762	750	751	23	6	3.8333333333333335	739
FBgn0002941	754	750	722	36	4	9	718
FBgn0002962	767	750	765	19	5	3.8	748
FBgn0002985	750	750	718	32	4	8	718
FBgn0002989	752	750	740	14	5	2.8	738
FBgn0003008	752	750	748	6	5	1.2	746
FBgn0003009	783	750	756	60	11	5.454545454545454	723
FBgn0003011	753	750	748	8	4	2	745
FBgn0003015	751	750	738	14	6	2.3333333333333335	737
FBgn0003023	799	750	766	82	9	9.11111111111111	717
FBgn0003028	762	750	757	17	8	2.125	745
FBgn0003034	758	750	738	28	9	3.111111111111111	730
FBgn0003041	795	750	763	77	7	11	718
FBgn0003044	765	750	748	32	14	2.2857142857142856	733
FBgn0003046	764	750	750	28	7	4	736
FBgn0003048	636	630	633	9	5	1.8	627
FBgn0003053	799	750	755	93	7	13.285714285714286	706
FBgn0003057	773	750	756	40	5	8	733
FBgn0003060	768	750	761	25	6	4.166666666666667	743
FBgn0003062	755	750	702	58	9	6.444444444444445	697
FBgn0003065	759	750	759	9	2	4.5	750
FBgn0003068	770	750	737	53	10	5.3	717
FBgn0003071	753	750	748	8	4	2	745
FBgn0003074	775	750	772	28	3	9.333333333333334	747
FBgn0003076	758	750	754	12	4	3	746
FBgn0003079	824	750	754	144	18	8	680
FBgn0003082	765	750	720	60	6	10	705
FBgn0003086	788	750	565	261	11	23.727272727272727	527
FBgn0003087	750	750	739	11	3	3.6666666666666665	739
FBgn0003089	751	750	747	5	3	1.6666666666666667	746
FBgn0003090	668	608	661	67	5	13.4	601
FBgn0003091	771	750	768	24	7	3.4285714285714284	747
FBgn0003093	750	750	750	0	0	NA	750
FBgn0003114	751	750	750	2	2	1	749
FBgn0003117	750	750	737	13	4	3.25	737
FBgn0003118	754	750	690	68	6	11.333333333333334	686
FBgn0003124	760	750	723	47	10	4.7	713
FBgn0003129	766	750	766	16	4	4	750
FBgn0003130	752	750	691	63	5	12.6	689
FBgn0003137	755	750	739	21	5	4.2	734
FBgn0003139	766	750	753	29	9	3.2222222222222223	737
FBgn0003140	756	750	726	36	6	6	720
FBgn0003141	750	750	750	0	0	NA	750
FBgn0003145	760	750	716	54	7	7.714285714285714	706
FBgn0003149	765	750	757	23	4	5.75	742
FBgn0003159	790	750	765	65	11	5.909090909090909	725
FBgn0003162	753	750	713	43	6	7.166666666666667	710
FBgn0003165	751	750	710	42	9	4.666666666666667	709
FBgn0003169	756	750	756	6	1	6	750
FBgn0003175	778	750	772	34	8	4.25	744
FBgn0003187	759	750	690	78	12	6.5	681
FBgn0003189	774	750	767	31	8	3.875	743
FBgn0003204	760	750	757	13	3	4.333333333333333	747
FBgn0003205	750	750	750	0	0	NA	750
FBgn0003206	750	750	750	0	0	NA	750
FBgn0003209	788	750	515	311	9	34.55555555555556	477
FBgn0003231	768	750	368	418	5	83.6	350
FBgn0003249	782	750	707	107	8	13.375	675
FBgn0003250	772	750	771	23	4	5.75	749
FBgn0003254	797	750	780	64	7	9.142857142857142	733
FBgn0003255	777	750	752	52	9	5.777777777777778	725
FBgn0003257	770	750	744	46	7	6.571428571428571	724
FBgn0003261	806	750	550	312	14	22.285714285714285	494
FBgn0003267	751	750	736	16	4	4	735
FBgn0003268	751	750	747	5	2	2.5	746
FBgn0003270	750	750	716	34	3	11.333333333333334	716
FBgn0003274	786	750	758	64	8	8	722
FBgn0003278	769	750	688	100	8	12.5	669
FBgn0003279	777	750	748	56	10	5.6	721
FBgn0003285	763	750	735	41	8	5.125	722
FBgn0003292	764	750	742	36	8	4.5	728
FBgn0003295	764	750	656	122	10	12.2	642
FBgn0003300	757	750	719	45	5	9	712
FBgn0003301	757	750	741	23	8	2.875	734
FBgn0003308	835	750	595	325	12	27.083333333333332	510
FBgn0003310	750	750	750	0	0	NA	750
FBgn0003312	790	750	782	48	8	6	742
FBgn0003317	755	750	729	31	7	4.428571428571429	724
FBgn0003319	760	750	700	70	8	8.75	690
FBgn0003321	771	750	766	26	5	5.2	745
FBgn0003326	754	750	735	23	5	4.6	731
FBgn0003330	781	750	775	37	7	5.285714285714286	744
FBgn0003334	798	750	598	248	9	27.555555555555557	550
FBgn0003339	756	750	756	6	2	3	750
FBgn0003346	787	750	775	49	11	4.454545454545454	738
FBgn0003353	756	750	739	23	8	2.875	733
FBgn0003356	729	683	664	111	13	8.538461538461538	618
FBgn0003357	753	750	753	3	1	3	750
FBgn0003366	763	750	682	94	15	6.266666666666667	669
FBgn0003371	662	654	635	35	6	5.833333333333333	627
FBgn0003372	797	750	744	100	11	9.090909090909092	697
FBgn0003377	812	750	803	71	10	7.1	741
FBgn0003378	820	750	820	70	9	7.777777777777778	750
FBgn0003380	751	750	712	40	5	8	711
FBgn0003382	759	750	723	45	8	5.625	714
FBgn0003388	760	750	745	25	7	3.5714285714285716	735
FBgn0003390	758	750	654	112	12	9.333333333333334	646
FBgn0003391	753	750	710	46	7	6.571428571428571	707
FBgn0003392	635	628	623	19	5	3.8	616
FBgn0003396	803	750	741	115	12	9.583333333333334	688
FBgn0003410	792	750	779	55	9	6.111111111111111	737
FBgn0003411	760	750	728	42	10	4.2	718
FBgn0003415	757	750	723	41	6	6.833333333333333	716
FBgn0003423	762	750	436	338	9	37.55555555555556	424
FBgn0003429	754	750	749	9	3	3	745
FBgn0003430	764	750	750	28	5	5.6	736
FBgn0003435	778	750	765	41	6	6.833333333333333	737
FBgn0003444	753	750	740	16	3	5.333333333333333	737
FBgn0003447	750	750	744	6	2	3	744
FBgn0003448	753	750	738	18	5	3.6	735
FBgn0003449	773	750	772	24	5	4.8	749
FBgn0003450	750	750	721	29	6	4.833333333333333	721
FBgn0003460	782	750	736	78	11	7.090909090909091	704
FBgn0003462	772	750	747	47	11	4.2727272727272725	725
FBgn0003463	779	750	746	62	12	5.166666666666667	717
FBgn0003464	762	750	759	15	7	2.142857142857143	747
FBgn0003479	761	750	724	48	6	8	713
FBgn0003480	531	514	516	32	4	8	499
FBgn0003482	603	584	602	20	3	6.666666666666667	583
FBgn0003483	756	750	715	47	8	5.875	709
FBgn0003495	793	750	706	130	15	8.666666666666666	663
FBgn0003499	793	750	781	55	5	11	738
FBgn0003507	860	750	845	125	7	17.857142857142858	735
FBgn0003512	764	750	736	42	6	7	722
FBgn0003513	751	750	751	1	1	1	750
FBgn0003514	764	750	729	49	8	6.125	715
FBgn0003515	826	750	791	111	9	12.333333333333334	715
FBgn0003517	767	750	750	34	7	4.857142857142857	733
FBgn0003520	761	750	760	12	4	3	749
FBgn0003525	764	750	728	50	8	6.25	714
FBgn0003545	795	750	793	47	6	7.833333333333333	748
FBgn0003557	750	750	731	19	4	4.75	731
FBgn0003567	773	750	769	27	7	3.857142857142857	746
FBgn0003575	750	750	723	27	3	9	723
FBgn0003598	750	750	728	22	4	5.5	728
FBgn0003607	751	750	738	14	3	4.666666666666667	737
FBgn0003655	752	750	732	22	4	5.5	730
FBgn0003660	809	750	800	68	10	6.8	741
FBgn0003701	750	750	562	188	4	47	562
FBgn0003714	751	750	742	10	4	2.5	741
FBgn0003716	761	750	757	15	6	2.5	746
FBgn0003719	766	750	738	44	6	7.333333333333333	722
FBgn0003720	750	750	608	142	2	71	608
FBgn0003721	750	750	748	2	1	2	748
FBgn0003733	807	750	805	59	6	9.833333333333334	748
FBgn0003744	750	750	727	23	3	7.666666666666667	727
FBgn0003747	782	750	763	51	13	3.923076923076923	731
FBgn0003748	765	750	729	51	11	4.636363636363637	714
FBgn0003861	787	750	735	89	8	11.125	698
FBgn0003862	750	750	697	53	3	17.666666666666668	697
FBgn0003865	750	750	343	407	2	203.5	343
FBgn0003866	757	750	755	9	4	2.25	748
FBgn0003867	775	750	775	25	2	12.5	750
FBgn0003870	750	750	728	22	2	11	728
FBgn0003882	838	750	650	276	13	21.23076923076923	562
FBgn0003885	783	750	672	144	13	11.076923076923077	639
FBgn0003886	787	750	753	71	12	5.916666666666667	716
FBgn0003888	763	750	722	54	10	5.4	709
FBgn0003890	771	750	747	45	15	3	726
FBgn0003892	771	750	733	59	11	5.363636363636363	712
FBgn0003896	751	750	725	27	5	5.4	724
FBgn0003936	760	750	736	34	7	4.857142857142857	726
FBgn0003938	755	750	733	27	6	4.5	728
FBgn0003941	769	750	707	81	14	5.785714285714286	688
FBgn0003943	751	750	746	6	4	1.5	745
FBgn0003944	753	750	490	266	4	66.5	487
FBgn0003950	765	750	715	65	11	5.909090909090909	700
FBgn0003965	802	750	780	74	9	8.222222222222221	728
FBgn0003969	772	750	746	48	9	5.333333333333333	724
FBgn0003975	754	750	748	10	4	2.5	744
FBgn0003977	764	750	734	44	9	4.888888888888889	720
FBgn0003978	763	750	727	49	9	5.444444444444445	714
FBgn0003979	750	750	374	376	1	376	374
FBgn0003983	767	750	759	25	7	3.5714285714285716	742
FBgn0003984	826	750	826	76	7	10.857142857142858	750
FBgn0003997	780	750	736	74	10	7.4	706
FBgn0004003	755	750	732	28	3	9.333333333333334	727
FBgn0004034	764	750	740	38	7	5.428571428571429	726
FBgn0004045	765	750	736	44	9	4.888888888888889	721
FBgn0004047	784	750	649	169	18	9.38888888888889	615
FBgn0004049	754	750	751	7	5	1.4	747
FBgn0004050	753	750	752	4	2	2	749
FBgn0004052	790	750	784	46	7	6.571428571428571	744
FBgn0004053	752	750	752	2	2	1	750
FBgn0004054	816	750	760	122	11	11.090909090909092	694
FBgn0004055	814	750	788	90	10	9	724
FBgn0004066	765	750	753	27	7	3.857142857142857	738
FBgn0004101	769	750	764	24	3	8	745
FBgn0004102	763	750	757	19	3	6.333333333333333	744
FBgn0004103	783	750	776	40	7	5.714285714285714	743
FBgn0004106	783	750	762	54	11	4.909090909090909	729
FBgn0004108	750	750	740	10	2	5	740
FBgn0004110	782	750	766	48	8	6	734
FBgn0004117	753	750	729	27	8	3.375	726
FBgn0004132	755	750	749	11	4	2.75	744
FBgn0004133	770	750	754	36	6	6	734
FBgn0004143	800	750	764	86	14	6.142857142857143	714
FBgn0004168	784	750	742	76	11	6.909090909090909	708
FBgn0004169	759	750	757	11	5	2.2	748
FBgn0004170	762	750	758	16	5	3.2	746
FBgn0004172	758	750	712	54	6	9	704
FBgn0004173	679	675	640	43	8	5.375	636
FBgn0004175	662	588	583	153	15	10.2	509
FBgn0004177	751	750	545	207	7	29.571428571428573	544
FBgn0004185	756	750	741	21	8	2.625	735
FBgn0004191	540	540	315	225	3	75	315
FBgn0004192	758	750	746	20	8	2.5	738
FBgn0004197	750	750	741	9	2	4.5	741
FBgn0004198	796	750	794	48	6	8	748
FBgn0004228	727	725	691	38	5	7.6	689
FBgn0004237	817	750	679	205	13	15.76923076923077	612
FBgn0004242	781	750	733	79	11	7.181818181818182	702
FBgn0004244	756	750	748	14	4	3.5	742
FBgn0004359	751	750	736	16	4	4	735
FBgn0004360	786	750	769	53	8	6.625	733
FBgn0004362	761	750	668	104	12	8.666666666666666	657
FBgn0004363	751	750	728	24	4	6	727
FBgn0004367	755	750	746	14	5	2.8	741
FBgn0004368	800	750	772	78	5	15.6	722
FBgn0004369	777	750	773	31	5	6.2	746
FBgn0004372	809	750	783	85	12	7.083333333333333	724
FBgn0004373	753	750	735	21	5	4.2	732
FBgn0004374	751	750	745	7	2	3.5	744
FBgn0004379	752	750	752	2	2	1	750
FBgn0004380	784	750	747	71	17	4.176470588235294	713
FBgn0004389	770	750	768	22	5	4.4	748
FBgn0004390	757	750	742	22	10	2.2	735
FBgn0004391	754	750	754	4	2	2	750
FBgn0004394	787	750	748	76	11	6.909090909090909	711
FBgn0004396	814	750	807	71	9	7.888888888888889	743
FBgn0004397	752	750	726	28	5	5.6	724
FBgn0004401	612	577	544	103	11	9.363636363636363	509
FBgn0004403	766	750	763	19	4	4.75	747
FBgn0004414	750	750	744	6	1	6	744
FBgn0004419	836	750	808	114	16	7.125	722
FBgn0004427	768	750	758	28	5	5.6	740
FBgn0004429	785	750	761	59	8	7.375	726
FBgn0004432	771	750	663	129	8	16.125	642
FBgn0004449	773	750	717	79	7	11.285714285714286	694
FBgn0004507	763	750	749	27	8	3.375	736
FBgn0004509	784	750	781	37	5	7.4	747
FBgn0004510	781	750	736	76	6	12.666666666666666	705
FBgn0004511	770	750	695	95	8	11.875	675
FBgn0004512	768	750	726	60	13	4.615384615384615	708
FBgn0004513	751	750	750	2	2	1	749
FBgn0004514	821	750	803	89	13	6.846153846153846	732
FBgn0004516	772	750	764	30	7	4.285714285714286	742
FBgn0004552	750	750	748	2	2	1	748
FBgn0004567	751	750	739	13	6	2.1666666666666665	738
FBgn0004569	817	750	785	99	8	12.375	718
FBgn0004574	750	750	749	1	1	1	749
FBgn0004575	786	750	764	58	7	8.285714285714286	728
FBgn0004577	761	750	723	49	8	6.125	712
FBgn0004580	750	750	749	1	1	1	749
FBgn0004581	709	696	689	33	9	3.6666666666666665	676
FBgn0004583	811	750	800	72	7	10.285714285714286	739
FBgn0004584	774	750	752	46	7	6.571428571428571	728
FBgn0004587	817	750	711	173	12	14.416666666666666	644
FBgn0004588	759	750	755	13	4	3.25	746
FBgn0004589	762	750	755	19	8	2.375	743
FBgn0004590	750	750	741	9	3	3	741
FBgn0004591	750	750	748	2	1	2	748
FBgn0004592	738	734	738	4	2	2	734
FBgn0004593	792	750	789	45	5	9	747
FBgn0004594	792	750	551	283	3	94.33333333333333	509
FBgn0004595	758	750	758	8	2	4	750
FBgn0004597	753	750	751	5	3	1.6666666666666667	748
FBgn0004598	754	750	754	4	1	4	750
FBgn0004606	753	750	747	9	5	1.8	744
FBgn0004607	786	750	785	37	5	7.4	749
FBgn0004611	784	750	768	50	6	8.333333333333334	734
FBgn0004618	772	750	703	91	9	10.11111111111111	681
FBgn0004619	755	750	754	6	3	2	749
FBgn0004622	801	750	762	90	7	12.857142857142858	711
FBgn0004623	751	750	738	14	3	4.666666666666667	737
FBgn0004635	785	750	713	107	13	8.23076923076923	678
FBgn0004638	750	750	750	0	0	NA	750
FBgn0004643	784	750	757	61	12	5.083333333333333	723
FBgn0004644	768	750	739	47	11	4.2727272727272725	721
FBgn0004647	785	750	666	154	13	11.846153846153847	631
FBgn0004648	644	641	643	4	3	1.3333333333333333	640
FBgn0004649	750	750	709	41	4	10.25	709
FBgn0004650	754	750	744	14	4	3.5	740
FBgn0004652	763	750	726	50	9	5.555555555555555	713
FBgn0004656	752	750	751	3	3	1	749
FBgn0004657	753	750	747	9	4	2.25	744
FBgn0004666	767	750	697	87	12	7.25	680
FBgn0004687	751	750	750	2	2	1	749
FBgn0004698	778	750	762	44	8	5.5	734
FBgn0004777	756	750	756	6	1	6	750
FBgn0004780	751	750	673	79	5	15.8	672
FBgn0004781	789	750	783	45	6	7.5	744
FBgn0004782	834	750	785	133	8	16.625	701
FBgn0004783	812	750	745	129	11	11.727272727272727	683
FBgn0004784	780	750	730	80	8	10	700
FBgn0004795	753	750	738	18	5	3.6	735
FBgn0004797	775	750	757	43	7	6.142857142857143	732
FBgn0004811	774	750	759	39	9	4.333333333333333	735
FBgn0004832	754	750	751	7	3	2.3333333333333335	747
FBgn0004837	751	750	737	15	4	3.75	736
FBgn0004838	755	750	729	31	11	2.8181818181818183	724
FBgn0004839	782	750	744	70	10	7	712
FBgn0004841	781	750	713	99	10	9.9	682
FBgn0004842	761	748	729	45	5	9	716
FBgn0004852	779	750	708	100	7	14.285714285714286	679
FBgn0004854	756	750	706	56	3	18.666666666666668	700
FBgn0004855	770	750	767	23	5	4.6	747
FBgn0004858	761	750	755	17	7	2.4285714285714284	744
FBgn0004859	795	750	704	136	13	10.461538461538462	659
FBgn0004862	804	750	793	65	7	9.285714285714286	739
FBgn0004863	750	750	749	1	1	1	749
FBgn0004864	756	750	716	46	6	7.666666666666667	710
FBgn0004865	755	750	755	5	2	2.5	750
FBgn0004868	773	750	766	30	9	3.3333333333333335	743
FBgn0004870	764	750	739	39	4	9.75	725
FBgn0004872	751	750	500	252	2	126	499
FBgn0004875	722	679	668	97	8	12.125	625
FBgn0004878	779	750	766	42	10	4.2	737
FBgn0004880	750	750	749	1	1	1	749
FBgn0004882	757	750	740	24	7	3.4285714285714284	733
FBgn0004885	753	750	739	17	5	3.4	736
FBgn0004889	767	750	730	54	13	4.153846153846154	713
FBgn0004892	758	750	705	61	4	15.25	697
FBgn0004893	761	750	744	28	6	4.666666666666667	733
FBgn0004895	766	750	718	64	7	9.142857142857142	702
FBgn0004896	751	750	737	15	2	7.5	736
FBgn0004897	817	750	800	84	9	9.333333333333334	733
FBgn0004898	755	750	751	9	4	2.25	746
FBgn0004901	763	708	755	63	8	7.875	700
FBgn0004903	778	750	770	36	4	9	742
FBgn0004907	750	750	750	0	0	NA	750
FBgn0004908	759	750	752	16	4	4	743
FBgn0004910	780	750	761	49	5	9.8	731
FBgn0004911	760	750	722	48	9	5.333333333333333	712
FBgn0004913	750	750	211	539	2	269.5	211
FBgn0004914	801	750	797	55	5	11	746
FBgn0004915	761	750	761	11	3	3.6666666666666665	750
FBgn0004921	754	750	749	9	4	2.25	745
FBgn0004924	785	750	773	47	9	5.222222222222222	738
FBgn0004926	758	750	684	82	12	6.833333333333333	676
FBgn0004956	771	750	759	33	4	8.25	738
FBgn0004957	751	750	747	5	3	1.6666666666666667	746
FBgn0004959	787	750	784	40	7	5.714285714285714	747
FBgn0005198	767	750	712	72	14	5.142857142857143	695
FBgn0005278	750	750	739	11	2	5.5	739
FBgn0005355	651	650	650	2	2	1	649
FBgn0005390	762	750	746	28	7	4	734
FBgn0005391	758	750	730	36	6	6	722
FBgn0005411	754	750	717	41	4	10.25	713
FBgn0005533	799	750	786	62	7	8.857142857142858	737
FBgn0005558	806	750	781	81	14	5.785714285714286	725
FBgn0005564	793	750	785	51	5	10.2	742
FBgn0005585	750	750	746	4	2	2	746
FBgn0005590	764	750	738	40	7	5.714285714285714	724
FBgn0005596	751	750	735	17	2	8.5	734
FBgn0005612	763	750	756	20	7	2.857142857142857	743
FBgn0005613	759	750	746	22	7	3.142857142857143	737
FBgn0005614	755	750	658	102	9	11.333333333333334	653
FBgn0005616	750	750	736	14	1	14	736
FBgn0005619	795	750	789	51	5	10.2	744
FBgn0005624	752	750	747	7	4	1.75	745
FBgn0005626	774	750	760	38	4	9.5	736
FBgn0005632	761	750	740	32	9	3.5555555555555554	729
FBgn0005636	768	750	766	20	3	6.666666666666667	748
FBgn0005640	802	750	791	63	12	5.25	739
FBgn0005642	769	750	699	89	7	12.714285714285714	680
FBgn0005649	750	750	748	2	1	2	748
FBgn0005659	777	750	747	57	7	8.142857142857142	720
FBgn0005660	772	750	718	76	10	7.6	696
FBgn0005664	758	750	739	27	3	9	731
FBgn0005666	791	750	655	177	14	12.642857142857142	614
FBgn0005670	771	750	739	53	8	6.625	718
FBgn0005671	750	750	735	15	3	5	735
FBgn0005672	766	750	739	43	7	6.142857142857143	723
FBgn0005674	755	750	728	32	4	8	723
FBgn0005677	757	750	756	8	2	4	749
FBgn0005683	823	750	816	80	12	6.666666666666667	743
FBgn0005695	785	750	771	49	9	5.444444444444445	736
FBgn0005696	752	750	679	75	6	12.5	677
FBgn0005771	754	750	754	4	2	2	750
FBgn0005775	750	750	683	67	3	22.333333333333332	683
FBgn0005777	782	750	781	33	8	4.125	749
FBgn0005778	762	750	759	15	4	3.75	747
FBgn0005779	776	750	432	370	6	61.666666666666664	406
FBgn0008635	811	750	782	90	14	6.428571428571429	721
FBgn0008636	763	750	755	21	6	3.5	742
FBgn0008646	765	750	760	20	6	3.3333333333333335	745
FBgn0008651	758	750	751	15	9	1.6666666666666667	743
FBgn0010015	759	750	725	43	9	4.777777777777778	716
FBgn0010041	764	750	294	484	8	60.5	280
FBgn0010042	729	713	285	460	4	115	269
FBgn0010043	686	680	334	358	4	89.5	328
FBgn0010044	809	750	751	117	16	7.3125	692
FBgn0010051	798	750	726	120	14	8.571428571428571	678
FBgn0010052	765	719	736	75	10	7.5	690
FBgn0010053	750	750	737	13	5	2.6	737
FBgn0010078	789	750	757	71	9	7.888888888888889	718
FBgn0010097	752	750	745	9	6	1.5	743
FBgn0010105	758	750	758	8	6	1.3333333333333333	750
FBgn0010109	756	750	696	66	6	11	690
FBgn0010113	764	750	737	41	8	5.125	723
FBgn0010114	795	750	746	94	8	11.75	701
FBgn0010173	814	750	784	94	12	7.833333333333333	720
FBgn0010194	663	660	651	15	4	3.75	648
FBgn0010197	763	750	757	19	6	3.1666666666666665	744
FBgn0010198	751	750	469	283	5	56.6	468
FBgn0010213	755	750	739	21	5	4.2	734
FBgn0010217	758	750	667	99	7	14.142857142857142	659
FBgn0010220	751	750	722	30	7	4.285714285714286	721
FBgn0010222	751	750	746	6	2	3	745
FBgn0010223	755	750	720	40	8	5	715
FBgn0010226	754	750	722	36	8	4.5	718
FBgn0010235	752	750	752	2	2	1	750
FBgn0010238	758	750	751	15	6	2.5	743
FBgn0010240	592	579	563	42	13	3.230769230769231	550
FBgn0010241	775	750	762	38	10	3.8	737
FBgn0010263	753	750	743	13	4	3.25	740
FBgn0010265	750	750	748	2	2	1	748
FBgn0010269	769	750	748	40	7	5.714285714285714	729
FBgn0010278	757	750	715	49	7	7	708
FBgn0010280	754	750	300	458	6	76.33333333333333	296
FBgn0010282	751	750	751	1	1	1	750
FBgn0010287	759	750	759	9	1	9	750
FBgn0010288	770	750	770	20	2	10	750
FBgn0010292	773	750	765	31	7	4.428571428571429	742
FBgn0010296	792	750	747	87	12	7.25	705
FBgn0010300	773	750	771	25	5	5	748
FBgn0010303	752	750	735	19	7	2.7142857142857144	733
FBgn0010309	752	750	729	25	9	2.7777777777777777	727
FBgn0010313	773	750	769	27	5	5.4	746
FBgn0010314	810	750	774	96	13	7.384615384615385	714
FBgn0010315	773	750	754	42	9	4.666666666666667	731
FBgn0010316	791	750	753	79	11	7.181818181818182	712
FBgn0010317	568	519	560	57	5	11.4	511
FBgn0010323	756	750	749	13	3	4.333333333333333	743
FBgn0010329	762	750	746	28	5	5.6	734
FBgn0010333	754	750	753	5	3	1.6666666666666667	749
FBgn0010339	751	750	745	7	5	1.4	744
FBgn0010340	750	750	744	6	2	3	744
FBgn0010350	750	750	750	0	0	NA	750
FBgn0010356	751	750	735	17	4	4.25	734
FBgn0010357	752	750	752	2	1	2	750
FBgn0010379	786	750	768	54	7	7.714285714285714	732
FBgn0010380	784	750	732	86	8	10.75	698
FBgn0010382	787	750	759	65	12	5.416666666666667	722
FBgn0010383	764	750	726	52	13	4	712
FBgn0010385	761	750	715	57	8	7.125	704
FBgn0010388	763	750	739	37	8	4.625	726
FBgn0010389	793	750	746	90	13	6.923076923076923	703
FBgn0010391	757	750	730	34	7	4.857142857142857	723
FBgn0010397	752	750	727	27	7	3.857142857142857	725
FBgn0010398	757	750	756	8	3	2.6666666666666665	749
FBgn0010399	752	750	624	130	8	16.25	622
FBgn0010401	750	750	747	3	3	1	747
FBgn0010403	765	750	759	21	3	7	744
FBgn0010406	779	750	743	65	11	5.909090909090909	714
FBgn0010409	750	750	746	4	2	2	746
FBgn0010411	750	750	747	3	1	3	747
FBgn0010412	754	750	748	10	4	2.5	744
FBgn0010414	755	750	752	8	4	2	747
FBgn0010415	751	750	745	7	5	1.4	744
FBgn0010416	754	750	745	13	4	3.25	741
FBgn0010422	753	750	217	539	7	77	214
FBgn0010423	753	750	719	37	5	7.4	716
FBgn0010424	781	750	748	64	7	9.142857142857142	717
FBgn0010433	750	750	750	0	0	NA	750
FBgn0010434	614	580	595	53	9	5.888888888888889	561
FBgn0010435	773	750	772	24	4	6	749
FBgn0010441	800	750	765	85	9	9.444444444444445	715
FBgn0010452	752	750	734	20	4	5	732
FBgn0010453	767	750	760	24	6	4	743
FBgn0010470	805	750	795	65	12	5.416666666666667	740
FBgn0010473	751	750	732	20	7	2.857142857142857	731
FBgn0010482	783	750	704	112	10	11.2	671
FBgn0010488	761	750	696	76	9	8.444444444444445	685
FBgn0010497	776	750	682	120	10	12	656
FBgn0010501	764	750	756	22	4	5.5	742
FBgn0010516	774	750	770	28	8	3.5	746
FBgn0010548	776	750	723	79	11	7.181818181818182	697
FBgn0010549	753	750	424	332	7	47.42857142857143	421
FBgn0010551	769	750	703	85	11	7.7272727272727275	684
FBgn0010583	750	750	750	0	0	NA	750
FBgn0010590	762	750	741	33	5	6.6	729
FBgn0010591	750	750	749	1	1	1	749
FBgn0010602	662	660	543	121	6	20.166666666666668	541
FBgn0010607	761	750	752	20	3	6.666666666666667	741
FBgn0010611	768	750	768	18	4	4.5	750
FBgn0010612	754	750	719	39	9	4.333333333333333	715
FBgn0010620	763	750	740	36	14	2.5714285714285716	727
FBgn0010621	762	750	757	17	6	2.8333333333333335	745
FBgn0010638	758	750	718	48	7	6.857142857142857	710
FBgn0010651	761	750	673	99	7	14.142857142857142	662
FBgn0010660	772	750	761	33	6	5.5	739
FBgn0010747	754	750	749	9	4	2.25	745
FBgn0010750	801	750	544	308	9	34.22222222222222	493
FBgn0010768	774	750	694	104	14	7.428571428571429	670
FBgn0010770	762	750	759	15	4	3.75	747
FBgn0010772	753	750	644	112	5	22.4	641
FBgn0010786	750	750	740	10	2	5	740
FBgn0010803	754	750	703	55	3	18.333333333333332	699
FBgn0010808	750	750	730	20	7	2.857142857142857	730
FBgn0010812	765	750	764	16	2	8	749
FBgn0010825	766	750	746	36	6	6	730
FBgn0010830	777	750	763	41	10	4.1	736
FBgn0010877	751	750	750	2	2	1	749
FBgn0010905	782	750	769	45	11	4.090909090909091	737
FBgn0010909	811	750	746	126	17	7.411764705882353	685
FBgn0010926	758	750	746	20	4	5	738
FBgn0011016	803	750	779	77	10	7.7	726
FBgn0011202	754	750	730	28	5	5.6	726
FBgn0011204	751	750	732	20	3	6.666666666666667	731
FBgn0011205	775	750	772	28	6	4.666666666666667	747
FBgn0011206	757	750	755	9	5	1.8	748
FBgn0011211	759	750	751	17	5	3.4	742
FBgn0011217	761	750	752	20	6	3.3333333333333335	741
FBgn0011224	752	750	720	34	7	4.857142857142857	718
FBgn0011227	750	750	748	2	1	2	748
FBgn0011232	755	750	737	23	7	3.2857142857142856	732
FBgn0011239	773	750	589	207	6	34.5	566
FBgn0011244	789	750	767	61	8	7.625	728
FBgn0011260	758	750	752	14	4	3.5	744
FBgn0011272	756	750	755	7	2	3.5	749
FBgn0011277	753	750	720	36	7	5.142857142857143	717
FBgn0011278	756	750	756	6	2	3	750
FBgn0011279	758	750	754	12	2	6	746
FBgn0011280	751	750	663	89	9	9.88888888888889	662
FBgn0011281	750	750	746	4	1	4	746
FBgn0011282	750	750	746	4	2	2	746
FBgn0011283	795	750	794	46	5	9.2	749
FBgn0011284	795	750	780	60	12	5	735
FBgn0011289	750	750	734	16	2	8	734
FBgn0011290	755	750	755	5	2	2.5	750
FBgn0011291	752	750	720	34	5	6.8	718
FBgn0011293	799	750	768	80	12	6.666666666666667	719
FBgn0011294	758	750	743	23	2	11.5	735
FBgn0011296	754	750	734	24	4	6	730
FBgn0011297	787	750	783	41	8	5.125	746
FBgn0011305	766	750	736	46	11	4.181818181818182	720
FBgn0011327	750	750	750	0	0	NA	750
FBgn0011335	764	750	747	31	4	7.75	733
FBgn0011336	751	750	749	3	3	1	748
FBgn0011361	541	533	541	8	4	2	533
FBgn0011455	755	750	687	73	9	8.11111111111111	682
FBgn0011476	771	750	740	52	7	7.428571428571429	719
FBgn0011481	754	750	742	16	7	2.2857142857142856	738
FBgn0011554	571	530	555	57	8	7.125	514
FBgn0011555	810	750	759	111	9	12.333333333333334	699
FBgn0011556	514	502	483	43	7	6.142857142857143	471
FBgn0011569	756	750	722	40	11	3.6363636363636362	716
FBgn0011570	759	750	743	25	7	3.5714285714285716	734
FBgn0011573	756	750	756	6	3	2	750
FBgn0011581	750	750	735	15	2	7.5	735
FBgn0011582	716	706	611	115	3	38.333333333333336	601
FBgn0011584	792	750	738	96	12	8	696
FBgn0011589	787	750	763	61	9	6.777777777777778	726
FBgn0011591	750	750	680	70	5	14	680
FBgn0011603	750	750	731	19	3	6.333333333333333	731
FBgn0011604	793	750	793	43	3	14.333333333333334	750
FBgn0011606	756	750	750	12	2	6	744
FBgn0011638	803	750	762	94	7	13.428571428571429	709
FBgn0011640	755	750	748	12	5	2.4	743
FBgn0011648	755	750	755	5	2	2.5	750
FBgn0011653	759	750	719	49	11	4.454545454545454	710
FBgn0011655	760	750	758	12	6	2	748
FBgn0011659	615	611	604	15	4	3.75	600
FBgn0011661	779	750	591	217	12	18.083333333333332	562
FBgn0011666	763	750	743	33	15	2.2	730
FBgn0011668	813	750	811	65	8	8.125	748
FBgn0011669	750	734	695	71	7	10.142857142857142	679
FBgn0011672	761	750	728	44	10	4.4	717
FBgn0011676	752	750	732	22	3	7.333333333333333	730
FBgn0011693	770	750	760	30	7	4.285714285714286	740
FBgn0011695	526	524	525	3	2	1.5	523
FBgn0011701	817	750	757	127	10	12.7	690
FBgn0011704	785	750	782	38	11	3.4545454545454546	747
FBgn0011705	794	750	777	61	12	5.083333333333333	733
FBgn0011706	767	750	733	51	11	4.636363636363637	716
FBgn0011708	759	750	751	17	6	2.8333333333333335	742
FBgn0011710	785	750	753	67	11	6.090909090909091	718
FBgn0011715	751	750	719	33	7	4.714285714285714	718
FBgn0011722	753	750	723	33	5	6.6	720
FBgn0011723	781	750	781	31	7	4.428571428571429	750
FBgn0011725	778	750	769	37	9	4.111111111111111	741
FBgn0011737	751	750	743	9	5	1.8	742
FBgn0011739	767	750	752	32	9	3.5555555555555554	735
FBgn0011740	755	750	754	6	5	1.2	749
FBgn0011742	826	750	822	80	8	10	746
FBgn0011743	767	750	757	27	5	5.4	740
FBgn0011745	751	750	750	2	2	1	749
FBgn0011746	750	750	513	237	1	237	513
FBgn0011754	759	750	745	23	7	3.2857142857142856	736
FBgn0011758	841	750	829	103	10	10.3	738
FBgn0011763	753	750	751	5	2	2.5	748
FBgn0011766	762	750	733	41	8	5.125	721
FBgn0011768	790	750	773	57	11	5.181818181818182	733
FBgn0011774	750	750	742	8	5	1.6	742
FBgn0011785	759	750	747	21	7	3	738
FBgn0011802	832	750	825	89	13	6.846153846153846	743
FBgn0011812	796	706	728	158	12	13.166666666666666	638
FBgn0011817	751	750	731	21	5	4.2	730
FBgn0011818	803	750	792	64	5	12.8	739
FBgn0011824	798	750	795	51	7	7.285714285714286	747
FBgn0011826	755	750	738	22	8	2.75	733
FBgn0011829	645	638	600	52	4	13	593
FBgn0011836	764	750	761	17	7	2.4285714285714284	747
FBgn0011837	762	750	697	77	11	7	685
FBgn0011840	750	750	738	12	2	6	738
FBgn0011850	765	750	742	38	12	3.1666666666666665	727
FBgn0011851	757	750	738	26	7	3.7142857142857144	731
FBgn0011858	780	750	778	32	5	6.4	748
FBgn0011859	755	750	753	7	4	1.75	748
FBgn0011860	798	750	788	58	4	14.5	740
FBgn0011861	751	750	734	18	4	4.5	733
FBgn0011862	755	750	735	25	6	4.166666666666667	730
FBgn0011864	782	750	779	35	5	7	747
FBgn0011866	750	750	631	119	3	39.666666666666664	631
FBgn0011867	798	750	782	64	13	4.923076923076923	734
FBgn0011868	755	750	716	44	6	7.333333333333333	711
FBgn0011869	750	750	726	24	6	4	726
FBgn0011896	754	750	742	16	7	2.2857142857142856	738
FBgn0011897	827	750	658	246	12	20.5	581
FBgn0011902	830	750	826	84	10	8.4	746
FBgn0011906	767	750	752	32	5	6.4	735
FBgn0011919	851	750	767	185	18	10.277777777777779	666
FBgn0011921	774	750	742	56	4	14	718
FBgn0011952	787	750	768	56	10	5.6	731
FBgn0011955	800	750	797	53	6	8.833333333333334	747
FBgn0011956	795	750	777	63	9	7	732
FBgn0011958	763	750	729	47	6	7.833333333333333	716
FBgn0011959	788	750	787	39	5	7.8	749
FBgn0011965	775	750	702	98	8	12.25	677
FBgn0011966	777	750	752	52	11	4.7272727272727275	725
FBgn0011970	798	750	774	72	14	5.142857142857143	726
FBgn0011971	762	750	727	47	13	3.6153846153846154	715
FBgn0011974	772	750	683	111	10	11.1	661
FBgn0011982	756	750	697	65	8	8.125	691
FBgn0011983	778	750	766	40	10	4	738
FBgn0011986	773	750	767	29	7	4.142857142857143	744
FBgn0011994	792	750	789	45	6	7.5	747
FBgn0011999	758	750	758	8	2	4	750
FBgn0012001	772	750	707	87	9	9.666666666666666	685
FBgn0012003	753	750	651	105	4	26.25	648
FBgn0012004	752	750	746	8	5	1.6	744
FBgn0012010	758	750	757	9	4	2.25	749
FBgn0012016	752	750	750	4	4	1	748
FBgn0012017	752	750	748	6	3	2	746
FBgn0012027	714	712	707	9	5	1.8	705
FBgn0012036	756	750	578	184	9	20.444444444444443	572
FBgn0012037	751	750	455	297	4	74.25	454
FBgn0012042	752	750	701	53	4	13.25	699
FBgn0012051	751	750	705	47	3	15.666666666666666	704
FBgn0013269	758	750	750	16	3	5.333333333333333	742
FBgn0013272	843	750	837	99	8	12.375	744
FBgn0013305	750	750	748	2	1	2	748
FBgn0013307	753	750	743	13	4	3.25	740
FBgn0013308	643	614	628	44	11	4	599
FBgn0013323	751	750	731	21	4	5.25	730
FBgn0013325	568	550	517	69	7	9.857142857142858	499
FBgn0013348	755	750	442	318	3	106	437
FBgn0013432	754	750	736	22	5	4.4	732
FBgn0013433	760	750	706	64	10	6.4	696
FBgn0013435	767	750	767	17	4	4.25	750
FBgn0013469	750	750	616	134	5	26.8	616
FBgn0013531	750	750	750	0	0	NA	750
FBgn0013548	754	750	742	16	5	3.2	738
FBgn0013563	776	750	759	43	6	7.166666666666667	733
FBgn0013576	772	750	722	72	5	14.4	700
FBgn0013687	750	750	750	0	0	NA	750
FBgn0013702	750	750	750	0	0	NA	750
FBgn0013707	750	750	750	0	0	NA	750
FBgn0013710	750	750	750	0	0	NA	750
FBgn0013717	764	750	764	14	2	7	750
FBgn0013718	754	750	660	98	10	9.8	656
FBgn0013725	771	750	728	64	14	4.571428571428571	707
FBgn0013726	762	750	762	12	2	6	750
FBgn0013732	793	750	487	349	6	58.166666666666664	444
FBgn0013746	750	750	743	7	2	3.5	743
FBgn0013749	819	750	782	106	19	5.578947368421052	713
FBgn0013750	755	750	507	253	3	84.33333333333333	502
FBgn0013751	788	750	760	66	7	9.428571428571429	722
FBgn0013753	792	750	758	76	8	9.5	716
FBgn0013755	764	750	757	21	6	3.5	743
FBgn0013759	780	750	778	32	8	4	748
FBgn0013762	754	750	745	13	3	4.333333333333333	741
FBgn0013763	777	750	757	47	13	3.6153846153846154	730
FBgn0013764	759	750	746	22	5	4.4	737
FBgn0013765	750	750	747	3	3	1	747
FBgn0013767	697	679	677	38	6	6.333333333333333	659
FBgn0013770	763	750	761	15	3	5	748
FBgn0013773	765	750	760	20	7	2.857142857142857	745
FBgn0013799	752	750	744	10	3	3.3333333333333335	742
FBgn0013810	771	750	755	37	7	5.285714285714286	734
FBgn0013811	757	750	745	19	4	4.75	738
FBgn0013812	751	750	750	2	2	1	749
FBgn0013813	750	750	750	0	0	NA	750
FBgn0013949	767	750	748	36	3	12	731
FBgn0013953	771	750	760	32	9	3.5555555555555554	739
FBgn0013973	754	750	723	35	6	5.833333333333333	719
FBgn0013981	751	750	738	14	5	2.8	737
FBgn0013983	765	750	765	15	2	7.5	750
FBgn0013987	762	750	746	28	7	4	734
FBgn0013995	794	750	763	75	11	6.818181818181818	719
FBgn0013997	755	750	753	7	5	1.4	748
FBgn0014007	757	750	681	83	10	8.3	674
FBgn0014009	754	750	746	12	5	2.4	742
FBgn0014010	751	750	711	41	4	10.25	710
FBgn0014011	776	750	771	31	7	4.428571428571429	745
FBgn0014019	761	750	602	170	8	21.25	591
FBgn0014020	757	750	753	11	4	2.75	746
FBgn0014022	753	750	753	3	2	1.5	750
FBgn0014023	750	750	740	10	5	2	740
FBgn0014026	766	750	728	54	12	4.5	712
FBgn0014028	852	750	789	165	17	9.705882352941176	687
FBgn0014029	774	750	752	46	7	6.571428571428571	728
FBgn0014031	762	750	754	20	4	5	742
FBgn0014073	806	750	774	88	10	8.8	718
FBgn0014075	764	750	757	21	3	7	743
FBgn0014127	759	750	752	16	5	3.2	743
FBgn0014133	755	750	739	21	5	4.2	734
FBgn0014135	781	750	732	80	13	6.153846153846154	701
FBgn0014141	738	737	707	32	2	16	706
FBgn0014143	753	750	724	32	4	8	721
FBgn0014163	769	750	724	64	15	4.266666666666667	705
FBgn0014179	756	750	738	24	5	4.8	732
FBgn0014184	762	750	758	16	5	3.2	746
FBgn0014189	750	750	735	15	4	3.75	735
FBgn0014340	582	576	580	8	2	4	574
FBgn0014343	754	750	745	13	8	1.625	741
FBgn0014366	762	750	744	30	7	4.285714285714286	732
FBgn0014380	754	750	675	83	10	8.3	671
FBgn0014388	750	750	749	1	1	1	749
FBgn0014391	763	750	757	19	10	1.9	744
FBgn0014395	763	750	628	148	8	18.5	615
FBgn0014396	770	750	734	56	6	9.333333333333334	714
FBgn0014411	750	750	749	1	1	1	749
FBgn0014417	769	750	704	84	10	8.4	685
FBgn0014427	762	750	718	56	9	6.222222222222222	706
FBgn0014454	754	750	747	11	4	2.75	743
FBgn0014455	783	750	768	48	5	9.6	735
FBgn0014464	756	750	641	121	9	13.444444444444445	635
FBgn0014465	762	750	753	21	5	4.2	741
FBgn0014466	791	750	738	94	13	7.230769230769231	697
FBgn0014848	757	750	748	16	4	4	741
FBgn0014849	750	750	746	4	3	1.3333333333333333	746
FBgn0014850	750	750	742	8	3	2.6666666666666665	742
FBgn0014851	757	750	749	15	6	2.5	742
FBgn0014857	699	679	696	23	4	5.75	676
FBgn0014859	753	750	654	102	4	25.5	651
FBgn0014861	816	750	795	87	13	6.6923076923076925	729
FBgn0014868	756	750	751	11	4	2.75	745
FBgn0014869	755	750	753	7	2	3.5	748
FBgn0014870	797	750	771	73	7	10.428571428571429	724
FBgn0014877	759	750	738	30	7	4.285714285714286	729
FBgn0014879	753	750	745	11	3	3.6666666666666665	742
FBgn0014930	750	750	236	514	2	257	236
FBgn0014931	791	750	594	238	12	19.833333333333332	553
FBgn0014949	764	750	692	86	7	12.285714285714286	678
FBgn0015000	763	750	760	16	5	3.2	747
FBgn0015001	625	625	615	10	2	5	615
FBgn0015010	806	750	776	86	13	6.615384615384615	720
FBgn0015011	759	750	699	69	8	8.625	690
FBgn0015019	794	750	785	53	11	4.818181818181818	741
FBgn0015025	788	750	749	77	9	8.555555555555555	711
FBgn0015032	758	750	743	23	6	3.8333333333333335	735
FBgn0015033	752	750	752	2	1	2	750
FBgn0015035	750	750	714	36	4	9	714
FBgn0015038	624	567	585	96	8	12	528
FBgn0015039	799	750	775	73	9	8.11111111111111	726
FBgn0015040	756	750	739	23	5	4.6	733
FBgn0015075	755	750	546	214	7	30.571428571428573	541
FBgn0015218	750	750	717	33	1	33	717
FBgn0015221	750	750	743	7	2	3.5	743
FBgn0015222	765	750	764	16	3	5.333333333333333	749
FBgn0015229	778	750	707	99	12	8.25	679
FBgn0015230	751	750	745	7	3	2.3333333333333335	744
FBgn0015239	773	720	746	80	10	8	693
FBgn0015240	770	750	765	25	6	4.166666666666667	745
FBgn0015247	751	750	751	1	1	1	750
FBgn0015268	763	750	751	25	5	5	738
FBgn0015269	752	750	730	24	7	3.4285714285714284	728
FBgn0015270	750	750	405	345	7	49.285714285714285	405
FBgn0015271	750	750	748	2	2	1	748
FBgn0015279	772	750	731	63	16	3.9375	709
FBgn0015282	751	750	749	3	3	1	748
FBgn0015286	751	750	747	5	2	2.5	746
FBgn0015288	841	750	817	115	12	9.583333333333334	726
FBgn0015295	765	750	725	55	10	5.5	710
FBgn0015296	781	750	777	35	5	7	746
FBgn0015298	792	750	751	83	9	9.222222222222221	709
FBgn0015299	756	750	723	39	7	5.571428571428571	717
FBgn0015300	760	750	720	50	6	8.333333333333334	710
FBgn0015321	771	750	482	310	5	62	461
FBgn0015336	763	750	691	85	8	10.625	678
FBgn0015338	752	750	751	3	2	1.5	749
FBgn0015359	750	750	733	17	3	5.666666666666667	733
FBgn0015360	757	750	741	23	8	2.875	734
FBgn0015371	787	750	777	47	11	4.2727272727272725	740
FBgn0015372	754	750	753	5	3	1.6666666666666667	749
FBgn0015380	778	750	711	95	11	8.636363636363637	683
FBgn0015381	765	750	761	19	4	4.75	746
FBgn0015391	754	750	723	35	5	7	719
FBgn0015399	750	750	738	12	3	4	738
FBgn0015402	756	750	684	78	5	15.6	678
FBgn0015509	756	750	710	52	4	13	704
FBgn0015513	758	750	741	25	5	5	733
FBgn0015519	773	750	745	51	8	6.375	722
FBgn0015520	755	750	750	10	7	1.4285714285714286	745
FBgn0015521	758	750	751	15	7	2.142857142857143	743
FBgn0015524	750	750	747	3	2	1.5	747
FBgn0015527	762	750	760	14	6	2.3333333333333335	748
FBgn0015544	750	750	750	0	0	NA	750
FBgn0015546	750	750	279	471	4	117.75	279
FBgn0015550	755	750	742	18	7	2.5714285714285716	737
FBgn0015553	750	750	745	5	1	5	745
FBgn0015558	758	750	755	11	4	2.75	747
FBgn0015561	757	750	730	34	2	17	723
FBgn0015568	819	750	803	85	11	7.7272727272727275	734
FBgn0015569	752	750	742	12	4	3	740
FBgn0015570	574	530	544	74	12	6.166666666666667	500
FBgn0015571	781	750	301	511	6	85.16666666666667	270
FBgn0015572	776	750	733	69	7	9.857142857142858	707
FBgn0015575	764	750	726	52	15	3.466666666666667	712
FBgn0015576	763	750	718	58	6	9.666666666666666	705
FBgn0015577	762	750	590	184	7	26.285714285714285	578
FBgn0015582	759	745	681	92	17	5.411764705882353	667
FBgn0015585	750	750	718	32	4	8	718
FBgn0015586	789	750	770	58	7	8.285714285714286	731
FBgn0015591	757	750	757	7	1	7	750
FBgn0015602	773	750	353	443	6	73.83333333333333	330
FBgn0015609	797	750	750	94	15	6.266666666666667	703
FBgn0015615	770	750	756	34	10	3.4	736
FBgn0015618	755	750	412	348	4	87	407
FBgn0015621	751	750	732	20	3	6.666666666666667	731
FBgn0015623	752	750	750	4	3	1.3333333333333333	748
FBgn0015625	806	750	771	91	9	10.11111111111111	715
FBgn0015663	809	750	771	97	13	7.461538461538462	712
FBgn0015664	750	750	750	0	0	NA	750
FBgn0015714	598	583	558	55	7	7.857142857142857	543
FBgn0015721	714	676	699	53	10	5.3	661
FBgn0015737	794	750	789	49	8	6.125	745
FBgn0015754	763	750	759	17	8	2.125	746
FBgn0015756	803	750	791	65	9	7.222222222222222	738
FBgn0015765	761	750	750	22	5	4.4	739
FBgn0015766	770	750	752	38	7	5.428571428571429	732
FBgn0015770	752	750	743	11	4	2.75	741
FBgn0015772	768	750	767	19	2	9.5	749
FBgn0015773	750	750	702	48	8	6	702
FBgn0015776	758	750	751	15	4	3.75	743
FBgn0015777	811	750	788	84	10	8.4	727
FBgn0015778	786	750	750	72	7	10.285714285714286	714
FBgn0015781	750	750	748	2	2	1	748
FBgn0015789	768	750	768	18	3	6	750
FBgn0015790	777	700	759	95	11	8.636363636363637	682
FBgn0015791	751	750	751	1	1	1	750
FBgn0015793	755	750	717	43	6	7.166666666666667	712
FBgn0015794	804	750	775	83	12	6.916666666666667	721
FBgn0015795	750	750	747	3	2	1.5	747
FBgn0015797	766	750	736	46	7	6.571428571428571	720
FBgn0015801	756	750	714	48	4	12	708
FBgn0015803	809	750	773	95	7	13.571428571428571	714
FBgn0015805	778	750	768	38	11	3.4545454545454546	740
FBgn0015808	762	750	754	20	6	3.3333333333333335	742
FBgn0015818	786	750	771	51	6	8.5	735
FBgn0015828	754	750	711	47	7	6.714285714285714	707
FBgn0015829	805	750	781	79	12	6.583333333333333	726
FBgn0015831	779	750	761	47	7	6.714285714285714	732
FBgn0015872	755	750	711	49	15	3.2666666666666666	706
FBgn0015904	763	750	748	28	8	3.5	735
FBgn0015905	761	750	758	14	5	2.8	747
FBgn0015919	751	750	715	37	4	9.25	714
FBgn0015924	750	750	748	2	2	1	748
FBgn0015925	752	750	752	2	1	2	750
FBgn0015926	769	750	744	44	11	4	725
FBgn0015929	753	750	740	16	5	3.2	737
FBgn0015946	761	750	711	61	4	15.25	700
FBgn0015949	757	750	694	70	9	7.777777777777778	687
FBgn0016013	756	750	748	14	5	2.8	742
FBgn0016036	751	750	708	44	7	6.285714285714286	707
FBgn0016038	795	750	790	50	6	8.333333333333334	745
FBgn0016041	589	580	518	80	5	16	509
FBgn0016047	791	750	787	45	4	11.25	746
FBgn0016053	763	750	724	52	4	13	711
FBgn0016054	750	750	750	0	0	NA	750
FBgn0016059	757	750	736	28	5	5.6	729
FBgn0016061	758	750	757	9	3	3	749
FBgn0016070	750	750	735	15	5	3	735
FBgn0016075	787	750	694	130	13	10	657
FBgn0016076	591	582	586	14	6	2.3333333333333335	577
FBgn0016081	754	750	711	47	9	5.222222222222222	707
FBgn0016119	760	750	734	36	5	7.2	724
FBgn0016120	760	750	746	24	2	12	736
FBgn0016123	758	750	737	29	13	2.230769230769231	729
FBgn0016126	768	750	364	422	7	60.285714285714285	346
FBgn0016131	755	750	724	36	5	7.2	719
FBgn0016641	754	750	744	14	5	2.8	740
FBgn0016650	808	750	791	75	11	6.818181818181818	733
FBgn0016660	753	750	752	4	3	1.3333333333333333	749
FBgn0016672	750	750	714	36	4	9	714
FBgn0016675	783	750	709	107	12	8.916666666666666	676
FBgn0016684	565	543	565	22	2	11	543
FBgn0016685	750	750	749	1	1	1	749
FBgn0016687	753	750	719	37	8	4.625	716
FBgn0016691	569	561	528	49	7	7	520
FBgn0016694	752	750	692	62	10	6.2	690
FBgn0016697	794	750	794	44	5	8.8	750
FBgn0016698	752	750	745	9	6	1.5	743
FBgn0016715	767	750	645	139	11	12.636363636363637	628
FBgn0016726	772	750	762	32	4	8	740
FBgn0016754	755	750	747	13	3	4.333333333333333	742
FBgn0016762	763	750	751	25	7	3.5714285714285716	738
FBgn0016794	741	697	721	64	11	5.818181818181818	677
FBgn0016917	781	745	779	38	5	7.6	743
FBgn0016920	772	750	758	36	8	4.5	736
FBgn0016926	759	750	735	33	4	8.25	726
FBgn0016930	763	750	748	28	9	3.111111111111111	735
FBgn0016970	773	750	763	33	10	3.3	740
FBgn0016977	756	750	748	14	5	2.8	742
FBgn0016983	750	750	748	2	2	1	748
FBgn0017414	751	750	747	5	3	1.6666666666666667	746
FBgn0017424	772	750	739	55	12	4.583333333333333	717
FBgn0017429	762	750	752	22	7	3.142857142857143	740
FBgn0017430	750	750	703	47	1	47	703
FBgn0017448	767	750	759	25	5	5	742
FBgn0017457	769	750	765	23	3	7.666666666666667	746
FBgn0017482	754	750	741	17	5	3.4	737
FBgn0017545	808	750	709	157	14	11.214285714285714	651
FBgn0017551	766	750	601	181	8	22.625	585
FBgn0017556	760	750	728	42	8	5.25	718
FBgn0017558	754	750	718	40	7	5.714285714285714	714
FBgn0017561	754	750	737	21	6	3.5	733
FBgn0017566	798	750	733	113	13	8.692307692307692	685
FBgn0017567	754	750	707	51	6	8.5	703
FBgn0017572	757	750	705	59	11	5.363636363636363	698
FBgn0017577	769	750	767	21	3	7	748
FBgn0017578	762	750	736	38	6	6.333333333333333	724
FBgn0017579	756	750	729	33	4	8.25	723
FBgn0017581	750	750	739	11	3	3.6666666666666665	739
FBgn0017590	757	750	734	30	9	3.3333333333333335	727
FBgn0019624	751	750	741	11	2	5.5	740
FBgn0019637	750	750	747	3	1	3	747
FBgn0019644	770	750	762	28	4	7	742
FBgn0019650	758	750	603	163	2	81.5	595
FBgn0019662	775	750	748	52	6	8.666666666666666	723
FBgn0019686	788	750	765	61	10	6.1	727
FBgn0019809	751	750	721	31	5	6.2	720
FBgn0019830	750	750	738	12	3	4	738
FBgn0019890	780	750	718	92	8	11.5	688
FBgn0019925	752	750	740	14	4	3.5	738
FBgn0019928	752	750	742	12	6	2	740
FBgn0019929	763	750	733	43	10	4.3	720
FBgn0019932	752	750	752	2	2	1	750
FBgn0019936	755	750	753	7	3	2.3333333333333335	748
FBgn0019938	760	750	745	25	2	12.5	735
FBgn0019949	750	750	750	0	0	NA	750
FBgn0019952	764	750	734	44	11	4	720
FBgn0019957	760	750	716	54	7	7.714285714285714	706
FBgn0019960	750	750	748	2	1	2	748
FBgn0019972	772	750	759	35	6	5.833333333333333	737
FBgn0019985	773	750	740	56	11	5.090909090909091	717
FBgn0019990	766	750	721	61	6	10.166666666666666	705
FBgn0020018	754	750	749	9	3	3	745
FBgn0020224	778	750	743	63	11	5.7272727272727275	715
FBgn0020235	751	750	737	15	4	3.75	736
FBgn0020236	812	750	784	90	9	10	722
FBgn0020238	759	750	755	13	9	1.4444444444444444	746
FBgn0020248	765	750	726	54	12	4.5	711
FBgn0020249	752	750	720	34	4	8.5	718
FBgn0020251	750	750	737	13	4	3.25	737
FBgn0020258	772	750	772	22	6	3.6666666666666665	750
FBgn0020261	806	750	539	323	6	53.833333333333336	483
FBgn0020277	764	750	718	60	9	6.666666666666667	704
FBgn0020278	761	750	755	17	6	2.8333333333333335	744
FBgn0020279	824	750	823	75	7	10.714285714285714	749
FBgn0020280	757	750	745	19	2	9.5	738
FBgn0020299	766	750	725	57	9	6.333333333333333	709
FBgn0020300	781	750	562	250	9	27.77777777777778	531
FBgn0020305	755	750	732	28	8	3.5	727
FBgn0020306	790	750	789	41	3	13.666666666666666	749
FBgn0020307	805	750	757	103	12	8.583333333333334	702
FBgn0020309	796	750	790	52	14	3.7142857142857144	744
FBgn0020312	750	750	737	13	2	6.5	737
FBgn0020370	755	750	746	14	6	2.3333333333333335	741
FBgn0020371	762	750	728	46	6	7.666666666666667	716
FBgn0020376	865	750	842	138	8	17.25	727
FBgn0020377	751	750	724	28	8	3.5	723
FBgn0020378	755	750	723	37	10	3.7	718
FBgn0020379	750	750	711	39	3	13	711
FBgn0020381	750	750	743	7	3	2.3333333333333335	743
FBgn0020385	755	750	731	29	4	7.25	726
FBgn0020386	789	750	758	70	14	5	719
FBgn0020407	752	750	751	3	2	1.5	749
FBgn0020412	830	750	830	80	4	20	750
FBgn0020415	676	610	658	84	11	7.636363636363637	592
FBgn0020416	768	750	762	24	7	3.4285714285714284	744
FBgn0020429	656	644	649	19	7	2.7142857142857144	637
FBgn0020440	788	750	774	52	10	5.2	736
FBgn0020443	772	750	709	85	8	10.625	687
FBgn0020445	751	750	743	9	2	4.5	742
FBgn0020493	799	750	793	55	13	4.230769230769231	744
FBgn0020496	696	689	675	28	7	4	668
FBgn0020503	778	750	754	52	7	7.428571428571429	726
FBgn0020506	505	505	211	294	2	147	211
FBgn0020508	758	750	699	67	11	6.090909090909091	691
FBgn0020509	761	750	751	21	5	4.2	740
FBgn0020510	759	750	740	28	6	4.666666666666667	731
FBgn0020521	750	750	734	16	3	5.333333333333333	734
FBgn0020545	750	750	746	4	2	2	746
FBgn0020546	751	750	748	4	3	1.3333333333333333	747
FBgn0020556	751	750	743	9	5	1.8	742
FBgn0020616	750	750	734	16	2	8	734
FBgn0020617	750	750	746	4	3	1.3333333333333333	746
FBgn0020618	764	750	530	248	7	35.42857142857143	516
FBgn0020620	776	750	759	43	8	5.375	733
FBgn0020622	761	750	708	64	8	8	697
FBgn0020633	823	750	797	99	8	12.375	724
FBgn0020640	803	750	794	62	6	10.333333333333334	741
FBgn0020641	750	750	405	345	4	86.25	405
FBgn0020642	773	750	742	54	9	6	719
FBgn0020645	777	750	729	75	11	6.818181818181818	702
FBgn0020647	750	750	747	3	2	1.5	747
FBgn0020653	763	750	759	17	6	2.8333333333333335	746
FBgn0020655	791	750	720	112	11	10.181818181818182	679
FBgn0020765	750	750	728	22	4	5.5	728
FBgn0020880	751	750	736	16	5	3.2	735
FBgn0020887	750	750	748	2	1	2	748
FBgn0020906	750	750	731	19	3	6.333333333333333	731
FBgn0020907	750	750	745	5	1	5	745
FBgn0020912	750	750	748	2	1	2	748
FBgn0021742	768	750	714	72	12	6	696
FBgn0021750	769	750	722	66	9	7.333333333333333	703
FBgn0021761	803	750	787	69	10	6.9	734
FBgn0021764	765	750	746	34	9	3.7777777777777777	731
FBgn0021765	753	750	74	682	3	227.33333333333334	71
FBgn0021767	759	750	724	44	9	4.888888888888889	715
FBgn0021768	768	750	747	39	7	5.571428571428571	729
FBgn0021795	830	750	568	342	10	34.2	488
FBgn0021796	792	750	792	42	7	6	750
FBgn0021800	760	750	688	82	3	27.333333333333332	678
FBgn0021814	750	750	734	16	6	2.6666666666666665	734
FBgn0021825	799	750	772	76	10	7.6	723
FBgn0021847	784	750	764	54	7	7.714285714285714	730
FBgn0021856	750	750	30	720	1	720	30
FBgn0021874	798	750	796	50	7	7.142857142857143	748
FBgn0021875	752	750	751	3	3	1	749
FBgn0021895	750	750	750	0	0	NA	750
FBgn0021906	754	750	677	81	5	16.2	673
FBgn0021944	757	750	755	9	4	2.25	748
FBgn0021967	757	750	748	16	6	2.6666666666666665	741
FBgn0021995	750	750	749	1	1	1	749
FBgn0022023	750	750	747	3	1	3	747
FBgn0022027	769	750	760	28	7	4	741
FBgn0022029	769	750	751	37	10	3.7	732
FBgn0022069	760	750	745	25	7	3.5714285714285716	735
FBgn0022153	753	750	545	211	2	105.5	542
FBgn0022160	768	750	762	24	5	4.8	744
FBgn0022213	777	750	770	34	5	6.8	743
FBgn0022224	758	750	440	326	4	81.5	432
FBgn0022238	750	750	750	0	0	NA	750
FBgn0022338	750	750	748	2	1	2	748
FBgn0022343	756	750	754	8	3	2.6666666666666665	748
FBgn0022344	754	750	718	40	11	3.6363636363636362	714
FBgn0022349	750	750	748	2	1	2	748
FBgn0022355	795	750	758	82	11	7.454545454545454	713
FBgn0022359	753	750	722	34	8	4.25	719
FBgn0022361	755	750	755	5	2	2.5	750
FBgn0022699	760	750	747	23	7	3.2857142857142856	737
FBgn0022700	765	750	679	101	7	14.428571428571429	664
FBgn0022702	762	750	744	30	5	6	732
FBgn0022724	757	750	755	9	5	1.8	748
FBgn0022740	751	750	589	163	3	54.333333333333336	588
FBgn0022768	813	750	759	117	16	7.3125	696
FBgn0022770	816	750	693	189	16	11.8125	627
FBgn0022774	751	750	717	35	7	5	716
FBgn0022786	757	750	743	21	8	2.625	736
FBgn0022787	759	750	754	14	5	2.8	745
FBgn0022800	755	750	744	16	7	2.2857142857142856	739
FBgn0022893	806	750	701	161	14	11.5	645
FBgn0022935	766	750	742	40	10	4	726
FBgn0022936	767	750	633	151	15	10.066666666666666	616
FBgn0022942	775	750	762	38	8	4.75	737
FBgn0022943	781	750	761	51	9	5.666666666666667	730
FBgn0022981	752	750	571	183	4	45.75	569
FBgn0022984	755	750	754	6	4	1.5	749
FBgn0022987	766	750	755	27	5	5.4	739
FBgn0023000	786	750	743	79	15	5.266666666666667	707
FBgn0023001	752	750	744	10	6	1.6666666666666667	742
FBgn0023023	792	750	769	65	9	7.222222222222222	727
FBgn0023076	795	750	737	103	10	10.3	692
FBgn0023081	758	750	687	79	10	7.9	679
FBgn0023090	768	750	253	533	8	66.625	235
FBgn0023091	765	750	718	62	10	6.2	703
FBgn0023095	776	750	769	33	7	4.714285714285714	743
FBgn0023129	751	750	726	26	2	13	725
FBgn0023130	751	750	742	10	3	3.3333333333333335	741
FBgn0023167	761	750	758	14	4	3.5	747
FBgn0023169	750	750	735	15	6	2.5	735
FBgn0023170	764	750	744	34	9	3.7777777777777777	730
FBgn0023171	750	750	748	2	1	2	748
FBgn0023172	757	750	749	15	5	3	742
FBgn0023174	766	750	726	56	9	6.222222222222222	710
FBgn0023175	762	750	762	12	3	4	750
FBgn0023177	775	750	762	38	5	7.6	737
FBgn0023178	762	750	746	28	10	2.8	734
FBgn0023179	750	750	722	28	4	7	722
FBgn0023181	771	750	739	53	8	6.625	718
FBgn0023197	770	750	736	54	5	10.8	716
FBgn0023212	750	750	749	1	1	1	749
FBgn0023214	781	750	759	53	5	10.6	728
FBgn0023215	751	750	751	1	1	1	750
FBgn0023216	754	750	748	10	7	1.4285714285714286	744
FBgn0023388	750	750	147	603	2	301.5	147
FBgn0023415	768	750	723	63	5	12.6	705
FBgn0023416	752	750	413	341	3	113.66666666666667	411
FBgn0023458	762	750	751	23	4	5.75	739
FBgn0023489	751	750	744	8	4	2	743
FBgn0023495	792	750	773	61	8	7.625	731
FBgn0023496	764	750	732	46	8	5.75	718
FBgn0023506	788	750	701	125	14	8.928571428571429	663
FBgn0023507	762	750	719	55	8	6.875	707
FBgn0023508	751	750	751	1	1	1	750
FBgn0023509	750	750	739	11	1	11	739
FBgn0023511	767	750	754	30	9	3.3333333333333335	737
FBgn0023512	752	750	746	8	3	2.6666666666666665	744
FBgn0023513	750	750	750	0	0	NA	750
FBgn0023514	752	750	745	9	3	3	743
FBgn0023515	754	750	754	4	1	4	750
FBgn0023516	750	750	750	0	0	NA	750
FBgn0023517	753	750	751	5	3	1.6666666666666667	748
FBgn0023518	755	750	751	9	5	1.8	746
FBgn0023519	750	750	747	3	3	1	747
FBgn0023520	757	750	752	12	6	2	745
FBgn0023521	753	750	747	9	7	1.2857142857142858	744
FBgn0023522	521	516	516	10	4	2.5	511
FBgn0023523	756	750	734	28	5	5.6	728
FBgn0023524	766	750	757	25	8	3.125	741
FBgn0023525	618	602	618	16	4	4	602
FBgn0023526	753	750	736	20	4	5	733
FBgn0023527	750	750	717	33	7	4.714285714285714	717
FBgn0023528	739	729	730	19	5	3.8	720
FBgn0023529	781	750	767	45	6	7.5	736
FBgn0023530	750	750	749	1	1	1	749
FBgn0023531	760	750	702	68	7	9.714285714285714	692
FBgn0023534	768	750	719	67	5	13.4	701
FBgn0023536	759	750	749	19	5	3.8	740
FBgn0023537	751	750	630	122	10	12.2	629
FBgn0023540	752	750	734	20	4	5	732
FBgn0023542	751	750	743	9	4	2.25	742
FBgn0023545	751	750	248	504	2	252	247
FBgn0023549	754	712	732	64	8	8	690
FBgn0023550	751	750	740	12	3	4	739
FBgn0024150	750	750	490	260	1	260	490
FBgn0024177	750	750	745	5	2	2.5	745
FBgn0024183	750	750	741	9	3	3	741
FBgn0024184	750	750	750	0	0	NA	750
FBgn0024187	762	750	749	25	8	3.125	737
FBgn0024188	762	750	750	24	8	3	738
FBgn0024191	766	750	734	48	8	6	718
FBgn0024196	757	750	728	36	6	6	721
FBgn0024227	799	750	794	54	6	9	745
FBgn0024230	756	750	740	22	4	5.5	734
FBgn0024232	771	750	743	49	4	12.25	722
FBgn0024236	761	750	535	237	6	39.5	524
FBgn0024244	753	750	753	3	1	3	750
FBgn0024248	571	569	542	31	6	5.166666666666667	540
FBgn0024249	752	750	732	22	3	7.333333333333333	730
FBgn0024250	791	750	729	103	7	14.714285714285714	688
FBgn0024273	750	750	711	39	5	7.8	711
FBgn0024277	793	750	780	56	9	6.222222222222222	737
FBgn0024285	764	750	737	41	7	5.857142857142857	723
FBgn0024288	755	750	740	20	8	2.5	735
FBgn0024291	751	750	740	12	3	4	739
FBgn0024294	775	750	736	64	10	6.4	711
FBgn0024315	804	750	763	95	15	6.333333333333333	709
FBgn0024319	719	710	676	52	5	10.4	667
FBgn0024320	751	750	750	2	2	1	749
FBgn0024321	753	750	741	15	3	5	738
FBgn0024326	717	716	705	13	4	3.25	704
FBgn0024329	674	656	628	64	8	8	610
FBgn0024330	750	750	748	2	1	2	748
FBgn0024352	769	750	769	19	2	9.5	750
FBgn0024360	751	750	743	9	4	2.25	742
FBgn0024361	755	750	749	11	3	3.6666666666666665	744
FBgn0024362	758	750	717	49	10	4.9	709
FBgn0024364	753	750	749	7	3	2.3333333333333335	746
FBgn0024365	750	750	745	5	2	2.5	745
FBgn0024366	754	750	703	55	6	9.166666666666666	699
FBgn0024371	751	750	748	4	3	1.3333333333333333	747
FBgn0024432	752	750	749	5	4	1.25	747
FBgn0024509	758	750	752	14	4	3.5	744
FBgn0024542	757	750	757	7	2	3.5	750
FBgn0024555	750	750	736	14	5	2.8	736
FBgn0024689	764	750	764	14	2	7	750
FBgn0024698	768	750	751	35	9	3.888888888888889	733
FBgn0024728	759	750	445	323	10	32.3	436
FBgn0024732	753	750	743	13	7	1.8571428571428572	740
FBgn0024734	767	750	758	26	9	2.888888888888889	741
FBgn0024740	782	750	774	40	4	10	742
FBgn0024754	744	727	713	48	4	12	696
FBgn0024806	766	750	764	18	4	4.5	748
FBgn0024814	785	750	773	47	7	6.714285714285714	738
FBgn0024833	764	750	750	28	8	3.5	736
FBgn0024846	754	750	696	62	7	8.857142857142858	692
FBgn0024897	797	750	788	56	3	18.666666666666668	741
FBgn0024909	750	750	750	0	0	NA	750
FBgn0024912	756	750	272	490	4	122.5	266
FBgn0024921	774	750	664	134	7	19.142857142857142	640
FBgn0024941	752	750	731	23	6	3.8333333333333335	729
FBgn0024943	753	750	690	66	9	7.333333333333333	687
FBgn0024944	758	750	757	9	2	4.5	749
FBgn0024945	750	750	750	0	0	NA	750
FBgn0024947	751	750	746	6	3	2	745
FBgn0024956	769	750	765	23	6	3.8333333333333335	746
FBgn0024957	753	750	750	6	3	2	747
FBgn0024963	787	750	786	38	5	7.6	749
FBgn0024973	750	750	740	10	2	5	740
FBgn0024975	802	750	792	62	4	15.5	740
FBgn0024980	752	750	714	40	4	10	712
FBgn0024983	755	750	743	17	7	2.4285714285714284	738
FBgn0024985	763	750	753	23	3	7.666666666666667	740
FBgn0024986	765	750	738	42	9	4.666666666666667	723
FBgn0024987	528	526	483	47	6	7.833333333333333	481
FBgn0024989	775	750	773	27	6	4.5	748
FBgn0024991	753	750	735	21	3	7	732
FBgn0024992	758	750	750	16	5	3.2	742
FBgn0024993	758	750	750	16	5	3.2	742
FBgn0024994	766	750	734	48	11	4.363636363636363	718
FBgn0024995	755	750	726	34	11	3.090909090909091	721
FBgn0024996	765	750	732	48	10	4.8	717
FBgn0024997	811	750	776	96	11	8.727272727272727	715
FBgn0024998	750	750	704	46	6	7.666666666666667	704
FBgn0025109	769	750	764	24	7	3.4285714285714284	745
FBgn0025185	756	750	243	519	7	74.14285714285714	237
FBgn0025334	766	750	754	28	6	4.666666666666667	738
FBgn0025335	752	750	673	81	4	20.25	671
FBgn0025352	756	750	725	37	3	12.333333333333334	719
FBgn0025360	769	750	769	19	2	9.5	750
FBgn0025378	758	750	734	32	5	6.4	726
FBgn0025382	753	750	752	4	2	2	749
FBgn0025383	750	750	740	10	2	5	740
FBgn0025388	766	750	757	25	4	6.25	741
FBgn0025391	754	750	733	25	6	4.166666666666667	729
FBgn0025393	750	750	747	3	2	1.5	747
FBgn0025394	751	750	746	6	3	2	745
FBgn0025455	750	750	184	566	7	80.85714285714286	184
FBgn0025457	751	750	743	9	5	1.8	742
FBgn0025463	761	750	757	15	3	5	746
FBgn0025469	768	750	757	29	7	4.142857142857143	739
FBgn0025519	750	750	750	0	0	NA	750
FBgn0025525	783	750	742	74	13	5.6923076923076925	709
FBgn0025558	753	750	736	20	3	6.666666666666667	733
FBgn0025571	753	750	741	15	4	3.75	738
FBgn0025573	753	750	727	29	5	5.8	724
FBgn0025574	588	526	575	75	7	10.714285714285714	513
FBgn0025578	756	750	756	6	2	3	750
FBgn0025583	781	750	612	200	4	50	581
FBgn0025592	765	750	764	16	6	2.6666666666666665	749
FBgn0025595	786	750	757	65	8	8.125	721
FBgn0025608	750	750	747	3	2	1.5	747
FBgn0025612	785	750	649	171	13	13.153846153846153	614
FBgn0025615	757	750	750	14	5	2.8	743
FBgn0025621	762	750	756	18	5	3.6	744
FBgn0025624	826	750	791	111	13	8.538461538461538	715
FBgn0025625	762	750	756	18	6	3	744
FBgn0025627	750	750	750	0	0	NA	750
FBgn0025628	750	750	750	0	0	NA	750
FBgn0025631	770	750	748	42	8	5.25	728
FBgn0025632	750	750	750	0	0	NA	750
FBgn0025637	759	750	753	15	4	3.75	744
FBgn0025639	782	750	769	45	8	5.625	737
FBgn0025640	786	750	758	64	14	4.571428571428571	722
FBgn0025641	750	750	747	3	1	3	747
FBgn0025642	753	750	749	7	3	2.3333333333333335	746
FBgn0025644	750	750	715	35	9	3.888888888888889	715
FBgn0025678	772	750	716	78	12	6.5	694
FBgn0025679	760	750	744	26	7	3.7142857142857144	734
FBgn0025681	750	750	749	1	1	1	749
FBgn0025684	773	750	485	311	6	51.833333333333336	462
FBgn0025692	692	688	671	25	8	3.125	667
FBgn0025700	788	750	747	79	11	7.181818181818182	709
FBgn0025702	752	750	752	2	1	2	750
FBgn0025709	752	750	704	50	7	7.142857142857143	702
FBgn0025716	802	750	801	53	3	17.666666666666668	749
FBgn0025720	751	750	712	40	6	6.666666666666667	711
FBgn0025724	754	750	708	50	7	7.142857142857143	704
FBgn0025725	750	750	750	0	0	NA	750
FBgn0025743	778	750	751	55	11	5	723
FBgn0025777	754	750	714	44	7	6.285714285714286	710
FBgn0025781	761	750	746	26	8	3.25	735
FBgn0025790	584	576	577	15	4	3.75	569
FBgn0025802	750	750	749	1	1	1	749
FBgn0025807	765	750	681	99	4	24.75	666
FBgn0025808	750	750	734	16	5	3.2	734
FBgn0025814	773	750	702	94	14	6.714285714285714	679
FBgn0025815	798	750	773	73	7	10.428571428571429	725
FBgn0025820	761	750	749	23	4	5.75	738
FBgn0025830	576	541	555	56	10	5.6	520
FBgn0025832	783	750	663	153	9	17	630
FBgn0025833	764	750	728	50	7	7.142857142857143	714
FBgn0025835	750	750	725	25	5	5	725
FBgn0025836	770	750	598	192	10	19.2	578
FBgn0025837	770	750	582	208	10	20.8	562
FBgn0025839	634	597	624	47	5	9.4	587
FBgn0025864	750	750	736	14	2	7	736
FBgn0025865	817	750	802	82	10	8.2	735
FBgn0025866	752	750	734	20	4	5	732
FBgn0025874	764	750	732	46	7	6.571428571428571	718
FBgn0025878	751	750	743	9	3	3	742
FBgn0025885	802	750	697	157	17	9.235294117647058	645
FBgn0025936	750	750	28	722	2	361	28
FBgn0026015	756	750	743	19	4	4.75	737
FBgn0026056	756	750	427	335	5	67	421
FBgn0026058	751	750	513	239	5	47.8	512
FBgn0026059	788	750	767	59	8	7.375	729
FBgn0026060	751	750	742	10	3	3.3333333333333335	741
FBgn0026077	750	750	736	14	5	2.8	736
FBgn0026079	752	750	739	15	8	1.875	737
FBgn0026080	752	750	737	17	3	5.666666666666667	735
FBgn0026083	752	750	751	3	2	1.5	749
FBgn0026084	674	649	664	35	9	3.888888888888889	639
FBgn0026085	751	750	751	1	1	1	750
FBgn0026088	760	750	759	11	4	2.75	749
FBgn0026089	757	750	755	9	4	2.25	748
FBgn0026090	549	547	532	19	6	3.1666666666666665	530
FBgn0026136	750	750	744	6	1	6	744
FBgn0026141	752	750	632	122	5	24.4	630
FBgn0026143	752	750	575	179	2	89.5	573
FBgn0026144	757	750	731	33	9	3.6666666666666665	724
FBgn0026148	827	750	751	153	11	13.909090909090908	674
FBgn0026149	754	750	748	10	5	2	744
FBgn0026150	751	750	741	11	2	5.5	740
FBgn0026160	784	750	773	45	9	5	739
FBgn0026162	813	750	749	127	13	9.76923076923077	686
FBgn0026175	761	750	337	435	5	87	326
FBgn0026176	750	750	721	29	4	7.25	721
FBgn0026179	762	750	740	34	9	3.7777777777777777	728
FBgn0026181	754	750	744	14	5	2.8	740
FBgn0026190	616	616	611	5	2	2.5	611
FBgn0026192	759	750	755	13	5	2.6	746
FBgn0026199	750	750	128	622	3	207.33333333333334	128
FBgn0026238	780	750	350	460	9	51.111111111111114	320
FBgn0026239	775	750	755	45	8	5.625	730
FBgn0026250	751	750	740	12	3	4	739
FBgn0026252	758	750	746	20	4	5	738
FBgn0026257	758	750	744	22	7	3.142857142857143	736
FBgn0026259	779	750	715	93	9	10.333333333333334	686
FBgn0026261	750	750	750	0	0	NA	750
FBgn0026262	777	750	494	310	4	77.5	467
FBgn0026263	751	750	737	15	5	3	736
FBgn0026268	783	750	762	54	7	7.714285714285714	729
FBgn0026309	808	750	757	109	16	6.8125	699
FBgn0026313	784	750	781	37	7	5.285714285714286	747
FBgn0026314	753	697	742	67	11	6.090909090909091	686
FBgn0026315	791	750	739	93	14	6.642857142857143	698
FBgn0026316	753	750	738	18	6	3	735
FBgn0026317	750	750	749	1	1	1	749
FBgn0026319	804	750	777	81	10	8.1	723
FBgn0026320	768	750	556	230	11	20.90909090909091	538
FBgn0026324	750	750	750	0	0	NA	750
FBgn0026326	771	750	769	23	7	3.2857142857142856	748
FBgn0026369	751	750	745	7	5	1.4	744
FBgn0026371	765	750	741	39	11	3.5454545454545454	726
FBgn0026373	783	750	772	44	4	11	739
FBgn0026374	760	750	714	56	11	5.090909090909091	704
FBgn0026376	615	597	542	91	9	10.11111111111111	524
FBgn0026378	750	750	735	15	5	3	735
FBgn0026379	771	750	751	41	14	2.9285714285714284	730
FBgn0026380	750	750	725	25	6	4.166666666666667	725
FBgn0026384	750	750	736	14	7	2	736
FBgn0026385	750	750	716	34	6	5.666666666666667	716
FBgn0026389	757	750	535	229	4	57.25	528
FBgn0026392	763	750	743	33	6	5.5	730
FBgn0026394	764	750	747	31	6	5.166666666666667	733
FBgn0026396	764	750	744	34	9	3.7777777777777777	730
FBgn0026398	791	750	775	57	8	7.125	734
FBgn0026399	767	750	722	62	5	12.4	705
FBgn0026402	791	750	778	54	5	10.8	737
FBgn0026404	751	750	690	62	7	8.857142857142858	689
FBgn0026411	758	750	747	19	7	2.7142857142857144	739
FBgn0026415	781	750	735	77	9	8.555555555555555	704
FBgn0026427	758	750	718	48	7	6.857142857142857	710
FBgn0026428	756	750	755	7	2	3.5	749
FBgn0026432	744	732	706	50	9	5.555555555555555	694
FBgn0026438	750	750	728	22	7	3.142857142857143	728
FBgn0026439	750	750	746	4	2	2	746
FBgn0026479	806	750	776	86	15	5.733333333333333	720
FBgn0026533	783	750	663	153	9	17	630
FBgn0026562	760	750	737	33	3	11	727
FBgn0026566	798	750	784	62	10	6.2	736
FBgn0026570	721	672	690	80	10	8	641
FBgn0026573	817	750	811	73	8	9.125	744
FBgn0026575	751	750	742	10	3	3.3333333333333335	741
FBgn0026576	750	750	747	3	1	3	747
FBgn0026577	829	750	782	126	17	7.411764705882353	703
FBgn0026582	770	750	745	45	9	5	725
FBgn0026592	766	750	745	37	10	3.7	729
FBgn0026593	794	750	777	61	12	5.083333333333333	733
FBgn0026597	752	750	752	2	2	1	750
FBgn0026598	759	750	745	23	6	3.8333333333333335	736
FBgn0026602	785	750	776	44	10	4.4	741
FBgn0026616	719	708	707	23	5	4.6	696
FBgn0026619	759	750	759	9	1	9	750
FBgn0026620	773	750	378	418	7	59.714285714285715	355
FBgn0026630	756	750	193	569	4	142.25	187
FBgn0026634	750	750	746	4	2	2	746
FBgn0026666	757	750	750	14	7	2	743
FBgn0026702	752	750	738	16	4	4	736
FBgn0026713	533	504	413	149	10	14.9	384
FBgn0026718	772	750	769	25	5	5	747
FBgn0026722	754	750	754	4	1	4	750
FBgn0026737	586	586	586	0	0	NA	586
FBgn0026738	750	750	728	22	4	5.5	728
FBgn0026741	752	750	737	17	5	3.4	735
FBgn0026749	780	750	771	39	8	4.875	741
FBgn0026751	751	750	727	25	9	2.7777777777777777	726
FBgn0026754	750	750	445	305	6	50.833333333333336	445
FBgn0026755	777	750	729	75	8	9.375	702
FBgn0026756	775	750	751	49	7	7	726
FBgn0026761	764	750	740	38	5	7.6	726
FBgn0026787	779	750	770	38	12	3.1666666666666665	741
FBgn0026872	751	750	750	2	2	1	749
FBgn0026873	763	750	763	13	3	4.333333333333333	750
FBgn0026874	767	750	765	19	5	3.8	748
FBgn0026876	769	750	763	25	5	5	744
FBgn0026878	759	750	751	17	5	3.4	742
FBgn0026879	773	750	773	23	5	4.6	750
FBgn0027053	766	750	728	54	8	6.75	712
FBgn0027054	791	750	774	58	6	9.666666666666666	733
FBgn0027055	752	750	460	294	2	147	458
FBgn0027057	751	750	377	375	2	187.5	376
FBgn0027066	590	572	552	56	9	6.222222222222222	534
FBgn0027070	585	566	571	33	8	4.125	552
FBgn0027074	759	750	739	29	10	2.9	730
FBgn0027079	771	750	737	55	14	3.9285714285714284	716
FBgn0027081	768	750	766	20	4	5	748
FBgn0027082	751	750	747	5	3	1.6666666666666667	746
FBgn0027084	763	750	755	21	5	4.2	742
FBgn0027085	761	750	755	17	4	4.25	744
FBgn0027086	800	750	771	79	14	5.642857142857143	721
FBgn0027088	767	750	674	110	14	7.857142857142857	657
FBgn0027090	750	750	740	10	2	5	740
FBgn0027093	750	750	744	6	3	2	744
FBgn0027095	751	750	743	9	2	4.5	742
FBgn0027101	763	750	231	545	7	77.85714285714286	218
FBgn0027106	796	750	788	54	9	6	742
FBgn0027107	803	750	769	87	10	8.7	716
FBgn0027108	811	750	778	94	12	7.833333333333333	717
FBgn0027109	758	750	751	15	4	3.75	743
FBgn0027111	778	750	606	200	7	28.571428571428573	578
FBgn0027259	782	750	761	53	9	5.888888888888889	729
FBgn0027280	785	750	784	36	7	5.142857142857143	749
FBgn0027287	761	750	745	27	5	5.4	734
FBgn0027291	751	750	750	2	2	1	749
FBgn0027330	752	750	740	14	5	2.8	738
FBgn0027334	760	750	373	397	8	49.625	363
FBgn0027338	778	750	747	59	9	6.555555555555555	719
FBgn0027339	751	750	743	9	4	2.25	742
FBgn0027342	783	750	736	80	13	6.153846153846154	703
FBgn0027343	792	750	780	54	8	6.75	738
FBgn0027348	767	750	697	87	16	5.4375	680
FBgn0027356	776	750	694	108	12	9	668
FBgn0027359	782	750	739	75	9	8.333333333333334	707
FBgn0027363	803	750	799	57	7	8.142857142857142	746
FBgn0027364	779	750	758	50	7	7.142857142857143	729
FBgn0027375	762	750	570	204	9	22.666666666666668	558
FBgn0027490	754	750	727	31	3	10.333333333333334	723
FBgn0027492	808	750	799	67	10	6.7	741
FBgn0027494	772	750	735	59	5	11.8	713
FBgn0027495	751	750	729	23	4	5.75	728
FBgn0027496	768	750	762	24	8	3	744
FBgn0027497	753	750	734	22	5	4.4	731
FBgn0027499	760	750	754	16	7	2.2857142857142856	744
FBgn0027503	777	750	768	36	6	6	741
FBgn0027504	762	750	759	15	4	3.75	747
FBgn0027509	759	750	747	21	7	3	738
FBgn0027514	758	750	756	10	3	3.3333333333333335	748
FBgn0027515	710	689	700	31	7	4.428571428571429	679
FBgn0027521	775	750	748	52	15	3.466666666666667	723
FBgn0027524	784	750	759	59	13	4.538461538461538	725
FBgn0027525	788	750	753	73	11	6.636363636363637	715
FBgn0027526	758	750	755	11	5	2.2	747
FBgn0027527	766	750	751	31	6	5.166666666666667	735
FBgn0027528	752	750	731	23	6	3.8333333333333335	729
FBgn0027535	773	750	772	24	5	4.8	749
FBgn0027539	774	750	765	33	8	4.125	741
FBgn0027546	758	750	721	45	5	9	713
FBgn0027550	775	750	757	43	9	4.777777777777778	732
FBgn0027552	782	750	771	43	10	4.3	739
FBgn0027553	759	750	748	20	4	5	739
FBgn0027554	792	750	754	80	10	8	712
FBgn0027556	750	750	749	1	1	1	749
FBgn0027558	728	721	256	479	7	68.42857142857143	249
FBgn0027560	750	750	746	4	2	2	746
FBgn0027561	755	750	629	131	10	13.1	624
FBgn0027562	759	750	748	20	6	3.3333333333333335	739
FBgn0027563	788	750	773	53	8	6.625	735
FBgn0027564	750	750	745	5	4	1.25	745
FBgn0027565	785	750	774	46	8	5.75	739
FBgn0027568	750	750	732	18	6	3	732
FBgn0027569	748	713	729	54	9	6	694
FBgn0027572	606	601	606	5	2	2.5	601
FBgn0027575	750	750	745	5	1	5	745
FBgn0027578	785	750	765	55	6	9.166666666666666	730
FBgn0027580	759	750	736	32	7	4.571428571428571	727
FBgn0027583	751	750	742	10	2	5	741
FBgn0027584	761	750	710	62	9	6.888888888888889	699
FBgn0027585	752	750	722	32	2	16	720
FBgn0027586	801	750	782	70	8	8.75	731
FBgn0027588	757	750	276	488	9	54.22222222222222	269
FBgn0027589	754	750	754	4	2	2	750
FBgn0027590	509	508	501	9	3	3	500
FBgn0027592	787	750	765	59	8	7.375	728
FBgn0027596	796	750	723	119	15	7.933333333333334	677
FBgn0027597	775	750	768	32	5	6.4	743
FBgn0027599	752	750	745	9	6	1.5	743
FBgn0027600	752	750	702	52	12	4.333333333333333	700
FBgn0027602	735	710	712	48	6	8	687
FBgn0027608	750	750	724	26	4	6.5	724
FBgn0027609	750	750	741	9	1	9	741
FBgn0027610	761	750	693	79	7	11.285714285714286	682
FBgn0027611	820	750	764	126	16	7.875	694
FBgn0027616	750	750	750	0	0	NA	750
FBgn0027619	595	577	360	253	8	31.625	342
FBgn0027620	754	750	738	20	5	4	734
FBgn0027654	751	750	747	5	3	1.6666666666666667	746
FBgn0027655	758	750	748	18	4	4.5	740
FBgn0027657	795	750	791	49	8	6.125	746
FBgn0027660	653	593	642	71	7	10.142857142857142	582
FBgn0027780	516	512	516	4	1	4	512
FBgn0027783	752	750	741	13	5	2.6	739
FBgn0027784	765	750	746	34	7	4.857142857142857	731
FBgn0027785	753	750	753	3	1	3	750
FBgn0027786	753	750	728	28	5	5.6	725
FBgn0027788	750	750	738	12	3	4	738
FBgn0027790	775	750	751	49	7	7	726
FBgn0027835	764	750	723	55	6	9.166666666666666	709
FBgn0027836	769	750	434	354	14	25.285714285714285	415
FBgn0027841	762	750	752	22	7	3.142857142857143	740
FBgn0027843	771	750	762	30	10	3	741
FBgn0027844	757	750	683	81	10	8.1	676
FBgn0027864	786	750	742	80	9	8.88888888888889	706
FBgn0027865	750	750	349	401	2	200.5	349
FBgn0027889	750	750	740	10	2	5	740
FBgn0027903	543	524	497	65	8	8.125	478
FBgn0027929	843	750	782	154	19	8.105263157894736	689
FBgn0027932	750	750	430	320	1	320	430
FBgn0027934	756	750	742	20	4	5	736
FBgn0027945	727	696	714	44	5	8.8	683
FBgn0027949	772	750	752	42	8	5.25	730
FBgn0027950	751	750	739	13	3	4.333333333333333	738
FBgn0027951	772	750	729	65	8	8.125	707
FBgn0028292	556	540	536	36	4	9	520
FBgn0028325	765	750	760	20	5	4	745
FBgn0028327	776	750	770	32	9	3.5555555555555554	744
FBgn0028342	762	750	758	16	6	2.6666666666666665	746
FBgn0028343	820	750	790	100	9	11.11111111111111	720
FBgn0028360	765	750	679	101	9	11.222222222222221	664
FBgn0028369	810	750	758	112	10	11.2	698
FBgn0028370	754	750	594	164	6	27.333333333333332	590
FBgn0028371	751	750	721	31	6	5.166666666666667	720
FBgn0028372	757	750	694	70	9	7.777777777777778	687
FBgn0028374	829	750	808	100	11	9.090909090909092	729
FBgn0028381	750	750	734	16	6	2.6666666666666665	734
FBgn0028387	645	610	642	38	5	7.6	607
FBgn0028394	789	750	743	85	9	9.444444444444445	704
FBgn0028398	769	750	747	41	8	5.125	728
FBgn0028400	781	750	772	40	7	5.714285714285714	741
FBgn0028402	793	750	754	82	12	6.833333333333333	711
FBgn0028406	764	750	764	14	4	3.5	750
FBgn0028408	762	750	760	14	4	3.5	748
FBgn0028412	754	750	744	14	3	4.666666666666667	740
FBgn0028416	825	750	760	140	7	20	685
FBgn0028418	756	750	730	32	4	8	724
FBgn0028421	772	750	772	22	4	5.5	750
FBgn0028424	774	750	747	51	9	5.666666666666667	723
FBgn0028425	755	750	753	7	3	2.3333333333333335	748
FBgn0028426	752	750	672	82	5	16.4	670
FBgn0028427	754	750	742	16	5	3.2	738
FBgn0028430	778	750	717	89	15	5.933333333333334	689
FBgn0028434	752	750	742	12	4	3	740
FBgn0028436	754	750	751	7	4	1.75	747
FBgn0028467	783	750	760	56	7	8	727
FBgn0028468	771	750	760	32	8	4	739
FBgn0028473	771	750	758	34	10	3.4	737
FBgn0028475	750	750	743	7	2	3.5	743
FBgn0028476	797	750	777	67	10	6.7	730
FBgn0028479	764	750	729	49	9	5.444444444444445	715
FBgn0028480	760	750	739	31	6	5.166666666666667	729
FBgn0028481	795	750	794	46	6	7.666666666666667	749
FBgn0028482	815	750	792	88	11	8	727
FBgn0028484	778	750	774	32	9	3.5555555555555554	746
FBgn0028487	750	750	750	0	0	NA	750
FBgn0028490	864	750	828	150	17	8.823529411764707	714
FBgn0028491	780	750	778	32	7	4.571428571428571	748
FBgn0028496	753	750	744	12	6	2	741
FBgn0028499	756	750	754	8	2	4	748
FBgn0028504	751	750	714	38	6	6.333333333333333	713
FBgn0028506	751	750	694	58	4	14.5	693
FBgn0028507	750	750	462	288	4	72	462
FBgn0028509	750	750	743	7	5	1.4	743
FBgn0028513	750	750	708	42	7	6	708
FBgn0028515	753	750	728	28	5	5.6	725
FBgn0028520	780	750	770	40	6	6.666666666666667	740
FBgn0028525	755	750	713	47	7	6.714285714285714	708
FBgn0028527	781	750	721	91	10	9.1	690
FBgn0028540	754	750	697	61	7	8.714285714285714	693
FBgn0028542	768	750	740	46	7	6.571428571428571	722
FBgn0028544	753	750	747	9	2	4.5	744
FBgn0028546	755	750	699	61	8	7.625	694
FBgn0028550	752	750	741	13	5	2.6	739
FBgn0028552	752	750	748	6	3	2	746
FBgn0028554	758	750	731	35	12	2.9166666666666665	723
FBgn0028560	751	750	647	105	4	26.25	646
FBgn0028562	750	750	749	1	1	1	749
FBgn0028567	765	750	755	25	7	3.5714285714285716	740
FBgn0028569	757	750	729	35	5	7	722
FBgn0028570	767	750	760	24	3	8	743
FBgn0028572	763	750	732	44	7	6.285714285714286	719
FBgn0028573	756	750	742	20	5	4	736
FBgn0028579	787	750	702	122	10	12.2	665
FBgn0028582	766	750	752	30	11	2.727272727272727	736
FBgn0028583	775	750	745	55	7	7.857142857142857	720
FBgn0028644	806	750	803	59	8	7.375	747
FBgn0028645	839	750	808	120	16	7.5	719
FBgn0028646	770	750	746	44	6	7.333333333333333	726
FBgn0028647	751	750	745	7	4	1.75	744
FBgn0028648	751	750	711	41	6	6.833333333333333	710
FBgn0028658	750	750	750	0	0	NA	750
FBgn0028662	759	750	729	39	4	9.75	720
FBgn0028667	777	750	749	55	10	5.5	722
FBgn0028669	750	750	682	68	4	17	682
FBgn0028671	750	750	747	3	2	1.5	747
FBgn0028675	715	714	676	40	6	6.666666666666667	675
FBgn0028684	750	750	748	2	1	2	748
FBgn0028685	750	750	750	0	0	NA	750
FBgn0028686	755	750	746	14	6	2.3333333333333335	741
FBgn0028688	751	750	743	9	3	3	742
FBgn0028689	566	561	539	32	9	3.5555555555555554	534
FBgn0028690	758	750	712	54	5	10.8	704
FBgn0028691	769	750	768	20	5	4	749
FBgn0028692	754	750	749	9	3	3	745
FBgn0028695	758	750	296	470	5	94	288
FBgn0028699	750	750	750	0	0	NA	750
FBgn0028700	751	750	732	20	3	6.666666666666667	731
FBgn0028703	717	702	498	234	9	26	483
FBgn0028704	750	750	733	17	3	5.666666666666667	733
FBgn0028707	764	750	751	27	4	6.75	737
FBgn0028708	774	750	736	62	9	6.888888888888889	712
FBgn0028717	781	750	763	49	7	7	732
FBgn0028734	764	750	751	27	5	5.4	737
FBgn0028737	810	750	780	90	12	7.5	720
FBgn0028740	768	750	738	48	10	4.8	720
FBgn0028743	513	512	511	3	2	1.5	510
FBgn0028789	751	750	747	5	3	1.6666666666666667	746
FBgn0028836	787	750	765	59	8	7.375	728
FBgn0028837	808	750	760	106	10	10.6	702
FBgn0028844	768	750	742	44	7	6.285714285714286	724
FBgn0028847	754	750	709	49	6	8.166666666666666	705
FBgn0028850	754	750	546	212	4	53	542
FBgn0028852	762	750	748	26	6	4.333333333333333	736
FBgn0028853	817	750	805	79	10	7.9	738
FBgn0028855	751	750	730	22	4	5.5	729
FBgn0028857	773	750	765	31	3	10.333333333333334	742
FBgn0028858	755	750	749	11	5	2.2	744
FBgn0028862	782	750	743	71	17	4.176470588235294	711
FBgn0028866	766	750	747	35	9	3.888888888888889	731
FBgn0028868	755	750	727	33	6	5.5	722
FBgn0028870	773	750	745	51	11	4.636363636363637	722
FBgn0028871	750	750	716	34	4	8.5	716
FBgn0028875	771	750	763	29	5	5.8	742
FBgn0028878	759	750	746	22	8	2.75	737
FBgn0028879	690	612	642	126	15	8.4	564
FBgn0028882	752	750	698	56	5	11.2	696
FBgn0028884	762	750	727	47	10	4.7	715
FBgn0028887	778	750	745	61	7	8.714285714285714	717
FBgn0028888	754	750	748	10	4	2.5	744
FBgn0028889	760	750	758	12	4	3	748
FBgn0028892	764	750	763	15	4	3.75	749
FBgn0028893	772	750	738	56	7	8	716
FBgn0028894	785	750	737	83	7	11.857142857142858	702
FBgn0028895	757	750	742	22	7	3.142857142857143	735
FBgn0028896	525	504	509	37	8	4.625	488
FBgn0028897	776	750	751	51	8	6.375	725
FBgn0028900	782	750	759	55	7	7.857142857142857	727
FBgn0028901	752	750	745	9	5	1.8	743
FBgn0028903	754	750	732	26	7	3.7142857142857144	728
FBgn0028909	780	750	746	64	13	4.923076923076923	716
FBgn0028912	758	750	698	68	7	9.714285714285714	690
FBgn0028913	750	750	740	10	4	2.5	740
FBgn0028919	750	750	749	1	1	1	749
FBgn0028920	755	750	745	15	6	2.5	740
FBgn0028926	769	750	722	66	9	7.333333333333333	703
FBgn0028931	692	657	550	177	16	11.0625	515
FBgn0028935	750	750	735	15	4	3.75	735
FBgn0028936	750	750	731	19	3	6.333333333333333	731
FBgn0028938	792	750	756	78	13	6	714
FBgn0028939	786	746	759	67	12	5.583333333333333	719
FBgn0028940	757	750	748	16	6	2.6666666666666665	741
FBgn0028941	695	693	660	37	6	6.166666666666667	658
FBgn0028942	754	750	730	28	7	4	726
FBgn0028944	662	635	662	27	6	4.5	635
FBgn0028945	756	750	665	97	9	10.777777777777779	659
FBgn0028946	755	750	721	39	4	9.75	716
FBgn0028947	785	750	755	65	8	8.125	720
FBgn0028948	785	750	754	66	9	7.333333333333333	719
FBgn0028949	753	690	731	85	12	7.083333333333333	668
FBgn0028950	751	750	745	7	3	2.3333333333333335	744
FBgn0028952	750	750	743	7	4	1.75	743
FBgn0028953	703	667	659	80	13	6.153846153846154	623
FBgn0028956	753	750	210	546	8	68.25	207
FBgn0028962	751	750	751	1	1	1	750
FBgn0028963	750	750	735	15	3	5	735
FBgn0028965	822	750	803	91	10	9.1	731
FBgn0028968	760	750	732	38	13	2.923076923076923	722
FBgn0028969	554	537	514	57	10	5.7	497
FBgn0028978	777	750	734	70	5	14	707
FBgn0028980	752	750	514	240	4	60	512
FBgn0028981	796	750	770	72	13	5.538461538461538	724
FBgn0028982	772	750	753	41	11	3.727272727272727	731
FBgn0028983	761	750	760	12	4	3	749
FBgn0028987	791	750	748	84	8	10.5	707
FBgn0028992	775	750	771	29	5	5.8	746
FBgn0028996	807	750	795	69	11	6.2727272727272725	738
FBgn0028997	715	702	673	55	9	6.111111111111111	660
FBgn0028999	752	750	741	13	5	2.6	739
FBgn0029002	777	750	750	54	9	6	723
FBgn0029003	750	750	735	15	2	7.5	735
FBgn0029006	751	750	736	16	2	8	735
FBgn0029067	772	750	768	26	5	5.2	746
FBgn0029079	755	750	746	14	8	1.75	741
FBgn0029088	754	750	746	12	5	2.4	742
FBgn0029093	560	556	545	19	7	2.7142857142857144	541
FBgn0029094	758	750	731	35	6	5.833333333333333	723
FBgn0029105	775	750	752	48	5	9.6	727
FBgn0029113	784	750	769	49	7	7	735
FBgn0029114	772	750	743	51	9	5.666666666666667	721
FBgn0029117	752	750	748	6	3	2	746
FBgn0029118	750	750	747	3	1	3	747
FBgn0029121	750	750	747	3	1	3	747
FBgn0029123	750	750	722	28	3	9.333333333333334	722
FBgn0029133	759	750	741	27	6	4.5	732
FBgn0029134	751	750	684	68	3	22.666666666666668	683
FBgn0029137	768	750	766	20	4	5	748
FBgn0029147	767	750	744	40	7	5.714285714285714	727
FBgn0029152	781	750	699	113	23	4.913043478260869	668
FBgn0029157	751	750	737	15	3	5	736
FBgn0029158	788	750	773	53	9	5.888888888888889	735
FBgn0029167	753	750	728	28	8	3.5	725
FBgn0029172	839	750	822	106	20	5.3	733
FBgn0029174	652	615	630	59	10	5.9	593
FBgn0029176	526	504	513	35	6	5.833333333333333	491
FBgn0029503	765	750	734	46	7	6.571428571428571	719
FBgn0029504	751	750	716	36	7	5.142857142857143	715
FBgn0029506	808	750	727	139	14	9.928571428571429	669
FBgn0029507	813	750	737	139	13	10.692307692307692	674
FBgn0029508	784	750	743	75	11	6.818181818181818	709
FBgn0029512	754	750	727	31	4	7.75	723
FBgn0029514	750	750	469	281	2	140.5	469
FBgn0029518	767	750	712	72	9	8	695
FBgn0029522	768	750	540	246	5	49.2	522
FBgn0029529	797	750	790	54	10	5.4	743
FBgn0029531	750	750	747	3	3	1	747
FBgn0029532	754	750	722	36	9	4	718
FBgn0029535	793	750	782	54	7	7.714285714285714	739
FBgn0029539	773	750	769	27	3	9	746
FBgn0029552	770	750	746	44	6	7.333333333333333	726
FBgn0029568	752	750	741	13	7	1.8571428571428572	739
FBgn0029573	765	750	714	66	4	16.5	699
FBgn0029587	750	750	729	21	4	5.25	729
FBgn0029588	766	750	766	16	3	5.333333333333333	750
FBgn0029594	776	750	775	27	5	5.4	749
FBgn0029603	784	750	736	82	6	13.666666666666666	702
FBgn0029606	767	750	765	19	4	4.75	748
FBgn0029608	750	750	701	49	7	7	701
FBgn0029639	775	750	757	43	9	4.777777777777778	732
FBgn0029649	782	750	755	59	12	4.916666666666667	723
FBgn0029657	827	750	757	147	12	12.25	680
FBgn0029659	785	750	751	69	14	4.928571428571429	716
FBgn0029662	758	750	669	97	11	8.818181818181818	661
FBgn0029663	764	750	743	35	11	3.1818181818181817	729
FBgn0029665	750	750	735	15	5	3	735
FBgn0029667	769	750	747	41	8	5.125	728
FBgn0029681	753	750	716	40	9	4.444444444444445	713
FBgn0029686	757	750	747	17	4	4.25	740
FBgn0029690	784	750	769	49	11	4.454545454545454	735
FBgn0029693	766	750	718	64	7	9.142857142857142	702
FBgn0029694	766	750	718	64	11	5.818181818181818	702
FBgn0029696	759	750	751	17	8	2.125	742
FBgn0029697	759	750	751	17	8	2.125	742
FBgn0029700	772	750	763	31	8	3.875	741
FBgn0029701	765	750	581	199	5	39.8	566
FBgn0029702	767	750	767	17	5	3.4	750
FBgn0029703	755	750	528	232	10	23.2	523
FBgn0029705	771	750	749	43	14	3.0714285714285716	728
FBgn0029708	755	750	731	29	7	4.142857142857143	726
FBgn0029709	751	750	737	15	7	2.142857142857143	736
FBgn0029710	578	573	546	37	6	6.166666666666667	541
FBgn0029712	751	750	737	15	6	2.5	736
FBgn0029714	750	750	743	7	2	3.5	743
FBgn0029716	775	750	720	80	12	6.666666666666667	695
FBgn0029718	753	750	711	45	10	4.5	708
FBgn0029719	792	750	730	104	14	7.428571428571429	688
FBgn0029720	781	750	746	66	10	6.6	715
FBgn0029722	552	538	529	37	7	5.285714285714286	515
FBgn0029723	638	594	566	116	18	6.444444444444445	522
FBgn0029725	773	750	769	27	7	3.857142857142857	746
FBgn0029726	750	750	713	37	5	7.4	713
FBgn0029727	807	750	743	121	11	11	686
FBgn0029728	636	596	634	42	4	10.5	594
FBgn0029729	784	750	744	74	12	6.166666666666667	710
FBgn0029733	770	750	766	24	4	6	746
FBgn0029736	760	750	720	50	13	3.8461538461538463	710
FBgn0029737	751	750	728	24	8	3	727
FBgn0029747	790	750	696	134	11	12.181818181818182	656
FBgn0029750	709	702	649	67	11	6.090909090909091	642
FBgn0029752	751	750	536	216	6	36	535
FBgn0029754	756	750	725	37	4	9.25	719
FBgn0029756	751	750	724	28	11	2.5454545454545454	723
FBgn0029762	770	750	680	110	16	6.875	660
FBgn0029763	763	750	472	304	9	33.77777777777778	459
FBgn0029768	758	750	703	63	12	5.25	695
FBgn0029769	774	750	745	53	11	4.818181818181818	721
FBgn0029770	765	750	703	77	9	8.555555555555555	688
FBgn0029771	768	750	737	49	6	8.166666666666666	719
FBgn0029778	755	750	741	19	6	3.1666666666666665	736
FBgn0029783	750	750	713	37	2	18.5	713
FBgn0029785	804	750	781	77	11	7	727
FBgn0029798	765	750	757	23	4	5.75	742
FBgn0029799	702	694	634	76	8	9.5	626
FBgn0029800	533	533	504	29	2	14.5	504
FBgn0029801	761	750	745	27	5	5.4	734
FBgn0029804	788	750	705	121	8	15.125	667
FBgn0029807	767	750	747	37	9	4.111111111111111	730
FBgn0029809	750	750	742	8	5	1.6	742
FBgn0029810	750	750	750	0	0	NA	750
FBgn0029811	787	750	747	77	13	5.923076923076923	710
FBgn0029813	773	750	755	41	7	5.857142857142857	732
FBgn0029816	752	750	647	107	6	17.833333333333332	645
FBgn0029819	784	750	754	64	13	4.923076923076923	720
FBgn0029820	753	750	750	6	3	2	747
FBgn0029821	753	750	693	63	11	5.7272727272727275	690
FBgn0029823	771	750	761	31	6	5.166666666666667	740
FBgn0029824	779	750	758	50	8	6.25	729
FBgn0029827	754	750	706	52	8	6.5	702
FBgn0029828	761	750	708	64	10	6.4	697
FBgn0029830	751	750	728	24	6	4	727
FBgn0029831	752	750	749	5	5	1	747
FBgn0029834	758	750	745	21	7	3	737
FBgn0029835	750	750	726	24	7	3.4285714285714284	726
FBgn0029836	750	750	662	88	5	17.6	662
FBgn0029837	773	750	734	62	9	6.888888888888889	711
FBgn0029838	760	750	753	17	8	2.125	743
FBgn0029839	812	750	774	100	7	14.285714285714286	712
FBgn0029843	556	556	522	34	1	34	522
FBgn0029848	754	750	735	23	4	5.75	731
FBgn0029849	754	750	728	30	4	7.5	724
FBgn0029851	790	750	760	70	8	8.75	720
FBgn0029853	755	750	710	50	7	7.142857142857143	705
FBgn0029856	752	750	132	622	3	207.33333333333334	130
FBgn0029857	750	750	747	3	2	1.5	747
FBgn0029858	753	750	750	6	3	2	747
FBgn0029860	750	750	741	9	2	4.5	741
FBgn0029861	752	750	732	22	5	4.4	730
FBgn0029863	751	750	710	42	11	3.8181818181818183	709
FBgn0029864	767	750	721	63	12	5.25	704
FBgn0029867	763	750	729	47	6	7.833333333333333	716
FBgn0029870	758	750	682	84	5	16.8	674
FBgn0029873	765	750	722	58	11	5.2727272727272725	707
FBgn0029874	771	750	770	22	6	3.6666666666666665	749
FBgn0029877	750	750	689	61	10	6.1	689
FBgn0029881	765	750	724	56	12	4.666666666666667	709
FBgn0029882	761	750	748	24	6	4	737
FBgn0029885	766	750	756	26	4	6.5	740
FBgn0029887	775	750	750	50	6	8.333333333333334	725
FBgn0029888	781	750	754	58	17	3.411764705882353	723
FBgn0029892	754	750	330	428	5	85.6	326
FBgn0029894	827	750	822	82	9	9.11111111111111	745
FBgn0029895	824	750	808	90	9	10	734
FBgn0029896	752	750	725	29	6	4.833333333333333	723
FBgn0029898	753	750	710	46	7	6.571428571428571	707
FBgn0029903	755	750	743	17	3	5.666666666666667	738
FBgn0029905	757	750	748	16	2	8	741
FBgn0029906	756	750	747	15	2	7.5	741
FBgn0029909	766	750	751	31	6	5.166666666666667	735
FBgn0029911	771	750	763	29	8	3.625	742
FBgn0029912	778	750	765	41	10	4.1	737
FBgn0029913	763	750	754	22	6	3.6666666666666665	741
FBgn0029914	763	750	761	15	4	3.75	748
FBgn0029915	764	750	760	18	4	4.5	746
FBgn0029922	779	750	739	69	16	4.3125	710
FBgn0029924	756	750	731	31	6	5.166666666666667	725
FBgn0029925	750	750	726	24	9	2.6666666666666665	726
FBgn0029928	750	750	749	1	1	1	749
FBgn0029929	756	750	751	11	3	3.6666666666666665	745
FBgn0029930	751	750	735	17	6	2.8333333333333335	734
FBgn0029931	751	750	741	11	6	1.8333333333333333	740
FBgn0029932	798	750	776	70	10	7	728
FBgn0029935	730	719	636	105	13	8.076923076923077	625
FBgn0029936	775	750	763	37	11	3.3636363636363638	738
FBgn0029937	775	750	771	29	8	3.625	746
FBgn0029939	771	750	727	65	10	6.5	706
FBgn0029940	760	750	743	27	8	3.375	733
FBgn0029942	751	750	717	35	9	3.888888888888889	716
FBgn0029944	758	750	726	40	6	6.666666666666667	718
FBgn0029945	755	750	723	37	9	4.111111111111111	718
FBgn0029947	763	750	637	139	8	17.375	624
FBgn0029948	754	750	752	6	3	2	748
FBgn0029950	759	750	744	24	7	3.4285714285714284	735
FBgn0029951	760	750	746	24	4	6	736
FBgn0029952	750	750	728	22	4	5.5	728
FBgn0029955	750	750	735	15	5	3	735
FBgn0029957	759	750	759	9	2	4.5	750
FBgn0029958	752	750	746	8	5	1.6	744
FBgn0029959	751	750	748	4	3	1.3333333333333333	747
FBgn0029961	750	750	748	2	2	1	748
FBgn0029962	761	750	744	28	6	4.666666666666667	733
FBgn0029963	767	750	757	27	7	3.857142857142857	740
FBgn0029964	791	750	601	231	12	19.25	560
FBgn0029965	771	750	771	21	2	10.5	750
FBgn0029966	780	750	737	73	9	8.11111111111111	707
FBgn0029968	787	750	780	44	7	6.285714285714286	743
FBgn0029969	512	506	499	19	5	3.8	493
FBgn0029970	787	750	778	46	6	7.666666666666667	741
FBgn0029974	766	750	758	24	8	3	742
FBgn0029975	765	750	758	22	7	3.142857142857143	743
FBgn0029977	751	750	747	5	4	1.25	746
FBgn0029979	680	666	609	85	11	7.7272727272727275	595
FBgn0029980	753	750	744	12	7	1.7142857142857142	741
FBgn0029986	753	750	668	88	7	12.571428571428571	665
FBgn0029990	756	750	728	34	12	2.8333333333333335	722
FBgn0029992	766	750	766	16	7	2.2857142857142856	750
FBgn0029993	759	750	750	18	6	3	741
FBgn0029994	775	750	735	65	13	5	710
FBgn0029995	786	750	771	51	9	5.666666666666667	735
FBgn0029996	784	750	783	35	4	8.75	749
FBgn0029997	751	750	738	14	6	2.3333333333333335	737
FBgn0029999	775	750	769	31	6	5.166666666666667	744
FBgn0030001	753	750	737	19	3	6.333333333333333	734
FBgn0030003	762	750	605	169	7	24.142857142857142	593
FBgn0030004	589	569	579	30	7	4.285714285714286	559
FBgn0030005	760	750	604	166	11	15.090909090909092	594
FBgn0030007	756	750	750	12	4	3	744
FBgn0030008	756	750	750	12	4	3	744
FBgn0030009	602	602	576	26	1	26	576
FBgn0030013	753	750	753	3	2	1.5	750
FBgn0030014	759	750	683	85	14	6.071428571428571	674
FBgn0030015	755	750	676	84	8	10.5	671
FBgn0030016	764	750	740	38	9	4.222222222222222	726
FBgn0030017	757	750	710	54	11	4.909090909090909	703
FBgn0030018	765	750	653	127	12	10.583333333333334	638
FBgn0030025	767	750	763	21	8	2.625	746
FBgn0030026	763	750	733	43	6	7.166666666666667	720
FBgn0030027	802	750	774	80	17	4.705882352941177	722
FBgn0030028	837	750	826	98	7	14	739
FBgn0030029	751	750	734	18	3	6	733
FBgn0030030	762	750	740	34	3	11.333333333333334	728
FBgn0030033	781	750	732	80	10	8	701
FBgn0030034	752	750	695	59	6	9.833333333333334	693
FBgn0030037	756	750	740	22	5	4.4	734
FBgn0030038	754	750	754	4	1	4	750
FBgn0030039	763	750	549	227	8	28.375	536
FBgn0030040	763	750	705	71	11	6.454545454545454	692
FBgn0030048	762	750	761	13	4	3.25	749
FBgn0030049	761	750	748	24	6	4	737
FBgn0030053	657	643	597	74	6	12.333333333333334	583
FBgn0030054	817	750	738	146	18	8.11111111111111	671
FBgn0030055	750	750	749	1	1	1	749
FBgn0030056	754	750	725	33	12	2.75	721
FBgn0030057	750	750	656	94	1	94	656
FBgn0030058	758	750	674	92	9	10.222222222222221	666
FBgn0030060	750	750	749	1	1	1	749
FBgn0030061	830	750	817	93	10	9.3	737
FBgn0030063	752	750	743	11	3	3.6666666666666665	741
FBgn0030065	787	750	764	60	12	5	727
FBgn0030066	782	750	749	65	15	4.333333333333333	717
FBgn0030067	757	750	742	22	7	3.142857142857143	735
FBgn0030071	781	750	778	34	5	6.8	747
FBgn0030077	785	750	701	119	11	10.818181818181818	666
FBgn0030081	755	750	748	12	3	4	743
FBgn0030082	750	750	745	5	1	5	745
FBgn0030087	749	732	743	23	8	2.875	726
FBgn0030090	753	750	745	11	6	1.8333333333333333	742
FBgn0030091	812	750	761	113	10	11.3	699
FBgn0030092	750	750	745	5	1	5	745
FBgn0030093	750	750	740	10	3	3.3333333333333335	740
FBgn0030096	762	750	741	33	9	3.6666666666666665	729
FBgn0030097	759	750	624	144	12	12	615
FBgn0030098	792	750	725	109	16	6.8125	683
FBgn0030102	802	750	679	175	14	12.5	627
FBgn0030103	779	750	725	83	12	6.916666666666667	696
FBgn0030105	538	504	486	86	15	5.733333333333333	452
FBgn0030107	755	750	721	39	7	5.571428571428571	716
FBgn0030108	583	568	552	46	9	5.111111111111111	537
FBgn0030121	794	750	737	101	9	11.222222222222221	693
FBgn0030136	776	750	765	37	10	3.7	739
FBgn0030141	772	750	753	41	8	5.125	731
FBgn0030148	780	750	741	69	9	7.666666666666667	711
FBgn0030151	753	750	733	23	7	3.2857142857142856	730
FBgn0030156	808	750	770	96	12	8	712
FBgn0030157	757	750	722	42	11	3.8181818181818183	715
FBgn0030158	719	682	687	69	9	7.666666666666667	650
FBgn0030160	757	750	680	84	8	10.5	673
FBgn0030162	754	750	700	58	8	7.25	696
FBgn0030167	750	750	744	6	3	2	744
FBgn0030170	649	627	642	29	6	4.833333333333333	620
FBgn0030174	774	750	721	77	11	7	697
FBgn0030178	750	750	745	5	3	1.6666666666666667	745
FBgn0030181	783	750	759	57	11	5.181818181818182	726
FBgn0030183	762	750	761	13	5	2.6	749
FBgn0030186	757	750	691	73	11	6.636363636363637	684
FBgn0030187	755	750	733	27	9	3	728
FBgn0030191	758	750	567	199	7	28.428571428571427	559
FBgn0030196	761	750	754	18	6	3	743
FBgn0030204	750	750	708	42	3	14	708
FBgn0030206	758	750	750	16	7	2.2857142857142856	742
FBgn0030207	773	750	741	55	12	4.583333333333333	718
FBgn0030208	758	750	733	33	5	6.6	725
FBgn0030217	766	750	746	36	10	3.6	730
FBgn0030218	753	750	752	4	4	1	749
FBgn0030224	770	750	749	41	5	8.2	729
FBgn0030228	758	750	721	45	7	6.428571428571429	713
FBgn0030230	817	750	786	98	16	6.125	719
FBgn0030237	772	750	709	85	11	7.7272727272727275	687
FBgn0030239	771	750	568	224	8	28	547
FBgn0030241	594	578	585	25	6	4.166666666666667	569
FBgn0030242	753	750	709	47	7	6.714285714285714	706
FBgn0030243	750	750	706	44	4	11	706
FBgn0030244	779	750	738	70	14	5	709
FBgn0030245	652	622	611	71	7	10.142857142857142	581
FBgn0030251	824	750	779	119	18	6.611111111111111	705
FBgn0030257	759	750	717	51	11	4.636363636363637	708
FBgn0030258	756	750	720	42	6	7	714
FBgn0030259	770	750	723	67	7	9.571428571428571	703
FBgn0030260	778	750	749	57	7	8.142857142857142	721
FBgn0030262	764	750	710	68	6	11.333333333333334	696
FBgn0030266	764	750	761	17	7	2.4285714285714284	747
FBgn0030268	776	750	771	31	4	7.75	745
FBgn0030269	776	750	771	31	4	7.75	745
FBgn0030270	755	750	721	39	7	5.571428571428571	716
FBgn0030271	755	750	721	39	7	5.571428571428571	716
FBgn0030272	754	740	702	66	16	4.125	688
FBgn0030276	810	750	758	112	15	7.466666666666667	698
FBgn0030277	762	750	722	52	10	5.2	710
FBgn0030278	786	750	757	65	12	5.416666666666667	721
FBgn0030283	761	750	738	34	6	5.666666666666667	727
FBgn0030286	757	750	751	13	7	1.8571428571428572	744
FBgn0030289	753	750	737	19	5	3.8	734
FBgn0030290	761	750	757	15	3	5	746
FBgn0030296	751	750	717	35	10	3.5	716
FBgn0030300	812	750	760	114	18	6.333333333333333	698
FBgn0030301	774	750	714	84	11	7.636363636363637	690
FBgn0030305	656	656	653	3	3	1	653
FBgn0030311	754	750	731	27	9	3	727
FBgn0030313	761	750	745	27	5	5.4	734
FBgn0030316	753	750	739	17	7	2.4285714285714284	736
FBgn0030317	755	750	755	5	1	5	750
FBgn0030319	759	750	757	11	4	2.75	748
FBgn0030320	764	750	736	42	8	5.25	722
FBgn0030321	757	750	735	29	9	3.2222222222222223	728
FBgn0030323	756	750	741	21	6	3.5	735
FBgn0030326	782	750	654	160	10	16	622
FBgn0030329	752	750	747	7	3	2.3333333333333335	745
FBgn0030332	779	750	723	85	11	7.7272727272727275	694
FBgn0030334	757	750	731	33	10	3.3	724
FBgn0030336	753	750	706	50	9	5.555555555555555	703
FBgn0030338	800	750	646	204	13	15.692307692307692	596
FBgn0030339	761	750	709	63	18	3.5	698
FBgn0030342	752	750	743	11	3	3.6666666666666665	741
FBgn0030343	761	750	751	21	6	3.5	740
FBgn0030344	766	750	766	16	4	4	750
FBgn0030345	754	750	754	4	2	2	750
FBgn0030346	767	750	754	30	8	3.75	737
FBgn0030347	768	750	761	25	8	3.125	743
FBgn0030348	760	750	745	25	7	3.5714285714285716	735
FBgn0030349	752	750	748	6	3	2	746
FBgn0030350	786	750	774	48	9	5.333333333333333	738
FBgn0030357	753	750	735	21	7	3	732
FBgn0030358	750	750	717	33	8	4.125	717
FBgn0030359	741	728	715	39	8	4.875	702
FBgn0030360	772	750	719	75	12	6.25	697
FBgn0030361	752	750	635	119	5	23.8	633
FBgn0030362	754	750	713	45	4	11.25	709
FBgn0030364	751	750	402	350	5	70	401
FBgn0030367	755	750	565	195	9	21.666666666666668	560
FBgn0030370	778	750	766	40	9	4.444444444444445	738
FBgn0030373	814	750	768	110	13	8.461538461538462	704
FBgn0030375	781	750	765	47	10	4.7	734
FBgn0030377	774	750	689	109	9	12.11111111111111	665
FBgn0030384	754	750	734	24	7	3.4285714285714284	730
FBgn0030385	756	750	750	12	5	2.4	744
FBgn0030390	754	750	444	314	5	62.8	440
FBgn0030391	758	750	736	30	9	3.3333333333333335	728
FBgn0030394	775	750	744	56	11	5.090909090909091	719
FBgn0030398	762	750	699	75	11	6.818181818181818	687
FBgn0030400	756	750	742	20	8	2.5	736
FBgn0030403	750	750	465	285	4	71.25	465
FBgn0030407	765	750	745	35	5	7	730
FBgn0030408	790	750	760	70	9	7.777777777777778	720
FBgn0030409	768	750	748	38	14	2.7142857142857144	730
FBgn0030410	750	750	740	10	1	10	740
FBgn0030411	750	750	740	10	1	10	740
FBgn0030412	724	710	688	50	10	5	674
FBgn0030417	766	750	688	94	14	6.714285714285714	672
FBgn0030418	848	750	822	124	13	9.538461538461538	724
FBgn0030425	779	750	700	108	19	5.684210526315789	671
FBgn0030431	769	750	711	77	10	7.7	692
FBgn0030432	752	750	703	51	4	12.75	701
FBgn0030433	752	750	728	26	6	4.333333333333333	726
FBgn0030434	846	750	803	139	11	12.636363636363637	707
FBgn0030435	751	750	500	252	3	84	499
FBgn0030437	816	750	797	85	15	5.666666666666667	731
FBgn0030438	771	750	741	51	7	7.285714285714286	720
FBgn0030439	796	750	788	54	6	9	742
FBgn0030440	777	750	734	70	12	5.833333333333333	707
FBgn0030443	812	750	763	111	17	6.529411764705882	701
FBgn0030447	750	750	725	25	7	3.5714285714285716	725
FBgn0030451	761	750	744	28	6	4.666666666666667	733
FBgn0030457	750	750	747	3	1	3	747
FBgn0030459	774	750	729	69	12	5.75	705
FBgn0030465	756	750	735	27	7	3.857142857142857	729
FBgn0030466	563	556	533	37	8	4.625	526
FBgn0030467	771	750	762	30	8	3.75	741
FBgn0030468	760	750	725	45	8	5.625	715
FBgn0030477	753	750	735	21	8	2.625	732
FBgn0030479	769	750	753	35	7	5	734
FBgn0030480	769	750	745	43	8	5.375	726
FBgn0030481	764	750	755	23	6	3.8333333333333335	741
FBgn0030482	559	537	544	37	7	5.285714285714286	522
FBgn0030484	750	750	741	9	3	3	741
FBgn0030485	767	750	750	34	6	5.666666666666667	733
FBgn0030486	766	750	744	38	7	5.428571428571429	728
FBgn0030492	817	750	815	69	5	13.8	748
FBgn0030493	771	750	739	53	10	5.3	718
FBgn0030494	795	750	785	55	8	6.875	740
FBgn0030495	765	750	707	73	11	6.636363636363637	692
FBgn0030500	750	750	741	9	1	9	741
FBgn0030501	759	750	759	9	2	4.5	750
FBgn0030502	779	750	747	61	12	5.083333333333333	718
FBgn0030503	771	750	739	53	10	5.3	718
FBgn0030504	813	750	799	77	11	7	736
FBgn0030505	809	750	795	73	10	7.3	736
FBgn0030507	755	750	755	5	1	5	750
FBgn0030508	525	517	522	11	5	2.2	514
FBgn0030509	781	750	755	57	9	6.333333333333333	724
FBgn0030511	794	750	763	75	21	3.5714285714285716	719
FBgn0030512	757	750	503	261	10	26.1	496
FBgn0030514	764	750	764	14	1	14	750
FBgn0030518	751	750	739	13	2	6.5	738
FBgn0030519	695	673	671	46	11	4.181818181818182	649
FBgn0030521	763	750	763	13	2	6.5	750
FBgn0030522	767	750	759	25	5	5	742
FBgn0030528	751	750	743	9	3	3	742
FBgn0030530	784	750	682	136	12	11.333333333333334	648
FBgn0030536	861	750	815	157	16	9.8125	704
FBgn0030537	795	750	785	55	11	5	740
FBgn0030538	751	750	285	467	5	93.4	284
FBgn0030539	751	750	697	55	12	4.583333333333333	696
FBgn0030540	757	750	754	10	3	3.3333333333333335	747
FBgn0030541	754	750	698	60	8	7.5	694
FBgn0030542	754	750	717	41	8	5.125	713
FBgn0030543	768	750	677	109	7	15.571428571428571	659
FBgn0030544	775	750	736	64	6	10.666666666666666	711
FBgn0030545	604	591	536	81	9	9	523
FBgn0030551	755	750	740	20	6	3.3333333333333335	735
FBgn0030552	755	750	740	20	6	3.3333333333333335	735
FBgn0030554	751	750	749	3	3	1	748
FBgn0030555	764	750	756	22	8	2.75	742
FBgn0030559	753	750	712	44	6	7.333333333333333	709
FBgn0030562	764	750	726	52	7	7.428571428571429	712
FBgn0030569	754	750	693	65	7	9.285714285714286	689
FBgn0030570	750	750	730	20	4	5	730
FBgn0030571	798	750	755	91	13	7	707
FBgn0030574	770	750	741	49	11	4.454545454545454	721
FBgn0030575	792	750	772	62	10	6.2	730
FBgn0030576	773	750	667	129	11	11.727272727272727	644
FBgn0030577	752	750	612	142	9	15.777777777777779	610
FBgn0030578	754	750	291	467	8	58.375	287
FBgn0030582	754	750	265	493	2	246.5	261
FBgn0030583	794	750	762	76	13	5.846153846153846	718
FBgn0030586	805	750	788	72	8	9	733
FBgn0030587	774	750	762	36	9	4	738
FBgn0030588	772	750	759	35	9	3.888888888888889	737
FBgn0030589	753	750	733	23	5	4.6	730
FBgn0030590	820	750	797	93	9	10.333333333333334	727
FBgn0030592	818	750	812	74	8	9.25	744
FBgn0030593	766	750	743	39	8	4.875	727
FBgn0030595	786	750	783	39	8	4.875	747
FBgn0030597	761	750	755	17	6	2.8333333333333335	744
FBgn0030598	754	750	625	133	12	11.083333333333334	621
FBgn0030599	753	750	616	140	4	35	613
FBgn0030600	751	750	748	4	4	1	747
FBgn0030605	752	750	750	4	4	1	748
FBgn0030607	804	750	787	71	12	5.916666666666667	733
FBgn0030611	766	750	722	60	10	6	706
FBgn0030612	757	750	751	13	4	3.25	744
FBgn0030613	782	750	741	73	10	7.3	709
FBgn0030614	758	750	730	36	9	4	722
FBgn0030615	806	750	784	78	9	8.666666666666666	728
FBgn0030616	801	750	788	64	5	12.8	737
FBgn0030617	787	750	761	63	9	7	724
FBgn0030620	787	750	756	68	7	9.714285714285714	719
FBgn0030622	763	750	732	44	10	4.4	719
FBgn0030624	787	750	772	52	6	8.666666666666666	735
FBgn0030625	752	750	576	178	6	29.666666666666668	574
FBgn0030628	758	750	745	21	6	3.5	737
FBgn0030629	750	750	88	662	4	165.5	88
FBgn0030630	774	750	684	114	19	6	660
FBgn0030631	762	750	420	354	8	44.25	408
FBgn0030634	794	750	756	82	11	7.454545454545454	712
FBgn0030638	768	750	696	90	7	12.857142857142858	678
FBgn0030642	664	648	604	76	5	15.2	588
FBgn0030643	762	750	713	61	8	7.625	701
FBgn0030647	764	750	739	39	10	3.9	725
FBgn0030648	750	750	73	677	3	225.66666666666666	73
FBgn0030653	817	750	786	98	13	7.538461538461538	719
FBgn0030657	760	750	751	19	2	9.5	741
FBgn0030659	766	750	741	41	7	5.857142857142857	725
FBgn0030660	766	750	726	56	6	9.333333333333334	710
FBgn0030661	757	750	724	40	4	10	717
FBgn0030662	781	750	756	56	10	5.6	725
FBgn0030663	760	750	642	128	10	12.8	632
FBgn0030664	779	750	722	86	10	8.6	693
FBgn0030666	769	750	724	64	12	5.333333333333333	705
FBgn0030667	769	750	510	278	16	17.375	491
FBgn0030670	755	750	717	43	4	10.75	712
FBgn0030671	754	750	718	40	9	4.444444444444445	714
FBgn0030672	781	750	764	48	8	6	733
FBgn0030673	752	750	715	39	7	5.571428571428571	713
FBgn0030674	672	618	641	85	10	8.5	587
FBgn0030675	767	750	760	24	7	3.4285714285714284	743
FBgn0030676	750	750	667	83	5	16.6	667
FBgn0030678	770	750	740	50	3	16.666666666666668	720
FBgn0030679	770	750	748	42	2	21	728
FBgn0030684	751	750	631	121	7	17.285714285714285	630
FBgn0030685	764	750	740	38	6	6.333333333333333	726
FBgn0030686	766	750	742	40	7	5.714285714285714	726
FBgn0030688	750	750	722	28	3	9.333333333333334	722
FBgn0030691	626	604	610	38	7	5.428571428571429	588
FBgn0030699	750	750	747	3	1	3	747
FBgn0030700	755	750	673	87	7	12.428571428571429	668
FBgn0030701	798	750	782	64	7	9.142857142857142	734
FBgn0030703	750	750	502	248	4	62	502
FBgn0030706	778	750	764	42	10	4.2	736
FBgn0030707	792	750	747	87	15	5.8	705
FBgn0030710	750	750	727	23	5	4.6	727
FBgn0030711	780	750	751	59	6	9.833333333333334	721
FBgn0030715	512	507	248	269	2	134.5	243
FBgn0030716	790	750	670	160	11	14.545454545454545	630
FBgn0030717	797	750	702	142	12	11.833333333333334	655
FBgn0030718	754	750	744	14	7	2	740
FBgn0030720	753	750	747	9	7	1.2857142857142858	744
FBgn0030721	769	750	767	21	7	3	748
FBgn0030722	832	750	800	114	11	10.363636363636363	718
FBgn0030723	817	750	787	97	9	10.777777777777779	720
FBgn0030725	780	750	764	46	10	4.6	734
FBgn0030729	760	750	754	16	2	8	744
FBgn0030731	751	750	703	49	8	6.125	702
FBgn0030733	781	750	776	36	7	5.142857142857143	745
FBgn0030734	750	750	750	0	0	NA	750
FBgn0030735	758	750	741	25	5	5	733
FBgn0030738	752	750	726	28	7	4	724
FBgn0030739	753	750	728	28	8	3.5	725
FBgn0030740	763	750	709	67	6	11.166666666666666	696
FBgn0030742	786	750	774	48	14	3.4285714285714284	738
FBgn0030743	753	750	748	8	5	1.6	745
FBgn0030746	750	750	656	94	8	11.75	656
FBgn0030747	776	750	710	92	9	10.222222222222221	684
FBgn0030749	753	750	751	5	2	2.5	748
FBgn0030752	765	750	747	33	9	3.6666666666666665	732
FBgn0030753	757	750	749	15	3	5	742
FBgn0030759	803	750	797	59	9	6.555555555555555	744
FBgn0030766	802	750	790	64	8	8	738
FBgn0030768	769	750	765	23	6	3.8333333333333335	746
FBgn0030769	763	750	734	42	10	4.2	721
FBgn0030770	769	750	709	79	4	19.75	690
FBgn0030773	764	713	703	112	13	8.615384615384615	652
FBgn0030775	753	750	695	61	6	10.166666666666666	692
FBgn0030777	788	750	751	75	10	7.5	713
FBgn0030780	527	525	523	6	4	1.5	521
FBgn0030786	783	750	734	82	10	8.2	701
FBgn0030787	771	750	165	627	4	156.75	144
FBgn0030790	785	750	730	90	9	10	695
FBgn0030791	751	750	731	21	5	4.2	730
FBgn0030792	753	750	697	59	9	6.555555555555555	694
FBgn0030793	763	750	709	67	3	22.333333333333332	696
FBgn0030795	758	750	713	53	10	5.3	705
FBgn0030796	759	750	714	54	6	9	705
FBgn0030798	753	750	630	126	9	14	627
FBgn0030799	759	750	747	21	10	2.1	738
FBgn0030800	806	750	803	59	7	8.428571428571429	747
FBgn0030801	807	750	805	59	8	7.375	748
FBgn0030804	762	750	674	100	5	20	662
FBgn0030805	709	701	676	41	6	6.833333333333333	668
FBgn0030806	765	750	688	92	10	9.2	673
FBgn0030807	769	750	752	36	6	6	733
FBgn0030808	769	750	661	127	10	12.7	642
FBgn0030812	764	750	623	155	12	12.916666666666666	609
FBgn0030814	750	750	724	26	6	4.333333333333333	724
FBgn0030815	763	750	695	81	15	5.4	682
FBgn0030823	756	750	727	35	5	7	721
FBgn0030824	764	750	735	43	5	8.6	721
FBgn0030826	750	750	698	52	4	13	698
FBgn0030828	754	750	727	31	5	6.2	723
FBgn0030829	805	750	799	61	4	15.25	744
FBgn0030830	750	750	717	33	3	11	717
FBgn0030832	752	750	733	21	5	4.2	731
FBgn0030834	764	750	746	32	6	5.333333333333333	732
FBgn0030836	794	750	774	64	11	5.818181818181818	730
FBgn0030837	776	750	759	43	7	6.142857142857143	733
FBgn0030838	762	750	687	87	3	29	675
FBgn0030839	758	750	758	8	1	8	750
FBgn0030841	771	750	652	140	8	17.5	631
FBgn0030844	772	750	748	46	11	4.181818181818182	726
FBgn0030847	799	725	775	98	9	10.88888888888889	701
FBgn0030851	595	569	564	57	9	6.333333333333333	538
FBgn0030853	795	750	782	58	9	6.444444444444445	737
FBgn0030854	762	750	759	15	5	3	747
FBgn0030855	766	750	766	16	5	3.2	750
FBgn0030858	775	750	754	46	9	5.111111111111111	729
FBgn0030859	796	750	783	59	8	7.375	737
FBgn0030863	752	750	746	8	4	2	744
FBgn0030864	751	750	745	7	4	1.75	744
FBgn0030868	799	750	755	93	10	9.3	706
FBgn0030869	562	531	467	126	12	10.5	436
FBgn0030870	781	750	769	43	5	8.6	738
FBgn0030872	750	750	682	68	3	22.666666666666668	682
FBgn0030873	751	750	742	10	3	3.3333333333333335	741
FBgn0030874	754	750	747	11	3	3.6666666666666665	743
FBgn0030876	764	750	761	17	6	2.8333333333333335	747
FBgn0030877	766	750	762	20	4	5	746
FBgn0030878	766	750	760	22	6	3.6666666666666665	744
FBgn0030880	757	750	715	49	8	6.125	708
FBgn0030881	760	750	747	23	6	3.8333333333333335	737
FBgn0030883	783	750	783	33	4	8.25	750
FBgn0030884	791	750	777	55	10	5.5	736
FBgn0030887	765	750	752	28	4	7	737
FBgn0030889	766	750	763	19	3	6.333333333333333	747
FBgn0030890	701	699	683	20	5	4	681
FBgn0030891	757	750	752	12	9	1.3333333333333333	745
FBgn0030894	757	750	755	9	5	1.8	748
FBgn0030897	753	750	731	25	5	5	728
FBgn0030898	754	750	691	67	10	6.7	687
FBgn0030900	751	750	685	67	9	7.444444444444445	684
FBgn0030904	764	750	739	39	7	5.571428571428571	725
FBgn0030905	774	750	735	63	10	6.3	711
FBgn0030911	761	750	716	56	9	6.222222222222222	705
FBgn0030912	762	750	735	39	11	3.5454545454545454	723
FBgn0030914	755	750	712	48	12	4	707
FBgn0030915	756	750	755	7	3	2.3333333333333335	749
FBgn0030921	756	750	734	28	9	3.111111111111111	728
FBgn0030925	765	750	755	25	8	3.125	740
FBgn0030926	781	726	776	60	8	7.5	721
FBgn0030928	788	750	718	108	10	10.8	680
FBgn0030929	760	750	749	21	8	2.625	739
FBgn0030930	750	750	750	0	0	NA	750
FBgn0030931	751	750	748	4	4	1	747
FBgn0030933	768	750	731	55	12	4.583333333333333	713
FBgn0030936	750	750	538	212	6	35.333333333333336	538
FBgn0030937	756	750	657	105	5	21	651
FBgn0030941	781	750	751	61	14	4.357142857142857	720
FBgn0030945	752	750	673	81	6	13.5	671
FBgn0030946	793	750	770	66	9	7.333333333333333	727
FBgn0030947	750	750	721	29	2	14.5	721
FBgn0030949	774	750	760	38	7	5.428571428571429	736
FBgn0030951	762	750	710	64	11	5.818181818181818	698
FBgn0030952	761	750	749	23	7	3.2857142857142856	738
FBgn0030954	750	750	612	138	5	27.6	612
FBgn0030961	785	750	767	53	8	6.625	732
FBgn0030963	785	750	718	102	4	25.5	683
FBgn0030964	803	750	741	115	12	9.583333333333334	688
FBgn0030966	788	750	779	47	6	7.833333333333333	741
FBgn0030968	802	750	737	117	14	8.357142857142858	685
FBgn0030969	797	750	756	88	11	8	709
FBgn0030970	752	750	746	8	2	4	744
FBgn0030973	752	750	712	42	6	7	710
FBgn0030976	774	750	742	56	9	6.222222222222222	718
FBgn0030979	826	750	768	134	15	8.933333333333334	692
FBgn0030980	793	750	768	68	12	5.666666666666667	725
FBgn0030981	758	750	734	32	9	3.5555555555555554	726
FBgn0030982	762	750	697	77	7	11	685
FBgn0030984	769	750	282	506	4	126.5	263
FBgn0030985	743	737	726	23	8	2.875	720
FBgn0030990	782	750	753	61	8	7.625	721
FBgn0030991	782	750	754	60	8	7.5	722
FBgn0030992	752	750	684	70	8	8.75	682
FBgn0030995	765	750	726	54	5	10.8	711
FBgn0030997	752	750	691	63	9	7	689
FBgn0030998	765	750	616	164	10	16.4	601
FBgn0030999	766	750	746	36	11	3.272727272727273	730
FBgn0031000	791	706	779	97	10	9.7	694
FBgn0031002	758	750	573	193	9	21.444444444444443	565
FBgn0031004	762	750	722	52	8	6.5	710
FBgn0031005	784	750	753	65	17	3.823529411764706	719
FBgn0031006	795	750	766	74	10	7.4	721
FBgn0031008	750	750	738	12	4	3	738
FBgn0031010	780	750	700	110	10	11	670
FBgn0031011	787	750	755	69	8	8.625	718
FBgn0031012	786	750	730	92	10	9.2	694
FBgn0031018	750	750	580	170	2	85	580
FBgn0031020	753	750	752	4	2	2	749
FBgn0031021	751	750	411	341	5	68.2	410
FBgn0031026	765	750	687	93	13	7.153846153846154	672
FBgn0031030	782	750	735	79	11	7.181818181818182	703
FBgn0031031	767	750	669	115	15	7.666666666666667	652
FBgn0031032	830	750	758	152	14	10.857142857142858	678
FBgn0031034	760	750	716	54	12	4.5	706
FBgn0031036	750	750	464	286	4	71.5	464
FBgn0031040	770	750	745	45	8	5.625	725
FBgn0031043	756	750	746	16	5	3.2	740
FBgn0031044	760	750	754	16	5	3.2	744
FBgn0031045	764	750	718	60	19	3.1578947368421053	704
FBgn0031047	772	750	708	86	9	9.555555555555555	686
FBgn0031048	785	750	735	85	16	5.3125	700
FBgn0031049	789	750	743	85	12	7.083333333333333	704
FBgn0031050	753	750	521	235	4	58.75	518
FBgn0031051	774	750	765	33	7	4.714285714285714	741
FBgn0031052	750	750	729	21	4	5.25	729
FBgn0031053	775	750	751	49	10	4.9	726
FBgn0031054	775	750	751	49	10	4.9	726
FBgn0031055	647	647	613	34	6	5.666666666666667	613
FBgn0031057	752	750	750	4	2	2	748
FBgn0031058	760	750	620	150	8	18.75	610
FBgn0031061	750	750	748	2	2	1	748
FBgn0031062	750	750	742	8	2	4	742
FBgn0031064	765	750	751	29	4	7.25	736
FBgn0031065	799	750	770	78	7	11.142857142857142	721
FBgn0031069	843	750	834	102	10	10.2	741
FBgn0031070	763	750	681	95	8	11.875	668
FBgn0031077	763	750	743	33	5	6.6	730
FBgn0031078	763	750	755	21	5	4.2	742
FBgn0031080	796	750	728	114	12	9.5	682
FBgn0031082	786	750	720	102	7	14.571428571428571	684
FBgn0031086	770	750	562	228	7	32.57142857142857	542
FBgn0031091	789	750	432	396	4	99	393
FBgn0031092	789	750	522	306	5	61.2	483
FBgn0031093	750	750	729	21	3	7	729
FBgn0031094	750	750	730	20	2	10	730
FBgn0031097	769	750	695	93	9	10.333333333333334	676
FBgn0031098	776	750	767	35	6	5.833333333333333	741
FBgn0031099	751	750	681	71	6	11.833333333333334	680
FBgn0031100	750	750	734	16	6	2.6666666666666665	734
FBgn0031101	751	750	718	34	6	5.666666666666667	717
FBgn0031103	778	750	635	171	10	17.1	607
FBgn0031104	760	750	482	288	8	36	472
FBgn0031109	755	750	700	60	12	5	695
FBgn0031111	752	750	668	86	10	8.6	666
FBgn0031114	803	750	773	83	11	7.545454545454546	720
FBgn0031115	757	750	728	36	7	5.142857142857143	721
FBgn0031116	788	750	708	118	13	9.076923076923077	670
FBgn0031117	790	750	650	180	13	13.846153846153847	610
FBgn0031118	752	750	533	221	7	31.571428571428573	531
FBgn0031119	750	750	177	573	2	286.5	177
FBgn0031126	770	750	739	51	7	7.285714285714286	719
FBgn0031127	668	663	662	11	7	1.5714285714285714	657
FBgn0031128	763	750	761	15	6	2.5	748
FBgn0031129	750	750	729	21	3	7	729
FBgn0031130	783	750	776	40	7	5.714285714285714	743
FBgn0031135	751	750	726	26	6	4.333333333333333	725
FBgn0031142	562	519	541	64	8	8	498
FBgn0031144	769	750	248	540	5	108	229
FBgn0031146	805	750	685	175	8	21.875	630
FBgn0031148	861	750	822	150	15	10	711
FBgn0031149	816	750	812	70	6	11.666666666666666	746
FBgn0031150	751	750	735	17	4	4.25	734
FBgn0031157	750	750	257	493	4	123.25	257
FBgn0031161	753	750	730	26	7	3.7142857142857144	727
FBgn0031170	759	750	719	49	5	9.8	710
FBgn0031171	756	750	749	13	4	3.25	743
FBgn0031174	783	750	757	59	10	5.9	724
FBgn0031176	783	750	765	51	6	8.5	732
FBgn0031184	750	750	407	343	2	171.5	407
FBgn0031187	805	750	770	90	9	10	715
FBgn0031189	750	750	380	370	4	92.5	380
FBgn0031190	757	750	747	17	5	3.4	740
FBgn0031191	781	750	761	51	15	3.4	730
FBgn0031194	766	750	704	78	9	8.666666666666666	688
FBgn0031195	754	750	657	101	10	10.1	653
FBgn0031209	756	750	745	17	9	1.8888888888888888	739
FBgn0031213	756	750	703	59	10	5.9	697
FBgn0031216	751	750	527	225	5	45	526
FBgn0031227	785	750	782	38	6	6.333333333333333	747
FBgn0031228	763	750	757	19	5	3.8	744
FBgn0031231	769	750	751	37	10	3.7	732
FBgn0031232	751	750	749	3	2	1.5	748
FBgn0031233	771	750	753	39	9	4.333333333333333	732
FBgn0031235	758	750	750	16	6	2.6666666666666665	742
FBgn0031240	787	750	772	52	4	13	735
FBgn0031244	621	616	611	15	4	3.75	606
FBgn0031245	762	750	747	27	7	3.857142857142857	735
FBgn0031247	762	750	747	27	7	3.857142857142857	735
FBgn0031248	775	750	764	36	5	7.2	739
FBgn0031249	751	750	726	26	3	8.666666666666666	725
FBgn0031250	757	750	747	17	4	4.25	740
FBgn0031251	750	750	727	23	3	7.666666666666667	727
FBgn0031252	756	750	754	8	3	2.6666666666666665	748
FBgn0031253	750	750	731	19	4	4.75	731
FBgn0031254	751	750	736	16	4	4	735
FBgn0031256	751	750	723	29	6	4.833333333333333	722
FBgn0031258	787	750	768	56	7	8	731
FBgn0031263	751	750	704	48	6	8	703
FBgn0031264	776	750	730	72	8	9	704
FBgn0031265	817	750	792	92	12	7.666666666666667	725
FBgn0031266	794	750	792	46	5	9.2	748
FBgn0031267	752	750	751	3	2	1.5	749
FBgn0031268	750	750	749	1	1	1	749
FBgn0031270	761	750	727	45	14	3.2142857142857144	716
FBgn0031275	768	750	747	39	7	5.571428571428571	729
FBgn0031277	750	750	717	33	5	6.6	717
FBgn0031281	750	750	750	0	0	NA	750
FBgn0031282	750	750	749	1	1	1	749
FBgn0031283	556	556	506	50	5	10	506
FBgn0031284	752	750	732	22	5	4.4	730
FBgn0031286	750	750	741	9	1	9	741
FBgn0031287	751	750	722	30	6	5	721
FBgn0031288	792	750	705	129	9	14.333333333333334	663
FBgn0031292	779	750	759	49	11	4.454545454545454	730
FBgn0031294	767	750	722	62	12	5.166666666666667	705
FBgn0031296	794	750	778	60	8	7.5	734
FBgn0031299	762	750	754	20	5	4	742
FBgn0031301	756	750	747	15	4	3.75	741
FBgn0031304	772	750	747	47	7	6.714285714285714	725
FBgn0031305	761	750	750	22	9	2.4444444444444446	739
FBgn0031306	761	750	753	19	7	2.7142857142857144	742
FBgn0031309	751	750	741	11	3	3.6666666666666665	740
FBgn0031310	751	750	740	12	3	4	739
FBgn0031312	758	750	690	76	5	15.2	682
FBgn0031314	782	750	641	173	7	24.714285714285715	609
FBgn0031317	753	750	721	35	7	5	718
FBgn0031318	754	750	749	9	4	2.25	745
FBgn0031320	751	750	748	4	2	2	747
FBgn0031321	752	750	750	4	2	2	748
FBgn0031323	754	750	541	217	6	36.166666666666664	537
FBgn0031327	750	750	708	42	5	8.4	708
FBgn0031331	780	750	776	34	7	4.857142857142857	746
FBgn0031335	767	750	726	58	8	7.25	709
FBgn0031337	750	750	723	27	2	13.5	723
FBgn0031344	750	750	719	31	3	10.333333333333334	719
FBgn0031347	751	750	751	1	1	1	750
FBgn0031351	751	750	735	17	6	2.8333333333333335	734
FBgn0031356	772	750	745	49	5	9.8	723
FBgn0031357	758	750	758	8	4	2	750
FBgn0031359	762	750	739	35	12	2.9166666666666665	727
FBgn0031361	751	750	750	2	2	1	749
FBgn0031364	763	750	756	20	4	5	743
FBgn0031365	759	750	741	27	6	4.5	732
FBgn0031367	767	750	757	27	5	5.4	740
FBgn0031372	761	750	731	41	2	20.5	720
FBgn0031373	750	750	247	503	4	125.75	247
FBgn0031374	782	750	290	524	6	87.33333333333333	258
FBgn0031375	753	750	747	9	2	4.5	744
FBgn0031377	758	750	756	10	2	5	748
FBgn0031378	758	750	756	10	2	5	748
FBgn0031381	750	750	741	9	4	2.25	741
FBgn0031388	838	750	834	92	7	13.142857142857142	746
FBgn0031389	753	750	732	24	4	6	729
FBgn0031390	726	712	715	25	8	3.125	701
FBgn0031391	760	750	753	17	7	2.4285714285714284	743
FBgn0031393	750	750	715	35	8	4.375	715
FBgn0031398	539	514	537	27	4	6.75	512
FBgn0031399	750	750	746	4	1	4	746
FBgn0031406	789	750	783	45	6	7.5	744
FBgn0031407	768	750	747	39	6	6.5	729
FBgn0031409	758	750	749	17	6	2.8333333333333335	741
FBgn0031410	752	750	639	115	2	57.5	637
FBgn0031412	750	750	600	150	5	30	600
FBgn0031413	778	750	768	38	6	6.333333333333333	740
FBgn0031414	757	750	729	35	7	5	722
FBgn0031417	756	750	752	10	3	3.3333333333333335	746
FBgn0031419	799	750	793	55	9	6.111111111111111	744
FBgn0031423	776	750	767	35	4	8.75	741
FBgn0031424	750	750	678	72	1	72	678
FBgn0031428	784	750	773	45	8	5.625	739
FBgn0031430	772	750	729	65	5	13	707
FBgn0031431	774	750	742	56	7	8	718
FBgn0031434	795	750	712	128	10	12.8	667
FBgn0031435	785	750	641	179	9	19.88888888888889	606
FBgn0031436	750	750	732	18	3	6	732
FBgn0031437	787	750	773	51	6	8.5	736
FBgn0031440	770	750	768	22	4	5.5	748
FBgn0031441	761	750	689	83	7	11.857142857142858	678
FBgn0031442	750	750	737	13	2	6.5	737
FBgn0031444	750	750	729	21	4	5.25	729
FBgn0031446	753	750	716	40	10	4	713
FBgn0031449	762	750	747	27	7	3.857142857142857	735
FBgn0031451	751	750	683	69	2	34.5	682
FBgn0031452	750	750	726	24	2	12	726
FBgn0031453	767	750	760	24	6	4	743
FBgn0031456	762	750	757	17	4	4.25	745
FBgn0031457	751	750	716	36	3	12	715
FBgn0031458	751	750	716	36	3	12	715
FBgn0031459	758	750	743	23	5	4.6	735
FBgn0031461	761	750	726	46	8	5.75	715
FBgn0031462	685	677	632	61	4	15.25	624
FBgn0031463	597	581	596	17	2	8.5	580
FBgn0031467	755	750	749	11	3	3.6666666666666665	744
FBgn0031468	713	670	692	64	8	8	649
FBgn0031471	750	750	436	314	1	314	436
FBgn0031472	794	750	511	327	9	36.333333333333336	467
FBgn0031473	750	750	740	10	4	2.5	740
FBgn0031476	752	750	744	10	5	2	742
FBgn0031478	753	750	715	41	6	6.833333333333333	712
FBgn0031479	754	750	730	28	4	7	726
FBgn0031483	750	750	734	16	2	8	734
FBgn0031484	750	750	742	8	3	2.6666666666666665	742
FBgn0031485	757	750	710	54	10	5.4	703
FBgn0031489	861	750	861	111	8	13.875	750
FBgn0031491	750	750	750	0	0	NA	750
FBgn0031492	751	750	751	1	1	1	750
FBgn0031493	752	750	752	2	2	1	750
FBgn0031494	751	750	739	13	2	6.5	738
FBgn0031497	751	750	747	5	3	1.6666666666666667	746
FBgn0031498	750	750	750	0	0	NA	750
FBgn0031500	750	750	750	0	0	NA	750
FBgn0031501	774	750	759	39	4	9.75	735
FBgn0031504	763	750	464	312	6	52	451
FBgn0031505	754	750	597	161	11	14.636363636363637	593
FBgn0031512	751	750	750	2	2	1	749
FBgn0031513	785	750	774	46	6	7.666666666666667	739
FBgn0031514	754	750	735	23	4	5.75	731
FBgn0031516	757	750	695	69	9	7.666666666666667	688
FBgn0031519	757	750	756	8	2	4	749
FBgn0031520	752	750	746	8	4	2	744
FBgn0031526	752	750	549	205	6	34.166666666666664	547
FBgn0031529	751	750	748	4	3	1.3333333333333333	747
FBgn0031530	818	750	797	89	8	11.125	729
FBgn0031531	756	750	729	33	5	6.6	723
FBgn0031533	758	750	722	44	6	7.333333333333333	714
FBgn0031534	758	750	746	20	6	3.3333333333333335	738
FBgn0031535	752	750	711	43	5	8.6	709
FBgn0031536	770	750	767	23	5	4.6	747
FBgn0031538	782	750	769	45	9	5	737
FBgn0031540	770	750	758	32	2	16	738
FBgn0031542	750	750	741	9	3	3	741
FBgn0031544	752	750	748	6	4	1.5	746
FBgn0031545	763	750	754	22	5	4.4	741
FBgn0031546	750	750	743	7	2	3.5	743
FBgn0031547	753	750	733	23	6	3.8333333333333335	730
FBgn0031548	750	750	697	53	7	7.571428571428571	697
FBgn0031549	787	750	749	75	14	5.357142857142857	712
FBgn0031550	769	750	659	129	9	14.333333333333334	640
FBgn0031554	750	750	746	4	2	2	746
FBgn0031561	741	714	722	46	4	11.5	695
FBgn0031562	724	713	680	55	9	6.111111111111111	669
FBgn0031563	750	750	738	12	3	4	738
FBgn0031564	711	711	562	149	5	29.8	562
FBgn0031566	758	750	746	20	5	4	738
FBgn0031568	750	750	746	4	3	1.3333333333333333	746
FBgn0031571	765	750	726	54	9	6	711
FBgn0031573	776	750	742	60	13	4.615384615384615	716
FBgn0031574	787	750	715	109	16	6.8125	678
FBgn0031575	590	575	567	38	4	9.5	552
FBgn0031579	617	601	564	69	6	11.5	548
FBgn0031580	675	670	656	24	7	3.4285714285714284	651
FBgn0031585	769	750	720	68	11	6.181818181818182	701
FBgn0031589	769	750	759	29	8	3.625	740
FBgn0031590	769	750	717	71	13	5.461538461538462	698
FBgn0031592	756	750	741	21	7	3	735
FBgn0031596	750	750	725	25	3	8.333333333333334	725
FBgn0031600	751	750	507	245	2	122.5	506
FBgn0031603	767	750	751	33	8	4.125	734
FBgn0031604	752	750	748	6	2	3	746
FBgn0031607	750	750	745	5	2	2.5	745
FBgn0031608	752	750	710	44	4	11	708
FBgn0031609	767	750	681	103	2	51.5	664
FBgn0031619	755	750	738	22	9	2.4444444444444446	733
FBgn0031620	791	750	588	244	12	20.333333333333332	547
FBgn0031623	760	750	756	14	5	2.8	746
FBgn0031626	784	750	751	67	5	13.4	717
FBgn0031627	757	750	734	30	9	3.3333333333333335	727
FBgn0031628	752	750	740	14	4	3.5	738
FBgn0031631	801	750	733	119	5	23.8	682
FBgn0031632	776	750	760	42	6	7	734
FBgn0031635	755	750	751	9	5	1.8	746
FBgn0031636	755	750	753	7	3	2.3333333333333335	748
FBgn0031637	769	750	764	24	8	3	745
FBgn0031638	765	750	760	20	7	2.857142857142857	745
FBgn0031639	750	750	750	0	0	NA	750
FBgn0031640	750	750	750	0	0	NA	750
FBgn0031643	750	750	744	6	3	2	744
FBgn0031644	808	750	752	114	13	8.76923076923077	694
FBgn0031645	778	750	668	138	14	9.857142857142858	640
FBgn0031646	798	750	753	93	15	6.2	705
FBgn0031649	797	750	744	100	11	9.090909090909092	697
FBgn0031650	755	750	723	37	7	5.285714285714286	718
FBgn0031651	762	750	762	12	2	6	750
FBgn0031653	783	750	722	94	13	7.230769230769231	689
FBgn0031654	750	750	401	349	2	174.5	401
FBgn0031657	753	750	713	43	3	14.333333333333334	710
FBgn0031659	762	750	761	13	5	2.6	749
FBgn0031661	754	750	752	6	5	1.2	748
FBgn0031662	754	750	752	6	5	1.2	748
FBgn0031664	762	750	758	16	3	5.333333333333333	746
FBgn0031670	759	750	751	17	6	2.8333333333333335	742
FBgn0031673	860	750	820	150	9	16.666666666666668	710
FBgn0031676	750	750	747	3	1	3	747
FBgn0031681	796	750	782	60	7	8.571428571428571	736
FBgn0031682	796	750	781	61	8	7.625	735
FBgn0031683	763	750	469	307	5	61.4	456
FBgn0031684	753	750	737	19	6	3.1666666666666665	734
FBgn0031688	751	750	636	116	9	12.88888888888889	635
FBgn0031689	776	750	736	66	10	6.6	710
FBgn0031692	751	750	711	41	3	13.666666666666666	710
FBgn0031696	759	750	726	42	6	7	717
FBgn0031697	772	750	723	71	15	4.733333333333333	701
FBgn0031698	752	750	748	6	4	1.5	746
FBgn0031700	757	750	719	45	7	6.428571428571429	712
FBgn0031701	773	750	679	117	8	14.625	656
FBgn0031702	752	750	727	27	5	5.4	725
FBgn0031707	784	750	760	58	12	4.833333333333333	726
FBgn0031708	751	750	718	34	7	4.857142857142857	717
FBgn0031710	774	750	679	119	3	39.666666666666664	655
FBgn0031711	750	750	540	210	3	70	540
FBgn0031713	755	750	750	10	4	2.5	745
FBgn0031715	717	701	685	48	13	3.6923076923076925	669
FBgn0031717	766	750	710	72	7	10.285714285714286	694
FBgn0031718	811	750	792	80	11	7.2727272727272725	731
FBgn0031719	808	750	784	82	14	5.857142857142857	726
FBgn0031720	752	750	728	26	3	8.666666666666666	726
FBgn0031721	750	750	748	2	1	2	748
FBgn0031722	777	750	745	59	8	7.375	718
FBgn0031723	796	750	782	60	9	6.666666666666667	736
FBgn0031724	801	750	796	56	9	6.222222222222222	745
FBgn0031725	755	750	680	80	7	11.428571428571429	675
FBgn0031726	809	750	792	76	10	7.6	733
FBgn0031728	750	750	732	18	6	3	732
FBgn0031729	750	750	743	7	1	7	743
FBgn0031730	756	750	746	16	7	2.2857142857142856	740
FBgn0031731	755	750	688	72	6	12	683
FBgn0031732	766	750	758	24	4	6	742
FBgn0031733	754	750	752	6	4	1.5	748
FBgn0031734	770	750	718	72	7	10.285714285714286	698
FBgn0031737	763	750	720	56	7	8	707
FBgn0031738	616	616	588	28	5	5.6	588
FBgn0031739	751	750	529	223	2	111.5	528
FBgn0031740	759	750	617	151	5	30.2	608
FBgn0031741	754	750	675	83	7	11.857142857142858	671
FBgn0031745	758	750	718	48	7	6.857142857142857	710
FBgn0031746	619	602	579	57	12	4.75	562
FBgn0031749	757	750	752	12	3	4	745
FBgn0031751	755	750	746	14	7	2	741
FBgn0031752	806	750	772	90	19	4.7368421052631575	716
FBgn0031756	752	750	742	12	7	1.7142857142857142	740
FBgn0031757	752	750	739	15	8	1.875	737
FBgn0031759	787	750	748	76	13	5.846153846153846	711
FBgn0031760	786	750	746	76	13	5.846153846153846	710
FBgn0031762	756	750	703	59	7	8.428571428571429	697
FBgn0031763	751	750	747	5	4	1.25	746
FBgn0031764	774	750	518	280	8	35	494
FBgn0031766	767	750	765	19	5	3.8	748
FBgn0031768	750	750	750	0	0	NA	750
FBgn0031770	752	750	752	2	2	1	750
FBgn0031771	751	750	738	14	6	2.3333333333333335	737
FBgn0031772	751	750	741	11	5	2.2	740
FBgn0031773	750	750	744	6	2	3	744
FBgn0031774	759	750	759	9	1	9	750
FBgn0031775	785	750	757	63	13	4.846153846153846	722
FBgn0031776	785	750	762	58	11	5.2727272727272725	727
FBgn0031777	785	750	738	82	12	6.833333333333333	703
FBgn0031778	762	750	746	28	5	5.6	734
FBgn0031779	767	750	698	86	11	7.818181818181818	681
FBgn0031782	750	750	616	134	1	134	616
FBgn0031784	759	750	728	40	10	4	719
FBgn0031785	766	750	761	21	6	3.5	745
FBgn0031786	752	750	721	33	8	4.125	719
FBgn0031792	751	750	750	2	2	1	749
FBgn0031799	759	750	752	16	5	3.2	743
FBgn0031800	777	750	768	36	7	5.142857142857143	741
FBgn0031801	794	750	744	94	14	6.714285714285714	700
FBgn0031802	761	750	751	21	3	7	740
FBgn0031803	761	750	745	27	4	6.75	734
FBgn0031805	769	750	477	311	5	62.2	458
FBgn0031808	770	750	752	38	5	7.6	732
FBgn0031811	750	750	744	6	4	1.5	744
FBgn0031813	785	750	697	123	10	12.3	662
FBgn0031814	771	750	770	22	3	7.333333333333333	749
FBgn0031815	750	750	747	3	2	1.5	747
FBgn0031816	787	750	754	70	5	14	717
FBgn0031818	679	658	678	22	5	4.4	657
FBgn0031820	757	750	756	8	2	4	749
FBgn0031822	754	750	749	9	2	4.5	745
FBgn0031824	752	750	751	3	2	1.5	749
FBgn0031826	753	750	740	16	4	4	737
FBgn0031829	757	750	753	11	3	3.6666666666666665	746
FBgn0031830	760	750	740	30	10	3	730
FBgn0031832	750	750	730	20	4	5	730
FBgn0031834	773	750	634	162	12	13.5	611
FBgn0031835	763	750	745	31	6	5.166666666666667	732
FBgn0031836	790	750	763	67	13	5.153846153846154	723
FBgn0031837	772	750	765	29	6	4.833333333333333	743
FBgn0031844	751	750	738	14	4	3.5	737
FBgn0031848	751	750	745	7	5	1.4	744
FBgn0031850	774	750	772	26	7	3.7142857142857144	748
FBgn0031851	762	750	708	66	15	4.4	696
FBgn0031853	755	750	744	16	8	2	739
FBgn0031854	761	750	712	60	8	7.5	701
FBgn0031855	779	750	687	121	14	8.642857142857142	658
FBgn0031856	561	561	533	28	3	9.333333333333334	533
FBgn0031857	804	750	787	71	6	11.833333333333334	733
FBgn0031858	764	750	759	19	4	4.75	745
FBgn0031859	750	750	680	70	4	17.5	680
FBgn0031860	758	750	751	15	6	2.5	743
FBgn0031861	750	750	725	25	4	6.25	725
FBgn0031865	758	750	713	53	7	7.571428571428571	705
FBgn0031866	523	521	519	6	3	2	517
FBgn0031868	789	750	776	52	4	13	737
FBgn0031869	752	750	739	15	5	3	737
FBgn0031873	754	750	739	19	2	9.5	735
FBgn0031874	754	750	753	5	2	2.5	749
FBgn0031875	776	750	748	54	11	4.909090909090909	722
FBgn0031876	750	750	743	7	2	3.5	743
FBgn0031877	750	750	750	0	0	NA	750
FBgn0031878	757	750	755	9	4	2.25	748
FBgn0031881	759	750	741	27	4	6.75	732
FBgn0031883	755	750	717	43	5	8.6	712
FBgn0031885	785	750	756	64	8	8	721
FBgn0031893	801	750	793	59	11	5.363636363636363	742
FBgn0031894	772	750	734	60	9	6.666666666666667	712
FBgn0031895	769	750	756	32	8	4	737
FBgn0031896	756	750	753	9	4	2.25	747
FBgn0031900	781	750	732	80	8	10	701
FBgn0031903	753	750	752	4	3	1.3333333333333333	749
FBgn0031904	758	750	754	12	4	3	746
FBgn0031905	758	750	755	11	4	2.75	747
FBgn0031906	774	750	723	75	3	25	699
FBgn0031907	805	750	784	76	10	7.6	729
FBgn0031909	764	750	719	59	15	3.933333333333333	705
FBgn0031910	769	750	742	46	6	7.666666666666667	723
FBgn0031913	759	750	740	28	8	3.5	731
FBgn0031918	778	750	776	30	5	6	748
FBgn0031920	750	750	747	3	1	3	747
FBgn0031925	783	750	710	106	15	7.066666666666666	677
FBgn0031926	769	750	751	37	8	4.625	732
FBgn0031930	800	750	797	53	4	13.25	747
FBgn0031936	792	732	786	66	8	8.25	726
FBgn0031937	786	750	769	53	10	5.3	733
FBgn0031940	760	750	751	19	5	3.8	741
FBgn0031941	754	750	741	17	7	2.4285714285714284	737
FBgn0031942	756	750	724	38	7	5.428571428571429	718
FBgn0031945	760	750	757	13	3	4.333333333333333	747
FBgn0031948	809	750	798	70	15	4.666666666666667	739
FBgn0031950	770	750	732	58	6	9.666666666666666	712
FBgn0031951	751	750	749	3	3	1	748
FBgn0031952	855	750	841	119	12	9.916666666666666	736
FBgn0031954	800	750	578	272	9	30.22222222222222	528
FBgn0031955	761	750	751	21	4	5.25	740
FBgn0031957	760	750	706	64	5	12.8	696
FBgn0031959	753	750	740	16	4	4	737
FBgn0031970	762	750	717	57	14	4.071428571428571	705
FBgn0031971	762	750	685	89	13	6.846153846153846	673
FBgn0031973	751	750	721	31	8	3.875	720
FBgn0031976	756	750	695	67	9	7.444444444444445	689
FBgn0031977	798	750	606	240	6	40	558
FBgn0031979	781	750	711	101	14	7.214285714285714	680
FBgn0031980	767	750	729	55	9	6.111111111111111	712
FBgn0031981	767	750	730	54	9	6	713
FBgn0031985	764	750	764	14	2	7	750
FBgn0031986	764	750	764	14	2	7	750
FBgn0031987	754	750	750	8	5	1.6	746
FBgn0031988	759	750	758	10	3	3.3333333333333335	749
FBgn0031990	761	750	742	30	6	5	731
FBgn0031992	769	750	705	83	8	10.375	686
FBgn0031995	751	750	739	13	3	4.333333333333333	738
FBgn0031999	843	750	811	125	11	11.363636363636363	718
FBgn0032000	752	750	725	29	7	4.142857142857143	723
FBgn0032001	750	750	749	1	1	1	749
FBgn0032003	811	750	749	123	14	8.785714285714286	688
FBgn0032005	791	750	766	66	12	5.5	725
FBgn0032006	604	586	576	46	7	6.571428571428571	558
FBgn0032010	779	750	751	57	8	7.125	722
FBgn0032013	759	750	721	47	12	3.9166666666666665	712
FBgn0032015	754	750	754	4	1	4	750
FBgn0032016	754	750	754	4	1	4	750
FBgn0032017	763	750	756	20	5	4	743
FBgn0032018	763	750	761	15	4	3.75	748
FBgn0032020	790	750	773	57	14	4.071428571428571	733
FBgn0032021	824	750	791	107	13	8.23076923076923	717
FBgn0032022	751	750	649	103	7	14.714285714285714	648
FBgn0032023	760	750	716	54	9	6	706
FBgn0032024	771	750	760	32	12	2.6666666666666665	739
FBgn0032025	781	750	703	109	13	8.384615384615385	672
FBgn0032026	839	750	825	103	11	9.363636363636363	736
FBgn0032029	764	738	746	44	6	7.333333333333333	720
FBgn0032031	750	750	740	10	2	5	740
FBgn0032032	750	750	740	10	2	5	740
FBgn0032033	751	750	699	53	3	17.666666666666668	698
FBgn0032034	751	750	688	64	2	32	687
FBgn0032036	750	750	744	6	1	6	744
FBgn0032039	797	750	778	66	9	7.333333333333333	731
FBgn0032040	758	750	720	46	8	5.75	712
FBgn0032042	755	750	532	228	5	45.6	527
FBgn0032047	764	750	688	90	7	12.857142857142858	674
FBgn0032048	752	750	737	17	7	2.4285714285714284	735
FBgn0032050	739	726	471	281	4	70.25	458
FBgn0032051	754	750	750	8	4	2	746
FBgn0032052	766	750	762	20	6	3.3333333333333335	746
FBgn0032053	764	750	759	19	5	3.8	745
FBgn0032054	750	750	748	2	1	2	748
FBgn0032055	673	661	673	12	3	4	661
FBgn0032057	798	750	769	77	9	8.555555555555555	721
FBgn0032059	751	750	728	24	5	4.8	727
FBgn0032065	769	750	753	35	10	3.5	734
FBgn0032067	672	659	652	33	5	6.6	639
FBgn0032069	652	644	599	61	3	20.333333333333332	591
FBgn0032074	754	750	715	43	7	6.142857142857143	711
FBgn0032075	768	750	757	29	8	3.625	739
FBgn0032077	678	676	663	17	4	4.25	661
FBgn0032078	759	750	638	130	14	9.285714285714286	629
FBgn0032079	764	750	739	39	5	7.8	725
FBgn0032080	753	750	738	18	7	2.5714285714285716	735
FBgn0032082	520	506	506	28	7	4	492
FBgn0032083	757	750	710	54	6	9	703
FBgn0032086	759	750	709	59	16	3.6875	700
FBgn0032087	838	750	825	101	10	10.1	737
FBgn0032088	770	750	738	52	9	5.777777777777778	718
FBgn0032089	773	750	755	41	8	5.125	732
FBgn0032094	788	750	752	74	9	8.222222222222221	714
FBgn0032095	750	750	687	63	6	10.5	687
FBgn0032096	750	750	749	1	1	1	749
FBgn0032100	757	750	706	58	11	5.2727272727272725	699
FBgn0032101	760	750	747	23	8	2.875	737
FBgn0032105	814	750	785	93	13	7.153846153846154	721
FBgn0032110	796	750	782	60	8	7.5	736
FBgn0032111	621	594	613	35	5	7	586
FBgn0032116	751	750	735	17	6	2.8333333333333335	734
FBgn0032117	755	750	734	26	7	3.7142857142857144	729
FBgn0032120	773	750	767	29	8	3.625	744
FBgn0032124	763	750	757	19	7	2.7142857142857144	744
FBgn0032125	809	750	770	98	13	7.538461538461538	711
FBgn0032126	693	692	682	12	3	4	681
FBgn0032127	756	750	714	48	5	9.6	708
FBgn0032129	785	750	771	49	8	6.125	736
FBgn0032130	791	750	789	43	6	7.166666666666667	748
FBgn0032131	750	750	733	17	5	3.4	733
FBgn0032132	764	750	756	22	4	5.5	742
FBgn0032135	774	750	763	35	4	8.75	739
FBgn0032136	773	750	767	29	7	4.142857142857143	744
FBgn0032138	782	750	750	64	7	9.142857142857142	718
FBgn0032139	756	750	743	19	2	9.5	737
FBgn0032140	776	750	751	51	10	5.1	725
FBgn0032143	750	750	749	1	1	1	749
FBgn0032144	673	659	641	46	9	5.111111111111111	627
FBgn0032147	764	750	731	47	11	4.2727272727272725	717
FBgn0032150	769	750	752	36	8	4.5	733
FBgn0032151	753	750	701	55	10	5.5	698
FBgn0032153	750	750	735	15	2	7.5	735
FBgn0032156	611	605	590	27	6	4.5	584
FBgn0032157	764	750	743	35	6	5.833333333333333	729
FBgn0032160	785	750	748	72	10	7.2	713
FBgn0032163	750	750	743	7	4	1.75	743
FBgn0032167	787	750	766	58	12	4.833333333333333	729
FBgn0032168	768	750	747	39	7	5.571428571428571	729
FBgn0032169	752	750	737	17	4	4.25	735
FBgn0032170	750	750	750	0	0	NA	750
FBgn0032171	750	750	750	0	0	NA	750
FBgn0032172	595	595	571	24	7	3.4285714285714284	571
FBgn0032175	755	750	743	17	5	3.4	738
FBgn0032176	770	750	763	27	6	4.5	743
FBgn0032178	777	750	707	97	12	8.083333333333334	680
FBgn0032187	759	750	718	50	9	5.555555555555555	709
FBgn0032188	755	750	706	54	12	4.5	701
FBgn0032189	751	750	751	1	1	1	750
FBgn0032193	765	750	721	59	9	6.555555555555555	706
FBgn0032194	762	750	689	85	6	14.166666666666666	677
FBgn0032198	795	750	591	249	20	12.45	546
FBgn0032200	615	615	247	368	2	184	247
FBgn0032202	766	750	739	43	9	4.777777777777778	723
FBgn0032209	555	531	525	54	8	6.75	501
FBgn0032211	714	652	710	66	9	7.333333333333333	648
FBgn0032216	750	750	737	13	4	3.25	737
FBgn0032217	750	750	732	18	4	4.5	732
FBgn0032218	752	750	741	13	5	2.6	739
FBgn0032219	780	750	749	61	13	4.6923076923076925	719
FBgn0032221	759	750	753	15	4	3.75	744
FBgn0032222	757	750	742	22	4	5.5	735
FBgn0032228	750	750	750	0	0	NA	750
FBgn0032229	765	750	721	59	12	4.916666666666667	706
FBgn0032230	763	646	750	130	10	13	633
FBgn0032231	542	542	541	1	1	1	541
FBgn0032233	766	750	763	19	3	6.333333333333333	747
FBgn0032234	750	750	750	0	0	NA	750
FBgn0032236	781	750	767	45	8	5.625	736
FBgn0032242	760	750	747	23	8	2.875	737
FBgn0032243	760	750	745	25	8	3.125	735
FBgn0032244	756	750	744	18	7	2.5714285714285716	738
FBgn0032246	817	750	809	75	11	6.818181818181818	742
FBgn0032247	752	750	744	10	5	2	742
FBgn0032248	761	750	761	11	3	3.6666666666666665	750
FBgn0032249	763	750	739	37	4	9.25	726
FBgn0032250	752	750	728	26	3	8.666666666666666	726
FBgn0032252	758	750	656	110	12	9.166666666666666	648
FBgn0032253	770	750	742	48	11	4.363636363636363	722
FBgn0032256	786	750	730	92	8	11.5	694
FBgn0032258	767	750	741	43	5	8.6	724
FBgn0032259	756	750	740	22	2	11	734
FBgn0032260	760	750	715	55	7	7.857142857142857	705
FBgn0032262	765	750	748	32	7	4.571428571428571	733
FBgn0032264	790	750	780	50	6	8.333333333333334	740
FBgn0032266	764	745	739	44	7	6.285714285714286	720
FBgn0032269	767	750	742	42	4	10.5	725
FBgn0032271	751	750	749	3	3	1	748
FBgn0032280	768	750	754	32	7	4.571428571428571	736
FBgn0032281	553	543	313	250	5	50	303
FBgn0032282	775	750	731	69	8	8.625	706
FBgn0032283	760	750	740	30	8	3.75	730
FBgn0032284	765	750	712	68	8	8.5	697
FBgn0032285	751	750	707	45	8	5.625	706
FBgn0032286	758	750	754	12	5	2.4	746
FBgn0032287	756	750	721	41	8	5.125	715
FBgn0032289	780	750	755	55	6	9.166666666666666	725
FBgn0032292	760	750	576	194	3	64.66666666666667	566
FBgn0032293	755	750	571	189	3	63	566
FBgn0032294	769	750	765	23	3	7.666666666666667	746
FBgn0032295	775	750	771	29	4	7.25	746
FBgn0032296	750	750	746	4	3	1.3333333333333333	746
FBgn0032297	775	750	657	143	3	47.666666666666664	632
FBgn0032299	760	750	689	81	7	11.571428571428571	679
FBgn0032303	787	750	786	38	3	12.666666666666666	749
FBgn0032305	807	750	793	71	11	6.454545454545454	736
FBgn0032311	754	750	730	28	8	3.5	726
FBgn0032312	777	750	735	69	13	5.3076923076923075	708
FBgn0032313	755	750	546	214	5	42.8	541
FBgn0032314	769	750	699	89	12	7.416666666666667	680
FBgn0032315	769	750	750	38	9	4.222222222222222	731
FBgn0032318	775	750	704	96	15	6.4	679
FBgn0032321	781	750	781	31	3	10.333333333333334	750
FBgn0032330	758	750	751	15	6	2.5	743
FBgn0032331	518	505	465	66	6	11	452
FBgn0032335	756	750	739	23	7	3.2857142857142856	733
FBgn0032336	755	750	734	26	6	4.333333333333333	729
FBgn0032337	779	750	756	52	5	10.4	727
FBgn0032338	786	750	771	51	14	3.642857142857143	735
FBgn0032339	761	750	735	37	12	3.0833333333333335	724
FBgn0032341	752	750	752	2	2	1	750
FBgn0032343	790	750	740	90	11	8.181818181818182	700
FBgn0032345	754	750	749	9	3	3	745
FBgn0032346	764	750	763	15	4	3.75	749
FBgn0032348	795	750	773	67	9	7.444444444444445	728
FBgn0032350	770	750	756	34	7	4.857142857142857	736
FBgn0032354	763	750	722	54	8	6.75	709
FBgn0032358	753	750	694	62	8	7.75	691
FBgn0032360	767	750	766	18	3	6	749
FBgn0032363	795	750	756	84	9	9.333333333333334	711
FBgn0032364	796	750	774	68	8	8.5	728
FBgn0032368	753	750	742	14	5	2.8	739
FBgn0032369	750	750	746	4	2	2	746
FBgn0032370	752	750	748	6	3	2	746
FBgn0032371	762	750	761	13	3	4.333333333333333	749
FBgn0032372	758	750	748	18	4	4.5	740
FBgn0032373	754	750	699	59	6	9.833333333333334	695
FBgn0032374	796	750	752	90	6	15	706
FBgn0032377	788	750	788	38	3	12.666666666666666	750
FBgn0032378	769	750	766	22	7	3.142857142857143	747
FBgn0032381	768	750	749	37	6	6.166666666666667	731
FBgn0032382	764	750	584	194	6	32.333333333333336	570
FBgn0032385	752	750	752	2	1	2	750
FBgn0032387	792	750	785	49	5	9.8	743
FBgn0032388	789	750	776	52	6	8.666666666666666	737
FBgn0032390	751	750	737	15	3	5	736
FBgn0032394	807	750	603	261	11	23.727272727272727	546
FBgn0032395	779	750	744	64	9	7.111111111111111	715
FBgn0032399	565	565	559	6	1	6	559
FBgn0032400	768	750	764	22	5	4.4	746
FBgn0032401	766	750	721	61	11	5.545454545454546	705
FBgn0032402	766	750	736	46	11	4.181818181818182	720
FBgn0032404	755	750	745	15	5	3	740
FBgn0032406	812	750	794	80	8	10	732
FBgn0032407	832	750	802	112	11	10.181818181818182	720
FBgn0032408	751	750	750	2	2	1	749
FBgn0032414	764	750	755	23	7	3.2857142857142856	741
FBgn0032416	779	750	768	40	8	5	739
FBgn0032419	750	750	735	15	7	2.142857142857143	735
FBgn0032420	766	750	597	185	8	23.125	581
FBgn0032421	750	750	377	373	2	186.5	377
FBgn0032422	750	750	682	68	8	8.5	682
FBgn0032428	787	750	751	73	8	9.125	714
FBgn0032429	750	750	458	292	3	97.33333333333333	458
FBgn0032430	751	750	571	181	4	45.25	570
FBgn0032431	775	750	758	42	7	6	733
FBgn0032434	777	750	736	68	10	6.8	709
FBgn0032435	773	750	743	53	7	7.571428571428571	720
FBgn0032436	771	750	651	141	9	15.666666666666666	630
FBgn0032437	762	750	373	401	5	80.2	361
FBgn0032439	750	750	714	36	4	9	714
FBgn0032442	766	750	762	20	7	2.857142857142857	746
FBgn0032444	771	750	765	27	4	6.75	744
FBgn0032445	753	750	702	54	4	13.5	699
FBgn0032446	752	750	752	2	2	1	750
FBgn0032447	760	750	759	11	2	5.5	749
FBgn0032448	750	750	750	0	0	NA	750
FBgn0032449	775	750	671	129	6	21.5	646
FBgn0032450	774	750	759	39	4	9.75	735
FBgn0032451	774	750	773	25	3	8.333333333333334	749
FBgn0032453	750	750	585	165	5	33	585
FBgn0032456	806	750	758	104	20	5.2	702
FBgn0032457	751	750	740	12	5	2.4	739
FBgn0032462	768	750	734	52	10	5.2	716
FBgn0032464	745	716	739	35	8	4.375	710
FBgn0032465	753	750	719	37	2	18.5	716
FBgn0032470	750	750	737	13	3	4.333333333333333	737
FBgn0032471	750	750	634	116	2	58	634
FBgn0032474	750	750	747	3	1	3	747
FBgn0032475	771	750	771	21	2	10.5	750
FBgn0032479	751	750	747	5	4	1.25	746
FBgn0032480	751	750	737	15	8	1.875	736
FBgn0032481	786	750	713	109	10	10.9	677
FBgn0032482	785	750	736	84	9	9.333333333333334	701
FBgn0032485	767	750	767	17	1	17	750
FBgn0032486	754	750	736	22	5	4.4	732
FBgn0032487	751	750	737	15	3	5	736
FBgn0032488	750	750	736	14	2	7	736
FBgn0032489	750	750	590	160	3	53.333333333333336	590
FBgn0032490	753	750	738	18	6	3	735
FBgn0032491	756	750	733	29	6	4.833333333333333	727
FBgn0032492	758	750	639	127	9	14.11111111111111	631
FBgn0032493	753	750	739	17	4	4.25	736
FBgn0032494	777	750	777	27	4	6.75	750
FBgn0032495	808	750	793	73	8	9.125	735
FBgn0032503	755	750	749	11	5	2.2	744
FBgn0032505	763	750	710	66	9	7.333333333333333	697
FBgn0032506	809	750	798	70	18	3.888888888888889	739
FBgn0032507	797	750	774	70	7	10	727
FBgn0032509	760	750	745	25	7	3.5714285714285716	735
FBgn0032512	753	750	738	18	5	3.6	735
FBgn0032513	763	750	754	22	4	5.5	741
FBgn0032514	754	750	710	48	6	8	706
FBgn0032516	753	750	740	16	5	3.2	737
FBgn0032517	751	750	749	3	2	1.5	748
FBgn0032521	817	750	787	97	8	12.125	720
FBgn0032522	767	750	743	41	8	5.125	726
FBgn0032523	759	750	758	10	2	5	749
FBgn0032524	759	750	723	45	9	5	714
FBgn0032533	756	750	409	353	7	50.42857142857143	403
FBgn0032536	786	750	750	72	9	8	714
FBgn0032538	757	750	676	88	8	11	669
FBgn0032549	780	750	770	40	7	5.714285714285714	740
FBgn0032553	772	750	761	33	6	5.5	739
FBgn0032554	756	750	736	26	6	4.333333333333333	730
FBgn0032563	778	750	764	42	4	10.5	736
FBgn0032577	760	750	738	32	7	4.571428571428571	728
FBgn0032585	808	750	746	120	7	17.142857142857142	688
FBgn0032586	750	750	241	509	1	509	241
FBgn0032587	781	750	777	35	6	5.833333333333333	746
FBgn0032588	750	750	735	15	3	5	735
FBgn0032593	761	750	758	14	4	3.5	747
FBgn0032596	752	750	715	39	7	5.571428571428571	713
FBgn0032597	752	750	708	46	9	5.111111111111111	706
FBgn0032598	754	750	735	23	4	5.75	731
FBgn0032600	789	750	778	50	7	7.142857142857143	739
FBgn0032601	769	750	764	24	4	6	745
FBgn0032602	769	750	755	33	6	5.5	736
FBgn0032603	772	750	736	58	8	7.25	714
FBgn0032612	751	750	688	64	7	9.142857142857142	687
FBgn0032615	767	750	750	34	9	3.7777777777777777	733
FBgn0032624	758	750	668	98	7	14	660
FBgn0032625	767	750	740	44	7	6.285714285714286	723
FBgn0032626	750	750	741	9	4	2.25	741
FBgn0032629	789	750	771	57	10	5.7	732
FBgn0032631	784	750	773	45	8	5.625	739
FBgn0032632	752	750	739	15	7	2.142857142857143	737
FBgn0032633	783	750	756	60	10	6	723
FBgn0032634	758	750	753	13	6	2.1666666666666665	745
FBgn0032635	757	750	753	11	4	2.75	746
FBgn0032636	752	750	508	246	4	61.5	506
FBgn0032637	561	539	379	204	10	20.4	357
FBgn0032638	765	750	412	368	13	28.307692307692307	397
FBgn0032640	780	750	675	135	17	7.9411764705882355	645
FBgn0032642	764	750	764	14	2	7	750
FBgn0032643	786	750	777	45	7	6.428571428571429	741
FBgn0032644	753	750	717	39	3	13	714
FBgn0032645	639	577	623	78	9	8.666666666666666	561
FBgn0032646	765	750	761	19	2	9.5	746
FBgn0032647	750	750	745	5	1	5	745
FBgn0032649	758	750	636	130	8	16.25	628
FBgn0032651	751	750	727	25	4	6.25	726
FBgn0032652	765	750	745	35	3	11.666666666666666	730
FBgn0032654	770	750	757	33	7	4.714285714285714	737
FBgn0032656	829	750	771	137	11	12.454545454545455	692
FBgn0032658	788	750	781	45	7	6.428571428571429	743
FBgn0032664	751	750	748	4	3	1.3333333333333333	747
FBgn0032666	767	750	752	32	7	4.571428571428571	735
FBgn0032668	847	750	796	148	10	14.8	699
FBgn0032677	761	750	721	51	7	7.285714285714286	710
FBgn0032680	777	750	771	33	3	11	744
FBgn0032681	786	750	770	52	8	6.5	734
FBgn0032682	780	750	764	46	7	6.571428571428571	734
FBgn0032683	757	750	707	57	7	8.142857142857142	700
FBgn0032684	751	750	709	43	6	7.166666666666667	708
FBgn0032685	752	750	747	7	4	1.75	745
FBgn0032688	766	750	752	30	5	6	736
FBgn0032689	766	750	758	24	10	2.4	742
FBgn0032691	771	750	451	341	7	48.714285714285715	430
FBgn0032692	794	750	772	66	10	6.6	728
FBgn0032693	754	750	749	9	4	2.25	745
FBgn0032699	750	750	732	18	4	4.5	732
FBgn0032700	757	750	749	15	6	2.5	742
FBgn0032701	756	750	756	6	3	2	750
FBgn0032702	769	750	743	45	13	3.4615384615384617	724
FBgn0032703	762	750	730	44	12	3.6666666666666665	718
FBgn0032704	769	750	736	52	6	8.666666666666666	717
FBgn0032705	773	750	769	27	4	6.75	746
FBgn0032706	810	750	796	74	8	9.25	736
FBgn0032707	757	750	749	15	4	3.75	742
FBgn0032709	759	750	715	53	8	6.625	706
FBgn0032713	792	750	750	84	15	5.6	708
FBgn0032719	768	750	715	71	14	5.071428571428571	697
FBgn0032723	758	750	748	18	5	3.6	740
FBgn0032724	770	750	768	22	6	3.6666666666666665	748
FBgn0032726	783	750	737	79	9	8.777777777777779	704
FBgn0032727	767	750	757	27	6	4.5	740
FBgn0032728	771	750	763	29	4	7.25	742
FBgn0032729	751	750	728	24	3	8	727
FBgn0032730	755	750	738	22	3	7.333333333333333	733
FBgn0032731	776	750	770	32	5	6.4	744
FBgn0032732	775	750	759	41	7	5.857142857142857	734
FBgn0032733	759	750	758	10	2	5	749
FBgn0032734	750	750	749	1	1	1	749
FBgn0032741	752	750	747	7	3	2.3333333333333335	745
FBgn0032744	760	750	754	16	5	3.2	744
FBgn0032746	750	750	696	54	7	7.714285714285714	696
FBgn0032749	771	750	699	93	9	10.333333333333334	678
FBgn0032752	757	750	700	64	6	10.666666666666666	693
FBgn0032754	757	750	749	15	5	3	742
FBgn0032763	550	550	110	440	2	220	110
FBgn0032769	751	750	557	195	3	65	556
FBgn0032771	761	750	752	20	6	3.3333333333333335	741
FBgn0032772	755	750	750	10	5	2	745
FBgn0032774	622	593	601	50	8	6.25	572
FBgn0032781	512	512	480	32	6	5.333333333333333	480
FBgn0032783	596	576	596	20	2	10	576
FBgn0032785	752	750	705	49	12	4.083333333333333	703
FBgn0032787	752	750	751	3	2	1.5	749
FBgn0032788	752	750	751	3	2	1.5	749
FBgn0032789	773	750	681	115	9	12.777777777777779	658
FBgn0032790	782	750	754	60	6	10	722
FBgn0032791	753	750	726	30	3	10	723
FBgn0032793	759	750	756	12	3	4	747
FBgn0032797	767	750	722	62	10	6.2	705
FBgn0032799	761	750	744	28	8	3.5	733
FBgn0032800	761	750	741	31	9	3.4444444444444446	730
FBgn0032801	774	750	713	85	15	5.666666666666667	689
FBgn0032804	757	750	726	38	4	9.5	719
FBgn0032805	778	750	769	37	6	6.166666666666667	741
FBgn0032809	768	750	694	92	4	23	676
FBgn0032811	753	750	745	11	5	2.2	742
FBgn0032812	566	551	552	29	9	3.2222222222222223	537
FBgn0032815	751	750	751	1	1	1	750
FBgn0032816	750	750	566	184	2	92	566
FBgn0032818	756	750	753	9	2	4.5	747
FBgn0032819	750	750	747	3	1	3	747
FBgn0032820	767	750	753	31	8	3.875	736
FBgn0032821	784	750	770	48	8	6	736
FBgn0032822	750	750	734	16	5	3.2	734
FBgn0032827	752	750	743	11	7	1.5714285714285714	741
FBgn0032833	750	750	700	50	4	12.5	700
FBgn0032834	753	750	751	5	2	2.5	748
FBgn0032835	752	750	747	7	4	1.75	745
FBgn0032840	763	750	732	44	9	4.888888888888889	719
FBgn0032843	750	750	735	15	4	3.75	735
FBgn0032845	752	750	696	58	5	11.6	694
FBgn0032846	750	750	711	39	6	6.5	711
FBgn0032847	757	750	736	28	6	4.666666666666667	729
FBgn0032848	750	750	746	4	1	4	746
FBgn0032849	750	750	723	27	5	5.4	723
FBgn0032850	772	750	747	47	7	6.714285714285714	725
FBgn0032851	811	750	453	419	9	46.55555555555556	392
FBgn0032853	776	750	748	54	8	6.75	722
FBgn0032856	750	750	694	56	5	11.2	694
FBgn0032858	763	750	679	97	5	19.4	666
FBgn0032860	776	750	770	32	6	5.333333333333333	744
FBgn0032867	771	750	736	56	7	8	715
FBgn0032868	750	750	180	570	3	190	180
FBgn0032870	750	750	747	3	2	1.5	747
FBgn0032873	752	750	739	15	5	3	737
FBgn0032876	754	750	739	19	6	3.1666666666666665	735
FBgn0032877	754	750	745	13	5	2.6	741
FBgn0032878	767	750	714	70	8	8.75	697
FBgn0032879	718	717	714	5	3	1.6666666666666667	713
FBgn0032881	774	750	754	44	6	7.333333333333333	730
FBgn0032882	787	750	773	51	8	6.375	736
FBgn0032883	753	750	713	43	4	10.75	710
FBgn0032884	764	750	763	15	3	5	749
FBgn0032888	808	750	777	89	10	8.9	719
FBgn0032889	772	750	745	49	7	7	723
FBgn0032894	532	516	492	56	4	14	476
FBgn0032895	782	750	735	79	13	6.076923076923077	703
FBgn0032896	762	750	743	31	7	4.428571428571429	731
FBgn0032897	762	750	740	34	8	4.25	728
FBgn0032898	750	750	185	565	2	282.5	185
FBgn0032900	519	516	499	23	3	7.666666666666667	496
FBgn0032908	763	750	690	86	7	12.285714285714286	677
FBgn0032911	765	750	737	43	5	8.6	722
FBgn0032913	807	750	755	109	10	10.9	698
FBgn0032916	752	750	715	39	7	5.571428571428571	713
FBgn0032921	754	750	743	15	3	5	739
FBgn0032922	775	750	738	62	7	8.857142857142858	713
FBgn0032923	750	750	682	68	6	11.333333333333334	682
FBgn0032935	829	750	780	128	18	7.111111111111111	701
FBgn0032940	767	750	679	105	13	8.076923076923077	662
FBgn0032943	750	750	73	677	3	225.66666666666666	73
FBgn0032946	806	750	645	217	15	14.466666666666667	589
FBgn0032957	759	750	707	61	15	4.066666666666666	698
FBgn0032961	758	750	461	305	7	43.57142857142857	453
FBgn0032965	767	750	703	81	13	6.230769230769231	686
FBgn0032967	778	750	744	62	8	7.75	716
FBgn0032968	750	750	731	19	6	3.1666666666666665	731
FBgn0032969	777	750	683	121	15	8.066666666666666	656
FBgn0032971	792	750	727	107	12	8.916666666666666	685
FBgn0032973	769	750	637	151	17	8.882352941176471	618
FBgn0032981	757	750	310	454	3	151.33333333333334	303
FBgn0032988	778	750	371	435	10	43.5	343
FBgn0033010	750	750	148	602	1	602	148
FBgn0033033	753	750	737	19	5	3.8	734
FBgn0033038	762	750	413	361	4	90.25	401
FBgn0033043	752	750	748	6	4	1.5	746
FBgn0033047	750	750	312	438	7	62.57142857142857	312
FBgn0033048	584	540	540	88	6	14.666666666666666	496
FBgn0033051	847	750	727	217	16	13.5625	630
FBgn0033052	657	641	651	22	7	3.142857142857143	635
FBgn0033054	772	750	720	74	12	6.166666666666667	698
FBgn0033055	801	750	685	167	12	13.916666666666666	634
FBgn0033056	753	750	715	41	7	5.857142857142857	712
FBgn0033058	754	750	739	19	3	6.333333333333333	735
FBgn0033060	751	750	290	462	3	154	289
FBgn0033061	754	750	747	11	4	2.75	743
FBgn0033063	775	750	750	50	9	5.555555555555555	725
FBgn0033067	752	750	751	3	3	1	749
FBgn0033072	629	625	567	66	7	9.428571428571429	563
FBgn0033076	750	750	731	19	3	6.333333333333333	731
FBgn0033079	754	750	728	30	5	6	724
FBgn0033081	793	750	506	330	6	55	463
FBgn0033085	753	750	752	4	3	1.3333333333333333	749
FBgn0033087	758	750	757	9	4	2.25	749
FBgn0033088	765	750	755	25	8	3.125	740
FBgn0033093	765	750	670	110	7	15.714285714285714	655
FBgn0033096	751	750	294	458	2	229	293
FBgn0033097	757	750	740	24	5	4.8	733
FBgn0033100	626	626	616	10	3	3.3333333333333335	616
FBgn0033101	766	750	362	420	6	70	346
FBgn0033108	775	750	748	52	6	8.666666666666666	723
FBgn0033112	764	750	739	39	6	6.5	725
FBgn0033113	778	750	778	28	2	14	750
FBgn0033128	751	750	678	74	10	7.4	677
FBgn0033129	681	671	675	16	3	5.333333333333333	665
FBgn0033134	794	750	769	69	7	9.857142857142858	725
FBgn0033135	757	750	754	10	6	1.6666666666666667	747
FBgn0033136	789	750	770	58	10	5.8	731
FBgn0033137	610	609	587	24	4	6	586
FBgn0033138	764	750	736	42	9	4.666666666666667	722
FBgn0033139	764	750	736	42	9	4.666666666666667	722
FBgn0033140	754	750	751	7	2	3.5	747
FBgn0033141	782	750	766	48	6	8	734
FBgn0033145	801	750	794	58	6	9.666666666666666	743
FBgn0033153	785	750	773	47	4	11.75	738
FBgn0033154	766	750	761	21	5	4.2	745
FBgn0033155	750	750	749	1	1	1	749
FBgn0033158	770	750	748	42	3	14	728
FBgn0033159	750	750	686	64	6	10.666666666666666	686
FBgn0033160	754	750	747	11	3	3.6666666666666665	743
FBgn0033166	755	750	489	271	8	33.875	484
FBgn0033167	766	750	714	68	7	9.714285714285714	698
FBgn0033168	772	750	765	29	6	4.833333333333333	743
FBgn0033169	754	750	389	369	3	123	385
FBgn0033174	784	750	720	98	11	8.909090909090908	686
FBgn0033177	751	750	751	1	1	1	750
FBgn0033178	751	750	729	23	6	3.8333333333333335	728
FBgn0033179	547	536	537	21	4	5.25	526
FBgn0033186	764	750	754	24	8	3	740
FBgn0033187	764	750	746	32	11	2.909090909090909	732
FBgn0033191	760	750	739	31	4	7.75	729
FBgn0033192	760	750	736	34	4	8.5	726
FBgn0033194	750	750	750	0	0	NA	750
FBgn0033195	756	750	755	7	2	3.5	749
FBgn0033196	764	750	735	43	8	5.375	721
FBgn0033199	750	750	750	0	0	NA	750
FBgn0033204	602	598	243	363	5	72.6	239
FBgn0033205	760	703	702	115	13	8.846153846153847	645
FBgn0033207	752	750	741	13	3	4.333333333333333	739
FBgn0033208	750	750	743	7	2	3.5	743
FBgn0033209	753	750	753	3	1	3	750
FBgn0033210	761	750	750	22	4	5.5	739
FBgn0033212	763	750	753	23	4	5.75	740
FBgn0033214	793	750	769	67	8	8.375	726
FBgn0033215	682	677	629	58	8	7.25	624
FBgn0033216	751	750	726	26	5	5.2	725
FBgn0033221	759	750	729	39	6	6.5	720
FBgn0033224	755	750	743	17	6	2.8333333333333335	738
FBgn0033225	792	750	783	51	10	5.1	741
FBgn0033226	804	750	795	63	11	5.7272727272727275	741
FBgn0033232	790	750	763	67	11	6.090909090909091	723
FBgn0033234	759	750	722	46	6	7.666666666666667	713
FBgn0033236	790	750	723	107	13	8.23076923076923	683
FBgn0033240	770	750	757	33	8	4.125	737
FBgn0033243	751	750	742	10	4	2.5	741
FBgn0033244	815	750	740	140	11	12.727272727272727	675
FBgn0033247	757	750	733	31	6	5.166666666666667	726
FBgn0033248	705	692	680	38	7	5.428571428571429	667
FBgn0033249	768	750	735	51	7	7.285714285714286	717
FBgn0033250	786	750	714	108	10	10.8	678
FBgn0033252	765	750	742	38	7	5.428571428571429	727
FBgn0033257	605	506	593	111	6	18.5	494
FBgn0033258	764	750	751	27	9	3	737
FBgn0033259	753	750	729	27	6	4.5	726
FBgn0033261	750	750	748	2	1	2	748
FBgn0033264	756	750	756	6	1	6	750
FBgn0033265	753	750	746	10	3	3.3333333333333335	743
FBgn0033266	760	750	759	11	3	3.6666666666666665	749
FBgn0033268	809	750	716	152	17	8.941176470588236	657
FBgn0033275	752	750	739	15	4	3.75	737
FBgn0033277	757	750	697	67	5	13.4	690
FBgn0033279	753	750	712	44	8	5.5	709
FBgn0033285	752	750	712	42	6	7	710
FBgn0033289	750	750	730	20	2	10	730
FBgn0033292	772	750	612	182	9	20.22222222222222	590
FBgn0033294	753	750	738	18	5	3.6	735
FBgn0033297	750	750	742	8	1	8	742
FBgn0033301	750	750	335	415	4	103.75	335
FBgn0033302	758	750	740	26	6	4.333333333333333	732
FBgn0033303	775	750	623	177	15	11.8	598
FBgn0033307	750	750	743	7	2	3.5	743
FBgn0033308	762	750	752	22	3	7.333333333333333	740
FBgn0033309	782	750	415	399	3	133	383
FBgn0033312	758	750	702	64	9	7.111111111111111	694
FBgn0033313	758	750	700	66	9	7.333333333333333	692
FBgn0033315	772	750	697	97	6	16.166666666666668	675
FBgn0033317	806	750	767	95	12	7.916666666666667	711
FBgn0033323	750	750	739	11	1	11	739
FBgn0033327	772	750	757	37	5	7.4	735
FBgn0033330	750	750	747	3	2	1.5	747
FBgn0033337	797	750	764	80	12	6.666666666666667	717
FBgn0033340	753	750	753	3	1	3	750
FBgn0033341	755	750	735	25	7	3.5714285714285716	730
FBgn0033344	751	750	749	3	2	1.5	748
FBgn0033348	750	750	750	0	0	NA	750
FBgn0033349	750	750	740	10	1	10	740
FBgn0033350	757	750	754	10	4	2.5	747
FBgn0033351	751	750	751	1	1	1	750
FBgn0033352	750	750	740	10	2	5	740
FBgn0033353	524	513	516	19	5	3.8	505
FBgn0033357	763	750	755	21	5	4.2	742
FBgn0033358	790	750	729	101	9	11.222222222222221	689
FBgn0033362	756	750	742	20	4	5	736
FBgn0033363	763	750	755	21	4	5.25	742
FBgn0033364	763	750	755	21	4	5.25	742
FBgn0033365	822	750	798	96	12	8	726
FBgn0033367	750	750	744	6	2	3	744
FBgn0033372	750	750	750	0	0	NA	750
FBgn0033376	750	750	750	0	0	NA	750
FBgn0033379	765	750	762	18	5	3.6	747
FBgn0033380	765	750	765	15	4	3.75	750
FBgn0033382	759	750	737	31	11	2.8181818181818183	728
FBgn0033387	752	750	722	32	4	8	720
FBgn0033388	757	750	730	34	6	5.666666666666667	723
FBgn0033389	757	750	727	37	7	5.285714285714286	720
FBgn0033392	755	750	744	16	4	4	739
FBgn0033395	781	750	731	81	13	6.230769230769231	700
FBgn0033400	750	750	636	114	1	114	636
FBgn0033401	807	750	764	100	7	14.285714285714286	707
FBgn0033402	757	750	750	14	5	2.8	743
FBgn0033404	781	750	774	38	9	4.222222222222222	743
FBgn0033405	753	750	371	385	7	55	368
FBgn0033412	750	750	731	19	5	3.8	731
FBgn0033413	750	750	729	21	6	3.5	729
FBgn0033421	750	750	738	12	5	2.4	738
FBgn0033422	764	750	739	39	7	5.571428571428571	725
FBgn0033423	583	569	575	22	7	3.142857142857143	561
FBgn0033427	750	750	733	17	2	8.5	733
FBgn0033428	793	750	788	48	6	8	745
FBgn0033431	753	750	752	4	3	1.3333333333333333	749
FBgn0033437	758	750	710	56	3	18.666666666666668	702
FBgn0033438	812	750	595	279	11	25.363636363636363	533
FBgn0033442	753	750	489	267	9	29.666666666666668	486
FBgn0033443	776	750	745	57	10	5.7	719
FBgn0033446	757	750	750	14	5	2.8	743
FBgn0033447	766	750	738	44	7	6.285714285714286	722
FBgn0033448	750	750	747	3	1	3	747
FBgn0033449	750	750	740	10	3	3.3333333333333335	740
FBgn0033450	779	750	770	38	4	9.5	741
FBgn0033451	779	750	770	38	4	9.5	741
FBgn0033453	758	750	751	15	6	2.5	743
FBgn0033454	762	750	762	12	3	4	750
FBgn0033457	750	750	746	4	3	1.3333333333333333	746
FBgn0033460	771	750	767	25	7	3.5714285714285716	746
FBgn0033461	750	750	747	3	1	3	747
FBgn0033463	805	750	776	84	8	10.5	721
FBgn0033464	789	750	772	56	9	6.222222222222222	733
FBgn0033467	754	750	744	14	6	2.3333333333333335	740
FBgn0033468	757	750	199	565	5	113	192
FBgn0033469	790	750	773	57	8	7.125	733
FBgn0033471	607	606	574	34	5	6.8	573
FBgn0033474	751	750	726	26	6	4.333333333333333	725
FBgn0033475	752	750	735	19	5	3.8	733
FBgn0033476	821	750	436	456	12	38	365
FBgn0033479	764	721	744	63	9	7	701
FBgn0033480	770	750	730	60	5	12	710
FBgn0033481	752	750	752	2	1	2	750
FBgn0033482	793	750	785	51	10	5.1	742
FBgn0033483	761	750	719	53	6	8.833333333333334	708
FBgn0033484	759	750	741	27	7	3.857142857142857	732
FBgn0033485	760	750	729	41	5	8.2	719
FBgn0033486	751	750	751	1	1	1	750
FBgn0033490	750	750	747	3	2	1.5	747
FBgn0033494	750	750	722	28	4	7	722
FBgn0033498	762	750	711	63	5	12.6	699
FBgn0033499	785	750	767	53	7	7.571428571428571	732
FBgn0033501	768	750	742	44	8	5.5	724
FBgn0033502	773	750	750	46	8	5.75	727
FBgn0033507	751	750	534	218	3	72.66666666666667	533
FBgn0033508	788	750	787	39	3	13	749
FBgn0033523	784	750	739	79	11	7.181818181818182	705
FBgn0033524	823	750	813	83	10	8.3	740
FBgn0033526	754	750	746	12	4	3	742
FBgn0033527	750	750	750	0	0	NA	750
FBgn0033528	750	750	734	16	2	8	734
FBgn0033529	755	750	752	8	2	4	747
FBgn0033538	759	750	737	31	7	4.428571428571429	728
FBgn0033539	755	750	743	17	4	4.25	738
FBgn0033540	755	750	753	7	4	1.75	748
FBgn0033542	759	750	723	45	5	9	714
FBgn0033543	750	750	738	12	5	2.4	738
FBgn0033544	754	750	749	9	6	1.5	745
FBgn0033547	760	750	749	21	8	2.625	739
FBgn0033548	750	750	725	25	3	8.333333333333334	725
FBgn0033549	534	534	474	60	3	20	474
FBgn0033550	752	750	745	9	5	1.8	743
FBgn0033551	754	750	753	5	2	2.5	749
FBgn0033555	693	692	666	28	4	7	665
FBgn0033556	753	750	751	5	4	1.25	748
FBgn0033557	750	750	750	0	0	NA	750
FBgn0033558	763	750	744	32	8	4	731
FBgn0033564	751	750	742	10	3	3.3333333333333335	741
FBgn0033569	771	750	751	41	10	4.1	730
FBgn0033571	840	750	708	222	16	13.875	618
FBgn0033572	751	750	739	13	4	3.25	738
FBgn0033574	762	750	745	29	9	3.2222222222222223	733
FBgn0033578	752	750	740	14	7	2	738
FBgn0033579	768	750	742	44	11	4	724
FBgn0033580	803	750	759	97	15	6.466666666666667	706
FBgn0033582	752	750	751	3	2	1.5	749
FBgn0033584	763	750	743	33	7	4.714285714285714	730
FBgn0033587	753	750	751	5	2	2.5	748
FBgn0033588	750	750	750	0	0	NA	750
FBgn0033589	776	750	760	42	5	8.4	734
FBgn0033590	574	573	552	23	2	11.5	551
FBgn0033591	700	672	649	79	4	19.75	621
FBgn0033592	750	750	700	50	5	10	700
FBgn0033593	784	750	765	53	8	6.625	731
FBgn0033594	758	750	706	60	6	10	698
FBgn0033597	757	750	744	20	3	6.666666666666667	737
FBgn0033598	778	750	765	41	9	4.555555555555555	737
FBgn0033599	617	617	498	119	2	59.5	498
FBgn0033600	754	750	735	23	5	4.6	731
FBgn0033601	754	750	751	7	4	1.75	747
FBgn0033602	750	750	743	7	1	7	743
FBgn0033603	750	750	747	3	1	3	747
FBgn0033605	750	750	750	0	0	NA	750
FBgn0033607	751	750	741	11	3	3.6666666666666665	740
FBgn0033608	751	750	744	8	2	4	743
FBgn0033614	750	750	746	4	3	1.3333333333333333	746
FBgn0033616	759	750	608	160	7	22.857142857142858	599
FBgn0033623	750	750	750	0	0	NA	750
FBgn0033627	750	750	747	3	1	3	747
FBgn0033628	781	750	748	64	13	4.923076923076923	717
FBgn0033629	752	750	731	23	7	3.2857142857142856	729
FBgn0033631	755	750	721	39	9	4.333333333333333	716
FBgn0033635	774	750	755	43	6	7.166666666666667	731
FBgn0033636	752	750	640	114	5	22.8	638
FBgn0033638	777	750	762	42	6	7	735
FBgn0033639	754	750	744	14	3	4.666666666666667	740
FBgn0033640	763	750	750	26	7	3.7142857142857144	737
FBgn0033645	772	750	767	27	9	3	745
FBgn0033648	754	750	749	9	3	3	745
FBgn0033651	768	750	761	25	7	3.5714285714285716	743
FBgn0033652	767	750	745	39	8	4.875	728
FBgn0033653	755	750	754	6	2	3	749
FBgn0033654	750	750	564	186	3	62	564
FBgn0033658	770	750	765	25	3	8.333333333333334	745
FBgn0033659	757	750	186	578	4	144.5	179
FBgn0033661	783	750	781	35	7	5	748
FBgn0033665	761	750	686	86	5	17.2	675
FBgn0033667	750	750	749	1	1	1	749
FBgn0033668	750	750	737	13	6	2.1666666666666665	737
FBgn0033669	796	750	760	82	8	10.25	714
FBgn0033672	755	750	739	21	6	3.5	734
FBgn0033673	755	750	745	15	5	3	740
FBgn0033677	750	750	743	7	3	2.3333333333333335	743
FBgn0033679	768	750	739	47	9	5.222222222222222	721
FBgn0033680	758	750	736	30	9	3.3333333333333335	728
FBgn0033685	757	750	675	89	10	8.9	668
FBgn0033686	790	750	758	72	15	4.8	718
FBgn0033687	678	665	590	101	6	16.833333333333332	577
FBgn0033688	787	750	778	46	12	3.8333333333333335	741
FBgn0033696	750	750	740	10	3	3.3333333333333335	740
FBgn0033697	750	750	745	5	2	2.5	745
FBgn0033699	776	750	754	48	8	6	728
FBgn0033701	758	750	646	120	8	15	638
FBgn0033702	755	750	739	21	5	4.2	734
FBgn0033703	785	750	766	54	11	4.909090909090909	731
FBgn0033705	773	750	764	32	6	5.333333333333333	741
FBgn0033706	804	750	727	131	10	13.1	673
FBgn0033708	800	750	764	86	12	7.166666666666667	714
FBgn0033710	786	750	767	55	8	6.875	731
FBgn0033713	752	750	744	10	4	2.5	742
FBgn0033717	780	750	774	36	3	12	744
FBgn0033720	762	750	742	32	7	4.571428571428571	730
FBgn0033723	768	750	757	29	7	4.142857142857143	739
FBgn0033724	758	750	738	28	7	4	730
FBgn0033725	807	750	797	67	7	9.571428571428571	740
FBgn0033727	753	750	749	7	5	1.4	746
FBgn0033729	753	750	727	29	5	5.8	724
FBgn0033730	752	750	738	16	4	4	736
FBgn0033732	751	750	745	7	3	2.3333333333333335	744
FBgn0033733	752	750	733	21	5	4.2	731
FBgn0033734	760	750	741	29	5	5.8	731
FBgn0033736	639	639	638	1	1	1	638
FBgn0033737	762	750	720	54	9	6	708
FBgn0033738	758	750	755	11	4	2.75	747
FBgn0033740	750	750	750	0	0	NA	750
FBgn0033741	756	750	745	17	7	2.4285714285714284	739
FBgn0033744	608	607	595	14	3	4.666666666666667	594
FBgn0033749	790	750	785	45	9	5	745
FBgn0033751	756	750	755	7	2	3.5	749
FBgn0033752	762	750	755	19	3	6.333333333333333	743
FBgn0033753	758	750	714	52	9	5.777777777777778	706
FBgn0033757	755	750	751	9	3	3	746
FBgn0033760	780	750	695	115	7	16.428571428571427	665
FBgn0033761	752	750	730	24	6	4	728
FBgn0033762	751	750	735	17	4	4.25	734
FBgn0033766	771	750	748	44	3	14.666666666666666	727
FBgn0033767	753	750	753	3	1	3	750
FBgn0033769	762	750	499	275	8	34.375	487
FBgn0033770	770	750	750	40	12	3.3333333333333335	730
FBgn0033774	765	750	750	30	2	15	735
FBgn0033775	754	750	701	57	7	8.142857142857142	697
FBgn0033781	751	750	750	2	2	1	749
FBgn0033783	706	706	704	2	1	2	704
FBgn0033784	768	750	763	23	5	4.6	745
FBgn0033785	767	750	762	22	4	5.5	745
FBgn0033787	761	750	706	66	14	4.714285714285714	695
FBgn0033788	765	750	715	65	9	7.222222222222222	700
FBgn0033789	756	750	743	19	7	2.7142857142857144	737
FBgn0033791	768	750	728	58	7	8.285714285714286	710
FBgn0033793	565	549	499	82	9	9.11111111111111	483
FBgn0033794	801	750	762	90	11	8.181818181818182	711
FBgn0033806	767	750	755	29	5	5.8	738
FBgn0033807	760	750	756	14	5	2.8	746
FBgn0033810	764	750	714	64	8	8	700
FBgn0033812	756	750	739	23	8	2.875	733
FBgn0033813	756	750	735	27	9	3	729
FBgn0033814	769	750	713	75	16	4.6875	694
FBgn0033815	789	750	734	94	16	5.875	695
FBgn0033816	764	750	749	29	6	4.833333333333333	735
FBgn0033817	752	750	739	15	3	5	737
FBgn0033820	750	750	424	326	3	108.66666666666667	424
FBgn0033821	531	531	238	293	3	97.66666666666667	238
FBgn0033826	824	750	812	86	7	12.285714285714286	738
FBgn0033827	751	750	709	43	2	21.5	708
FBgn0033828	750	750	745	5	3	1.6666666666666667	745
FBgn0033830	797	750	757	87	23	3.782608695652174	710
FBgn0033834	796	750	781	61	9	6.777777777777778	735
FBgn0033842	770	750	770	20	4	5	750
FBgn0033844	772	750	770	24	2	12	748
FBgn0033845	776	750	719	83	13	6.384615384615385	693
FBgn0033846	588	571	585	20	4	5	568
FBgn0033848	755	750	749	11	6	1.8333333333333333	744
FBgn0033850	762	750	712	62	8	7.75	700
FBgn0033851	768	750	692	94	14	6.714285714285714	674
FBgn0033853	753	750	717	39	6	6.5	714
FBgn0033855	663	661	651	14	6	2.3333333333333335	649
FBgn0033856	762	750	716	58	9	6.444444444444445	704
FBgn0033859	755	750	752	8	5	1.6	747
FBgn0033861	756	750	722	40	8	5	716
FBgn0033862	796	750	795	47	4	11.75	749
FBgn0033865	797	750	711	133	9	14.777777777777779	664
FBgn0033866	777	750	748	56	12	4.666666666666667	721
FBgn0033867	761	750	701	71	11	6.454545454545454	690
FBgn0033868	784	750	784	34	5	6.8	750
FBgn0033869	768	750	753	33	6	5.5	735
FBgn0033871	762	750	738	36	8	4.5	726
FBgn0033872	766	750	755	27	10	2.7	739
FBgn0033873	769	750	743	45	7	6.428571428571429	724
FBgn0033874	788	750	766	60	6	10	728
FBgn0033875	791	750	742	90	7	12.857142857142858	701
FBgn0033876	768	750	762	24	4	6	744
FBgn0033880	665	642	657	31	8	3.875	634
FBgn0033883	751	750	747	5	2	2.5	746
FBgn0033884	803	750	800	56	3	18.666666666666668	747
FBgn0033885	751	750	728	24	7	3.4285714285714284	727
FBgn0033886	764	750	763	15	3	5	749
FBgn0033888	807	750	784	80	10	8	727
FBgn0033890	755	750	750	10	4	2.5	745
FBgn0033891	750	750	750	0	0	NA	750
FBgn0033897	750	750	750	0	0	NA	750
FBgn0033899	730	728	712	20	6	3.3333333333333335	710
FBgn0033900	763	750	761	15	3	5	748
FBgn0033901	753	750	736	20	4	5	733
FBgn0033902	750	750	732	18	6	3	732
FBgn0033903	751	750	731	21	8	2.625	730
FBgn0033907	751	750	751	1	1	1	750
FBgn0033912	804	750	605	253	16	15.8125	551
FBgn0033913	758	750	739	27	8	3.375	731
FBgn0033915	751	750	741	11	3	3.6666666666666665	740
FBgn0033916	752	750	742	12	3	4	740
FBgn0033917	519	519	480	39	2	19.5	480
FBgn0033918	839	750	831	97	6	16.166666666666668	742
FBgn0033919	791	750	767	65	6	10.833333333333334	726
FBgn0033921	763	750	496	280	7	40	483
FBgn0033924	765	730	750	50	9	5.555555555555555	715
FBgn0033925	892	750	872	162	11	14.727272727272727	730
FBgn0033927	776	750	776	26	4	6.5	750
FBgn0033931	758	750	757	9	5	1.8	749
FBgn0033932	753	750	749	7	5	1.4	746
FBgn0033933	753	750	738	18	5	3.6	735
FBgn0033936	825	750	791	109	7	15.571428571428571	716
FBgn0033942	754	750	752	6	4	1.5	748
FBgn0033943	765	750	719	61	8	7.625	704
FBgn0033948	764	750	756	22	8	2.75	742
FBgn0033950	750	750	701	49	5	9.8	701
FBgn0033951	771	750	707	85	14	6.071428571428571	686
FBgn0033952	765	750	741	39	8	4.875	726
FBgn0033954	758	750	741	25	7	3.5714285714285716	733
FBgn0033955	751	750	737	15	4	3.75	736
FBgn0033958	763	750	739	37	8	4.625	726
FBgn0033960	750	750	725	25	2	12.5	725
FBgn0033961	750	750	732	18	4	4.5	732
FBgn0033963	753	750	750	6	5	1.2	747
FBgn0033968	772	750	741	53	6	8.833333333333334	719
FBgn0033969	757	750	748	16	5	3.2	741
FBgn0033970	763	750	733	43	9	4.777777777777778	720
FBgn0033972	802	750	756	98	11	8.909090909090908	704
FBgn0033973	802	750	756	98	11	8.909090909090908	704
FBgn0033983	760	750	746	24	7	3.4285714285714284	736
FBgn0033984	760	750	740	30	8	3.75	730
FBgn0033985	790	750	765	65	10	6.5	725
FBgn0033987	750	750	737	13	3	4.333333333333333	737
FBgn0033989	682	662	658	44	7	6.285714285714286	638
FBgn0033990	791	750	757	75	8	9.375	716
FBgn0033993	758	750	757	9	3	3	749
FBgn0033994	750	750	735	15	3	5	735
FBgn0033995	775	750	738	62	9	6.888888888888889	713
FBgn0033996	753	750	743	13	3	4.333333333333333	740
FBgn0033997	547	547	540	7	2	3.5	540
FBgn0033998	704	697	677	34	11	3.090909090909091	670
FBgn0033999	750	750	750	0	0	NA	750
FBgn0034000	750	750	750	0	0	NA	750
FBgn0034008	779	750	764	44	8	5.5	735
FBgn0034009	752	750	666	88	4	22	664
FBgn0034010	757	750	584	180	6	30	577
FBgn0034011	757	750	691	73	9	8.11111111111111	684
FBgn0034012	751	750	750	2	2	1	749
FBgn0034013	807	750	773	91	14	6.5	716
FBgn0034021	774	750	708	90	9	10	684
FBgn0034022	785	750	754	66	5	13.2	719
FBgn0034023	750	750	750	0	0	NA	750
FBgn0034025	804	750	783	75	13	5.769230769230769	729
FBgn0034030	774	750	774	24	2	12	750
FBgn0034032	762	750	612	162	7	23.142857142857142	600
FBgn0034035	689	651	673	54	9	6	635
FBgn0034045	751	750	740	12	7	1.7142857142857142	739
FBgn0034049	696	696	676	20	6	3.3333333333333335	676
FBgn0034050	750	750	744	6	1	6	744
FBgn0034051	629	627	614	17	5	3.4	612
FBgn0034052	750	750	712	38	2	19	712
FBgn0034053	757	750	742	22	5	4.4	735
FBgn0034054	751	750	747	5	3	1.6666666666666667	746
FBgn0034058	750	750	749	1	1	1	749
FBgn0034059	751	750	745	7	2	3.5	744
FBgn0034060	753	750	745	11	6	1.8333333333333333	742
FBgn0034062	750	750	749	1	1	1	749
FBgn0034065	763	750	761	15	5	3	748
FBgn0034066	761	750	635	137	12	11.416666666666666	624
FBgn0034067	763	750	660	116	11	10.545454545454545	647
FBgn0034068	750	750	744	6	1	6	744
FBgn0034069	750	750	739	11	4	2.75	739
FBgn0034072	760	750	758	12	3	4	748
FBgn0034073	751	750	751	1	1	1	750
FBgn0034075	766	750	752	30	7	4.285714285714286	736
FBgn0034076	531	516	528	18	3	6	513
FBgn0034081	764	750	755	23	6	3.8333333333333335	741
FBgn0034082	797	750	734	110	11	10	687
FBgn0034083	757	750	745	19	5	3.8	738
FBgn0034085	752	750	748	6	5	1.2	746
FBgn0034086	750	750	735	15	5	3	735
FBgn0034087	757	750	720	44	9	4.888888888888889	713
FBgn0034092	690	669	674	37	8	4.625	653
FBgn0034093	750	750	750	0	0	NA	750
FBgn0034094	782	750	727	87	13	6.6923076923076925	695
FBgn0034096	769	750	737	51	9	5.666666666666667	718
FBgn0034097	754	750	699	59	9	6.555555555555555	695
FBgn0034099	768	750	746	40	8	5	728
FBgn0034103	791	750	765	67	13	5.153846153846154	724
FBgn0034104	619	601	606	31	8	3.875	588
FBgn0034109	760	750	755	15	5	3	745
FBgn0034110	760	750	756	14	5	2.8	746
FBgn0034114	752	750	750	4	4	1	748
FBgn0034117	754	750	750	8	3	2.6666666666666665	746
FBgn0034118	774	750	764	34	7	4.857142857142857	740
FBgn0034121	755	750	752	8	6	1.3333333333333333	747
FBgn0034122	755	750	737	23	3	7.666666666666667	732
FBgn0034126	758	750	752	14	5	2.8	744
FBgn0034127	759	750	723	45	7	6.428571428571429	714
FBgn0034128	819	750	811	77	9	8.555555555555555	742
FBgn0034129	761	750	745	27	9	3	734
FBgn0034131	758	750	736	30	10	3	728
FBgn0034132	765	750	688	92	7	13.142857142857142	673
FBgn0034135	760	750	747	23	7	3.2857142857142856	737
FBgn0034136	804	750	800	58	6	9.666666666666666	746
FBgn0034137	804	750	798	60	7	8.571428571428571	744
FBgn0034138	791	750	671	161	13	12.384615384615385	630
FBgn0034139	765	750	628	152	16	9.5	613
FBgn0034143	778	750	749	57	7	8.142857142857142	721
FBgn0034144	755	750	749	11	5	2.2	744
FBgn0034151	777	750	777	27	3	9	750
FBgn0034156	769	750	728	60	10	6	709
FBgn0034157	769	750	764	24	6	4	745
FBgn0034158	827	750	791	113	14	8.071428571428571	714
FBgn0034159	752	750	746	8	3	2.6666666666666665	744
FBgn0034160	780	750	756	54	11	4.909090909090909	726
FBgn0034166	756	750	755	7	3	2.3333333333333335	749
FBgn0034168	767	750	765	19	4	4.75	748
FBgn0034173	804	750	790	68	6	11.333333333333334	736
FBgn0034176	750	750	747	3	1	3	747
FBgn0034177	750	750	750	0	0	NA	750
FBgn0034179	797	750	784	60	7	8.571428571428571	737
FBgn0034180	791	750	778	54	10	5.4	737
FBgn0034181	780	750	408	402	7	57.42857142857143	378
FBgn0034186	765	750	730	50	8	6.25	715
FBgn0034187	752	750	751	3	3	1	749
FBgn0034191	750	750	725	25	3	8.333333333333334	725
FBgn0034194	766	750	760	22	6	3.6666666666666665	744
FBgn0034196	779	750	742	66	7	9.428571428571429	713
FBgn0034197	750	750	750	0	0	NA	750
FBgn0034201	752	750	734	20	7	2.857142857142857	732
FBgn0034204	751	750	742	10	3	3.3333333333333335	741
FBgn0034205	760	750	739	31	7	4.428571428571429	729
FBgn0034206	549	507	533	58	7	8.285714285714286	491
FBgn0034210	768	750	742	44	7	6.285714285714286	724
FBgn0034214	769	750	764	24	5	4.8	745
FBgn0034215	769	750	766	22	4	5.5	747
FBgn0034217	758	750	744	22	7	3.142857142857143	736
FBgn0034223	766	750	754	28	6	4.666666666666667	738
FBgn0034224	785	750	719	101	12	8.416666666666666	684
FBgn0034225	770	750	709	81	13	6.230769230769231	689
FBgn0034231	758	750	757	9	3	3	749
FBgn0034232	750	750	750	0	0	NA	750
FBgn0034237	752	750	734	20	4	5	732
FBgn0034240	762	750	760	14	3	4.666666666666667	748
FBgn0034243	750	750	746	4	1	4	746
FBgn0034245	750	750	735	15	5	3	735
FBgn0034246	660	604	629	87	10	8.7	573
FBgn0034247	753	750	695	61	9	6.777777777777778	692
FBgn0034249	751	750	732	20	3	6.666666666666667	731
FBgn0034253	771	750	720	72	9	8	699
FBgn0034258	753	750	745	11	6	1.8333333333333333	742
FBgn0034259	802	750	801	53	4	13.25	749
FBgn0034261	750	750	724	26	2	13	724
FBgn0034262	778	750	770	36	6	6	742
FBgn0034263	759	750	738	30	8	3.75	729
FBgn0034265	750	750	748	2	1	2	748
FBgn0034269	695	648	441	301	8	37.625	394
FBgn0034270	754	750	729	29	2	14.5	725
FBgn0034271	754	750	728	30	3	10	724
FBgn0034272	667	655	649	30	5	6	637
FBgn0034274	801	750	774	78	9	8.666666666666666	723
FBgn0034276	787	750	753	71	6	11.833333333333334	716
FBgn0034281	791	750	726	106	13	8.153846153846153	685
FBgn0034282	750	750	749	1	1	1	749
FBgn0034283	788	750	782	44	5	8.8	744
FBgn0034286	765	750	745	35	7	5	730
FBgn0034288	759	750	739	29	6	4.833333333333333	730
FBgn0034289	541	505	541	36	3	12	505
FBgn0034290	564	542	523	63	12	5.25	501
FBgn0034292	752	750	743	11	4	2.75	741
FBgn0034294	553	523	537	46	6	7.666666666666667	507
FBgn0034295	751	750	743	9	4	2.25	742
FBgn0034296	766	750	742	40	5	8	726
FBgn0034299	750	750	748	2	2	1	748
FBgn0034300	750	750	748	2	2	1	748
FBgn0034301	765	750	752	28	9	3.111111111111111	737
FBgn0034304	788	750	782	44	6	7.333333333333333	744
FBgn0034307	750	750	749	1	1	1	749
FBgn0034308	550	549	538	13	5	2.6	537
FBgn0034310	751	750	751	1	1	1	750
FBgn0034315	721	695	708	39	8	4.875	682
FBgn0034317	759	750	698	70	6	11.666666666666666	689
FBgn0034321	762	750	714	60	8	7.5	702
FBgn0034331	797	750	756	88	15	5.866666666666666	709
FBgn0034335	810	750	798	72	13	5.538461538461538	738
FBgn0034345	758	750	758	8	4	2	750
FBgn0034346	783	750	776	40	5	8	743
FBgn0034351	753	750	611	145	4	36.25	608
FBgn0034352	774	750	757	41	14	2.9285714285714284	733
FBgn0034354	756	750	671	91	10	9.1	665
FBgn0034356	762	750	754	20	6	3.3333333333333335	742
FBgn0034360	770	750	744	46	4	11.5	724
FBgn0034361	754	750	725	33	5	6.6	721
FBgn0034362	750	750	750	0	0	NA	750
FBgn0034364	752	750	733	21	4	5.25	731
FBgn0034365	762	750	740	34	5	6.8	728
FBgn0034366	750	750	689	61	3	20.333333333333332	689
FBgn0034368	760	750	713	57	7	8.142857142857142	703
FBgn0034379	753	750	734	22	6	3.6666666666666665	731
FBgn0034380	847	750	840	104	15	6.933333333333334	743
FBgn0034381	751	750	747	5	3	1.6666666666666667	746
FBgn0034383	751	750	740	12	4	3	739
FBgn0034387	751	750	738	14	6	2.3333333333333335	737
FBgn0034390	788	750	762	64	8	8	724
FBgn0034391	750	750	746	4	2	2	746
FBgn0034392	780	750	766	44	9	4.888888888888889	736
FBgn0034394	653	634	651	21	3	7	632
FBgn0034396	753	750	741	15	8	1.875	738
FBgn0034397	753	750	727	29	9	3.2222222222222223	724
FBgn0034398	756	750	341	421	3	140.33333333333334	335
FBgn0034401	769	750	765	23	6	3.8333333333333335	746
FBgn0034402	768	750	764	22	5	4.4	746
FBgn0034408	750	750	739	11	3	3.6666666666666665	739
FBgn0034411	794	750	760	78	16	4.875	716
FBgn0034413	754	750	723	35	7	5	719
FBgn0034415	760	750	748	22	3	7.333333333333333	738
FBgn0034416	790	750	764	66	9	7.333333333333333	724
FBgn0034417	788	750	784	42	8	5.25	746
FBgn0034418	765	750	753	27	5	5.4	738
FBgn0034419	769	750	763	25	9	2.7777777777777777	744
FBgn0034422	750	750	744	6	3	2	744
FBgn0034423	765	750	725	55	11	5	710
FBgn0034425	623	589	576	81	11	7.363636363636363	542
FBgn0034427	776	750	255	547	3	182.33333333333334	229
FBgn0034430	775	750	767	33	10	3.3	742
FBgn0034432	788	750	757	69	12	5.75	719
FBgn0034433	753	750	742	14	5	2.8	739
FBgn0034435	772	750	737	57	15	3.8	715
FBgn0034436	752	750	751	3	2	1.5	749
FBgn0034437	756	750	747	15	8	1.875	741
FBgn0034438	781	750	773	39	6	6.5	742
FBgn0034439	757	750	728	36	9	4	721
FBgn0034441	757	750	695	69	12	5.75	688
FBgn0034442	756	750	284	478	5	95.6	278
FBgn0034443	765	750	748	32	9	3.5555555555555554	733
FBgn0034447	767	750	375	409	9	45.44444444444444	358
FBgn0034452	757	750	740	24	4	6	733
FBgn0034454	809	750	792	76	9	8.444444444444445	733
FBgn0034456	750	750	734	16	2	8	734
FBgn0034458	766	750	756	26	9	2.888888888888889	740
FBgn0034459	782	750	771	43	9	4.777777777777778	739
FBgn0034460	763	750	756	20	3	6.666666666666667	743
FBgn0034462	764	750	764	14	1	14	750
FBgn0034464	778	750	645	161	4	40.25	617
FBgn0034467	761	750	750	22	5	4.4	739
FBgn0034468	527	527	527	0	0	NA	527
FBgn0034470	751	750	674	78	7	11.142857142857142	673
FBgn0034471	773	750	756	40	4	10	733
FBgn0034473	760	750	754	16	6	2.6666666666666665	744
FBgn0034474	754	750	715	43	4	10.75	711
FBgn0034475	768	750	766	20	4	5	748
FBgn0034476	752	750	720	34	5	6.8	718
FBgn0034477	770	750	647	143	10	14.3	627
FBgn0034478	750	750	725	25	2	12.5	725
FBgn0034479	757	750	748	16	5	3.2	741
FBgn0034481	752	750	743	11	5	2.2	741
FBgn0034483	762	750	668	106	4	26.5	656
FBgn0034484	754	750	722	36	6	6	718
FBgn0034486	766	750	747	35	6	5.833333333333333	731
FBgn0034487	765	750	745	35	5	7	730
FBgn0034489	637	619	631	24	7	3.4285714285714284	613
FBgn0034491	750	750	718	32	4	8	718
FBgn0034494	752	750	752	2	1	2	750
FBgn0034495	751	750	749	3	2	1.5	748
FBgn0034497	761	750	754	18	4	4.5	743
FBgn0034498	788	750	781	45	8	5.625	743
FBgn0034500	759	750	743	25	6	4.166666666666667	734
FBgn0034501	770	750	760	30	7	4.285714285714286	740
FBgn0034502	752	750	742	12	8	1.5	740
FBgn0034503	803	750	739	117	10	11.7	686
FBgn0034504	801	750	758	94	9	10.444444444444445	707
FBgn0034506	774	750	762	36	6	6	738
FBgn0034507	796	750	783	59	9	6.555555555555555	737
FBgn0034509	750	750	730	20	4	5	730
FBgn0034510	781	750	766	46	11	4.181818181818182	735
FBgn0034511	579	559	547	52	10	5.2	527
FBgn0034512	623	589	588	69	8	8.625	554
FBgn0034520	752	750	735	19	7	2.7142857142857144	733
FBgn0034523	773	750	757	39	9	4.333333333333333	734
FBgn0034527	754	750	660	98	5	19.6	656
FBgn0034528	750	750	747	3	1	3	747
FBgn0034529	750	750	747	3	2	1.5	747
FBgn0034530	693	684	678	24	2	12	669
FBgn0034532	753	750	742	14	2	7	739
FBgn0034534	751	750	751	1	1	1	750
FBgn0034537	752	750	552	202	6	33.666666666666664	550
FBgn0034538	754	750	709	49	8	6.125	705
FBgn0034539	750	750	739	11	2	5.5	739
FBgn0034540	641	641	620	21	4	5.25	620
FBgn0034541	751	750	745	7	4	1.75	744
FBgn0034543	763	750	756	20	3	6.666666666666667	743
FBgn0034546	770	750	762	28	4	7	742
FBgn0034548	787	750	774	50	7	7.142857142857143	737
FBgn0034551	758	750	740	26	5	5.2	732
FBgn0034553	778	750	777	29	5	5.8	749
FBgn0034554	761	750	747	25	5	5	736
FBgn0034558	759	750	740	28	6	4.666666666666667	731
FBgn0034560	758	750	753	13	5	2.6	745
FBgn0034563	754	750	719	39	6	6.5	715
FBgn0034565	773	750	760	36	7	5.142857142857143	737
FBgn0034566	750	750	743	7	3	2.3333333333333335	743
FBgn0034568	755	750	715	45	7	6.428571428571429	710
FBgn0034569	753	750	508	248	8	31	505
FBgn0034572	751	750	751	1	1	1	750
FBgn0034573	763	750	744	32	10	3.2	731
FBgn0034576	761	750	725	47	7	6.714285714285714	714
FBgn0034577	753	750	710	46	7	6.571428571428571	707
FBgn0034578	757	750	749	15	4	3.75	742
FBgn0034579	752	750	739	15	5	3	737
FBgn0034582	751	750	625	127	4	31.75	624
FBgn0034583	755	750	699	61	10	6.1	694
FBgn0034585	772	750	683	111	17	6.529411764705882	661
FBgn0034590	773	750	770	26	5	5.2	747
FBgn0034592	750	750	731	19	3	6.333333333333333	731
FBgn0034595	754	750	733	25	5	5	729
FBgn0034598	750	750	577	173	4	43.25	577
FBgn0034601	772	750	767	27	5	5.4	745
FBgn0034602	772	750	764	30	5	6	742
FBgn0034605	753	750	707	49	9	5.444444444444445	704
FBgn0034606	778	750	748	58	14	4.142857142857143	720
FBgn0034611	751	750	743	9	4	2.25	742
FBgn0034612	757	750	754	10	5	2	747
FBgn0034614	751	750	749	3	2	1.5	748
FBgn0034617	757	750	754	10	4	2.5	747
FBgn0034618	763	750	759	17	6	2.8333333333333335	746
FBgn0034622	751	750	719	33	7	4.714285714285714	718
FBgn0034623	763	750	761	15	2	7.5	748
FBgn0034624	775	750	762	38	5	7.6	737
FBgn0034627	782	750	772	42	6	7	740
FBgn0034628	751	750	746	6	3	2	745
FBgn0034631	753	750	571	185	4	46.25	568
FBgn0034636	776	750	745	57	8	7.125	719
FBgn0034638	529	528	518	12	5	2.4	517
FBgn0034639	756	750	728	34	5	6.8	722
FBgn0034641	754	750	744	14	5	2.8	740
FBgn0034643	508	508	506	2	1	2	506
FBgn0034644	763	750	750	26	6	4.333333333333333	737
FBgn0034645	759	750	745	23	5	4.6	736
FBgn0034646	761	750	741	31	6	5.166666666666667	730
FBgn0034647	763	750	752	24	7	3.4285714285714284	739
FBgn0034650	763	750	757	19	5	3.8	744
FBgn0034655	753	750	740	16	6	2.6666666666666665	737
FBgn0034657	754	750	750	8	4	2	746
FBgn0034658	750	750	732	18	4	4.5	732
FBgn0034659	756	750	755	7	3	2.3333333333333335	749
FBgn0034660	764	750	751	27	4	6.75	737
FBgn0034661	757	750	712	52	7	7.428571428571429	705
FBgn0034662	763	750	744	32	4	8	731
FBgn0034664	751	750	746	6	4	1.5	745
FBgn0034665	758	750	727	39	4	9.75	719
FBgn0034666	755	750	755	5	1	5	750
FBgn0034667	751	750	744	8	5	1.6	743
FBgn0034670	755	750	737	23	5	4.6	732
FBgn0034671	782	750	749	65	8	8.125	717
FBgn0034674	769	750	760	28	6	4.666666666666667	741
FBgn0034681	751	750	746	6	4	1.5	745
FBgn0034683	773	750	743	53	7	7.571428571428571	720
FBgn0034684	758	750	734	32	5	6.4	726
FBgn0034689	789	750	768	60	12	5	729
FBgn0034691	762	750	755	19	5	3.8	743
FBgn0034692	750	750	743	7	3	2.3333333333333335	743
FBgn0034693	763	750	752	24	5	4.8	739
FBgn0034694	762	750	748	26	8	3.25	736
FBgn0034697	768	750	743	43	8	5.375	725
FBgn0034704	758	750	746	20	5	4	738
FBgn0034705	750	750	713	37	4	9.25	713
FBgn0034707	637	608	595	71	7	10.142857142857142	566
FBgn0034709	783	750	773	43	8	5.375	740
FBgn0034710	567	538	551	45	9	5	522
FBgn0034712	770	750	695	95	4	23.75	675
FBgn0034713	770	750	689	101	4	25.25	669
FBgn0034716	752	750	707	47	6	7.833333333333333	705
FBgn0034720	585	585	579	6	4	1.5	579
FBgn0034721	758	750	755	11	3	3.6666666666666665	747
FBgn0034722	771	750	764	28	6	4.666666666666667	743
FBgn0034723	768	750	734	52	13	4	716
FBgn0034724	756	750	749	13	4	3.25	743
FBgn0034725	774	750	731	67	7	9.571428571428571	707
FBgn0034727	797	750	752	92	11	8.363636363636363	705
FBgn0034728	797	750	752	92	11	8.363636363636363	705
FBgn0034729	750	750	742	8	3	2.6666666666666665	742
FBgn0034730	750	750	734	16	4	4	734
FBgn0034731	750	750	748	2	1	2	748
FBgn0034733	787	750	755	69	11	6.2727272727272725	718
FBgn0034736	760	750	716	54	11	4.909090909090909	706
FBgn0034737	760	750	750	20	5	4	740
FBgn0034741	751	750	412	340	6	56.666666666666664	411
FBgn0034742	750	750	722	28	4	7	722
FBgn0034743	750	750	750	0	0	NA	750
FBgn0034745	758	750	752	14	6	2.3333333333333335	744
FBgn0034761	664	657	594	77	10	7.7	587
FBgn0034766	750	750	749	1	1	1	749
FBgn0034768	768	750	758	28	4	7	740
FBgn0034769	750	750	749	1	1	1	749
FBgn0034770	752	750	751	3	3	1	749
FBgn0034774	758	750	736	30	6	5	728
FBgn0034776	779	750	770	38	5	7.6	741
FBgn0034783	754	750	741	17	7	2.4285714285714284	737
FBgn0034784	781	750	777	35	6	5.833333333333333	746
FBgn0034786	781	750	749	63	8	7.875	718
FBgn0034788	768	750	723	63	5	12.6	705
FBgn0034789	752	750	700	54	11	4.909090909090909	698
FBgn0034792	752	750	737	17	6	2.8333333333333335	735
FBgn0034793	750	750	734	16	4	4	734
FBgn0034795	753	750	749	7	4	1.75	746
FBgn0034800	765	750	763	17	7	2.4285714285714284	748
FBgn0034802	755	750	749	11	4	2.75	744
FBgn0034803	750	750	743	7	1	7	743
FBgn0034804	783	750	750	66	15	4.4	717
FBgn0034807	750	750	718	32	6	5.333333333333333	718
FBgn0034808	750	750	730	20	4	5	730
FBgn0034814	795	750	757	83	12	6.916666666666667	712
FBgn0034816	753	750	752	4	2	2	749
FBgn0034819	766	750	736	46	6	7.666666666666667	720
FBgn0034820	762	750	724	50	6	8.333333333333334	712
FBgn0034821	758	750	746	20	5	4	738
FBgn0034822	778	750	559	247	6	41.166666666666664	531
FBgn0034824	765	750	717	63	4	15.75	702
FBgn0034825	750	750	744	6	2	3	744
FBgn0034826	756	750	746	16	5	3.2	740
FBgn0034827	750	750	675	75	3	25	675
FBgn0034828	766	750	740	42	12	3.5	724
FBgn0034829	722	722	717	5	2	2.5	717
FBgn0034833	769	750	713	75	11	6.818181818181818	694
FBgn0034834	751	750	733	19	6	3.1666666666666665	732
FBgn0034835	757	750	705	59	12	4.916666666666667	698
FBgn0034837	781	750	763	49	6	8.166666666666666	732
FBgn0034839	783	750	741	75	9	8.333333333333334	708
FBgn0034840	750	750	733	17	3	5.666666666666667	733
FBgn0034841	767	750	766	18	4	4.5	749
FBgn0034842	757	750	734	30	8	3.75	727
FBgn0034844	750	750	749	1	1	1	749
FBgn0034846	750	750	747	3	1	3	747
FBgn0034849	750	750	749	1	1	1	749
FBgn0034850	762	750	762	12	1	12	750
FBgn0034853	764	750	733	45	10	4.5	719
FBgn0034856	757	750	749	15	4	3.75	742
FBgn0034858	750	750	750	0	0	NA	750
FBgn0034860	784	750	761	57	13	4.384615384615385	727
FBgn0034861	756	750	756	6	1	6	750
FBgn0034863	751	750	733	19	4	4.75	732
FBgn0034865	550	537	491	72	6	12	478
FBgn0034866	766	750	700	82	10	8.2	684
FBgn0034867	668	659	657	20	6	3.3333333333333335	648
FBgn0034869	794	750	790	48	8	6	746
FBgn0034870	762	750	717	57	7	8.142857142857142	705
FBgn0034871	777	750	759	45	8	5.625	732
FBgn0034876	751	750	741	11	4	2.75	740
FBgn0034877	751	750	745	7	5	1.4	744
FBgn0034879	791	750	730	102	13	7.846153846153846	689
FBgn0034880	791	750	755	77	12	6.416666666666667	714
FBgn0034882	758	750	693	73	6	12.166666666666666	685
FBgn0034883	779	750	742	66	11	6	713
FBgn0034887	750	750	690	60	11	5.454545454545454	690
FBgn0034893	750	750	728	22	5	4.4	728
FBgn0034894	750	750	750	0	0	NA	750
FBgn0034900	777	750	767	37	8	4.625	740
FBgn0034903	763	750	691	85	8	10.625	678
FBgn0034907	750	750	738	12	4	3	738
FBgn0034908	758	750	726	40	7	5.714285714285714	718
FBgn0034909	768	750	722	64	6	10.666666666666666	704
FBgn0034910	800	750	756	94	8	11.75	706
FBgn0034911	751	750	718	34	9	3.7777777777777777	717
FBgn0034913	751	750	694	58	2	29	693
FBgn0034914	751	750	728	24	2	12	727
FBgn0034919	783	750	780	36	8	4.5	747
FBgn0034920	753	750	735	21	6	3.5	732
FBgn0034921	773	750	761	35	8	4.375	738
FBgn0034923	750	750	745	5	2	2.5	745
FBgn0034924	754	750	753	5	2	2.5	749
FBgn0034925	772	750	748	46	8	5.75	726
FBgn0034933	762	750	500	274	8	34.25	488
FBgn0034935	753	750	735	21	5	4.2	732
FBgn0034936	773	750	753	43	5	8.6	730
FBgn0034938	750	750	737	13	1	13	737
FBgn0034939	753	750	721	35	5	7	718
FBgn0034940	766	750	743	39	3	13	727
FBgn0034942	754	750	745	13	4	3.25	741
FBgn0034943	762	750	753	21	5	4.2	741
FBgn0034946	775	750	763	37	5	7.4	738
FBgn0034948	847	750	806	138	11	12.545454545454545	709
FBgn0034950	761	750	755	17	3	5.666666666666667	744
FBgn0034956	758	750	731	35	5	7	723
FBgn0034957	778	750	757	49	11	4.454545454545454	729
FBgn0034958	750	750	750	0	0	NA	750
FBgn0034959	750	750	747	3	2	1.5	747
FBgn0034961	758	750	721	45	9	5	713
FBgn0034962	750	750	750	0	0	NA	750
FBgn0034963	754	750	754	4	2	2	750
FBgn0034964	763	750	762	14	6	2.3333333333333335	749
FBgn0034965	773	750	769	27	4	6.75	746
FBgn0034966	795	750	773	67	8	8.375	728
FBgn0034968	754	750	729	29	9	3.2222222222222223	725
FBgn0034970	756	750	716	46	6	7.666666666666667	710
FBgn0034971	753	750	720	36	2	18	717
FBgn0034972	751	750	703	49	8	6.125	702
FBgn0034973	750	750	605	145	3	48.333333333333336	605
FBgn0034975	758	750	687	79	10	7.9	679
FBgn0034976	760	750	726	44	3	14.666666666666666	716
FBgn0034982	752	750	706	48	8	6	704
FBgn0034985	756	750	750	12	5	2.4	744
FBgn0034986	759	750	749	19	3	6.333333333333333	740
FBgn0034990	760	750	735	35	4	8.75	725
FBgn0034994	767	750	763	21	4	5.25	746
FBgn0034996	750	750	741	9	3	3	741
FBgn0034997	768	750	748	38	9	4.222222222222222	730
FBgn0034998	777	750	702	102	7	14.571428571428571	675
FBgn0034999	759	750	746	22	5	4.4	737
FBgn0035000	753	750	633	123	2	61.5	630
FBgn0035001	751	750	739	13	3	4.333333333333333	738
FBgn0035004	761	750	712	60	3	20	701
FBgn0035005	750	750	738	12	2	6	738
FBgn0035006	751	750	727	25	5	5	726
FBgn0035010	757	750	740	24	7	3.4285714285714284	733
FBgn0035014	767	750	732	52	6	8.666666666666666	715
FBgn0035016	753	750	753	3	1	3	750
FBgn0035019	753	750	751	5	4	1.25	748
FBgn0035020	751	750	750	2	2	1	749
FBgn0035021	764	750	758	20	4	5	744
FBgn0035022	790	750	777	53	9	5.888888888888889	737
FBgn0035023	765	750	740	40	6	6.666666666666667	725
FBgn0035024	751	750	719	33	6	5.5	718
FBgn0035025	792	750	781	53	7	7.571428571428571	739
FBgn0035026	750	750	750	0	0	NA	750
FBgn0035027	750	750	741	9	1	9	741
FBgn0035031	754	750	751	7	3	2.3333333333333335	747
FBgn0035032	751	750	748	4	3	1.3333333333333333	747
FBgn0035033	751	750	740	12	3	4	739
FBgn0035034	750	750	707	43	4	10.75	707
FBgn0035036	758	750	748	18	6	3	740
FBgn0035039	763	750	742	34	7	4.857142857142857	729
FBgn0035040	766	750	740	42	6	7	724
FBgn0035041	771	750	740	52	5	10.4	719
FBgn0035042	768	750	736	50	5	10	718
FBgn0035043	761	750	740	32	3	10.666666666666666	729
FBgn0035044	750	750	740	10	3	3.3333333333333335	740
FBgn0035046	750	750	747	3	1	3	747
FBgn0035047	755	750	755	5	2	2.5	750
FBgn0035049	758	750	758	8	2	4	750
FBgn0035050	818	750	813	73	11	6.636363636363637	745
FBgn0035056	757	750	715	49	8	6.125	708
FBgn0035059	620	620	619	1	1	1	619
FBgn0035063	756	750	753	9	3	3	747
FBgn0035064	750	750	750	0	0	NA	750
FBgn0035065	753	750	753	3	2	1.5	750
FBgn0035068	766	750	706	76	9	8.444444444444445	690
FBgn0035070	782	750	738	76	8	9.5	706
FBgn0035076	771	750	769	23	5	4.6	748
FBgn0035078	760	750	756	14	3	4.666666666666667	746
FBgn0035083	756	750	722	40	8	5	716
FBgn0035084	750	750	747	3	2	1.5	747
FBgn0035085	778	750	727	79	5	15.8	699
FBgn0035086	751	750	749	3	3	1	748
FBgn0035088	750	750	745	5	2	2.5	745
FBgn0035091	768	750	764	22	5	4.4	746
FBgn0035092	769	750	766	22	4	5.5	747
FBgn0035097	776	750	700	102	18	5.666666666666667	674
FBgn0035099	792	750	735	99	14	7.071428571428571	693
FBgn0035101	752	750	741	13	6	2.1666666666666665	739
FBgn0035103	804	750	779	79	9	8.777777777777779	725
FBgn0035104	805	750	782	78	9	8.666666666666666	727
FBgn0035106	775	750	774	26	4	6.5	749
FBgn0035107	775	750	772	28	4	7	747
FBgn0035109	768	750	767	19	7	2.7142857142857144	749
FBgn0035110	753	750	753	3	1	3	750
FBgn0035111	750	750	744	6	2	3	744
FBgn0035113	794	750	761	77	14	5.5	717
FBgn0035120	780	750	780	30	4	7.5	750
FBgn0035121	761	750	721	51	10	5.1	710
FBgn0035122	761	750	727	45	9	5	716
FBgn0035131	758	750	746	20	5	4	738
FBgn0035134	770	750	768	22	6	3.6666666666666665	748
FBgn0035137	751	750	746	6	4	1.5	745
FBgn0035138	750	750	744	6	3	2	744
FBgn0035139	761	750	745	27	10	2.7	734
FBgn0035140	755	750	728	32	7	4.571428571428571	723
FBgn0035141	761	750	722	50	11	4.545454545454546	711
FBgn0035142	763	750	747	29	5	5.8	734
FBgn0035143	755	750	746	14	9	1.5555555555555556	741
FBgn0035144	754	750	744	14	7	2	740
FBgn0035145	782	750	751	63	9	7	719
FBgn0035146	775	750	764	36	8	4.5	739
FBgn0035147	779	750	769	39	9	4.333333333333333	740
FBgn0035149	767	750	721	63	7	9	704
FBgn0035150	767	750	723	61	8	7.625	706
FBgn0035152	673	595	660	91	7	13	582
FBgn0035154	640	626	594	60	5	12	580
FBgn0035157	781	750	749	63	11	5.7272727272727275	718
FBgn0035158	508	504	423	89	6	14.833333333333334	419
FBgn0035159	823	750	816	80	8	10	743
FBgn0035160	765	750	739	41	8	5.125	724
FBgn0035161	785	750	783	37	7	5.285714285714286	748
FBgn0035162	755	750	726	34	11	3.090909090909091	721
FBgn0035164	753	750	743	13	3	4.333333333333333	740
FBgn0035165	755	750	742	18	4	4.5	737
FBgn0035166	807	750	799	65	9	7.222222222222222	742
FBgn0035167	781	750	773	39	3	13	742
FBgn0035168	615	595	586	49	7	7	566
FBgn0035170	761	750	682	90	12	7.5	671
FBgn0035173	756	750	718	44	5	8.8	712
FBgn0035181	752	750	712	42	7	6	710
FBgn0035186	760	750	723	47	6	7.833333333333333	713
FBgn0035187	755	750	718	42	4	10.5	713
FBgn0035189	761	750	750	22	4	5.5	739
FBgn0035193	754	750	743	15	5	3	739
FBgn0035194	751	750	750	2	2	1	749
FBgn0035196	627	626	607	21	8	2.625	606
FBgn0035199	786	750	728	94	11	8.545454545454545	692
FBgn0035204	752	750	659	95	5	19	657
FBgn0035205	750	750	740	10	1	10	740
FBgn0035206	817	750	797	87	6	14.5	730
FBgn0035207	800	750	783	67	6	11.166666666666666	733
FBgn0035211	759	750	742	26	7	3.7142857142857144	733
FBgn0035216	788	750	767	59	10	5.9	729
FBgn0035217	779	750	745	63	10	6.3	716
FBgn0035228	777	750	751	53	8	6.625	724
FBgn0035229	778	750	757	49	6	8.166666666666666	729
FBgn0035231	751	750	735	17	6	2.8333333333333335	734
FBgn0035232	756	750	748	14	4	3.5	742
FBgn0035233	750	750	749	1	1	1	749
FBgn0035234	766	750	738	44	10	4.4	722
FBgn0035235	772	750	736	58	10	5.8	714
FBgn0035236	772	750	739	55	11	5	717
FBgn0035237	756	750	729	33	7	4.714285714285714	723
FBgn0035238	764	750	755	23	3	7.666666666666667	741
FBgn0035241	777	750	740	64	8	8	713
FBgn0035243	761	750	751	21	7	3	740
FBgn0035245	750	750	730	20	4	5	730
FBgn0035247	789	750	750	78	9	8.666666666666666	711
FBgn0035248	750	750	750	0	0	NA	750
FBgn0035249	751	750	744	8	4	2	743
FBgn0035251	750	750	750	0	0	NA	750
FBgn0035252	750	750	750	0	0	NA	750
FBgn0035253	760	750	756	14	3	4.666666666666667	746
FBgn0035254	750	750	750	0	0	NA	750
FBgn0035256	811	750	796	76	8	9.5	735
FBgn0035258	761	750	715	57	8	7.125	704
FBgn0035260	761	750	702	70	16	4.375	691
FBgn0035263	750	750	734	16	3	5.333333333333333	734
FBgn0035265	758	750	743	23	6	3.8333333333333335	735
FBgn0035266	758	750	742	24	5	4.8	734
FBgn0035267	774	750	735	63	11	5.7272727272727275	711
FBgn0035268	762	750	754	20	3	6.666666666666667	742
FBgn0035270	769	750	721	67	9	7.444444444444445	702
FBgn0035271	756	750	756	6	1	6	750
FBgn0035279	766	750	679	103	8	12.875	663
FBgn0035280	750	750	732	18	1	18	732
FBgn0035281	750	750	744	6	3	2	744
FBgn0035282	775	750	771	29	6	4.833333333333333	746
FBgn0035283	782	750	762	52	9	5.777777777777778	730
FBgn0035285	754	750	737	21	3	7	733
FBgn0035286	807	750	806	58	4	14.5	749
FBgn0035287	753	750	744	12	4	3	741
FBgn0035290	801	750	798	54	6	9	747
FBgn0035294	775	750	767	33	4	8.25	742
FBgn0035295	750	750	746	4	1	4	746
FBgn0035299	764	750	749	29	6	4.833333333333333	735
FBgn0035300	764	750	749	29	6	4.833333333333333	735
FBgn0035308	763	750	745	31	10	3.1	732
FBgn0035312	840	750	824	106	12	8.833333333333334	734
FBgn0035313	750	750	724	26	5	5.2	724
FBgn0035315	750	750	725	25	3	8.333333333333334	725
FBgn0035316	797	750	786	58	6	9.666666666666666	739
FBgn0035317	762	750	742	32	5	6.4	730
FBgn0035318	767	750	763	21	4	5.25	746
FBgn0035321	751	750	751	1	1	1	750
FBgn0035323	752	750	732	22	7	3.142857142857143	730
FBgn0035325	785	750	754	66	6	11	719
FBgn0035328	750	750	734	16	3	5.333333333333333	734
FBgn0035331	753	750	742	14	3	4.666666666666667	739
FBgn0035332	788	750	770	56	5	11.2	732
FBgn0035333	766	750	743	39	5	7.8	727
FBgn0035334	766	750	737	45	5	9	721
FBgn0035335	750	750	750	0	0	NA	750
FBgn0035336	764	750	764	14	2	7	750
FBgn0035337	756	750	756	6	3	2	750
FBgn0035343	751	750	724	28	4	7	723
FBgn0035344	771	750	749	43	6	7.166666666666667	728
FBgn0035348	751	750	751	1	1	1	750
FBgn0035355	767	750	767	17	3	5.666666666666667	750
FBgn0035358	750	750	689	61	4	15.25	689
FBgn0035359	772	750	756	38	6	6.333333333333333	734
FBgn0035360	769	750	768	20	3	6.666666666666667	749
FBgn0035370	767	750	745	39	9	4.333333333333333	728
FBgn0035372	798	750	796	50	6	8.333333333333334	748
FBgn0035379	750	750	737	13	4	3.25	737
FBgn0035380	750	750	683	67	2	33.5	683
FBgn0035382	762	750	760	14	3	4.666666666666667	748
FBgn0035383	796	750	792	50	6	8.333333333333334	746
FBgn0035384	756	750	733	29	6	4.833333333333333	727
FBgn0035385	771	750	761	31	5	6.2	740
FBgn0035390	781	750	772	40	4	10	741
FBgn0035392	787	750	530	294	8	36.75	493
FBgn0035397	750	750	722	28	5	5.6	722
FBgn0035398	790	750	777	53	8	6.625	737
FBgn0035400	762	750	762	12	3	4	750
FBgn0035401	762	750	759	15	4	3.75	747
FBgn0035402	752	750	749	5	4	1.25	747
FBgn0035407	763	750	590	186	5	37.2	577
FBgn0035410	769	750	761	27	8	3.375	742
FBgn0035413	751	750	730	22	3	7.333333333333333	729
FBgn0035415	714	689	693	46	5	9.2	668
FBgn0035420	750	750	744	6	3	2	744
FBgn0035421	750	750	748	2	2	1	748
FBgn0035422	777	750	771	33	7	4.714285714285714	744
FBgn0035423	770	750	768	22	4	5.5	748
FBgn0035425	753	750	741	15	9	1.6666666666666667	738
FBgn0035426	782	750	758	56	12	4.666666666666667	726
FBgn0035427	764	750	755	23	5	4.6	741
FBgn0035428	778	750	760	46	6	7.666666666666667	732
FBgn0035429	773	750	760	36	6	6	737
FBgn0035430	760	750	755	15	7	2.142857142857143	745
FBgn0035432	768	750	420	366	4	91.5	402
FBgn0035434	781	750	584	228	7	32.57142857142857	553
FBgn0035435	754	750	741	17	4	4.25	737
FBgn0035438	798	750	797	49	10	4.9	749
FBgn0035440	626	600	601	51	6	8.5	575
FBgn0035443	750	750	742	8	2	4	742
FBgn0035445	752	750	732	22	7	3.142857142857143	730
FBgn0035449	519	512	501	25	6	4.166666666666667	494
FBgn0035452	773	750	769	27	10	2.7	746
FBgn0035455	756	750	729	33	7	4.714285714285714	723
FBgn0035462	751	750	728	24	5	4.8	727
FBgn0035464	756	750	748	14	3	4.666666666666667	742
FBgn0035468	765	750	765	15	2	7.5	750
FBgn0035469	751	750	730	22	3	7.333333333333333	729
FBgn0035471	751	750	741	11	6	1.8333333333333333	740
FBgn0035473	750	750	742	8	4	2	742
FBgn0035475	731	702	727	33	6	5.5	698
FBgn0035476	755	750	734	26	5	5.2	729
FBgn0035478	758	750	741	25	9	2.7777777777777777	733
FBgn0035479	755	750	666	94	5	18.8	661
FBgn0035480	773	750	744	52	12	4.333333333333333	721
FBgn0035481	752	750	748	6	3	2	746
FBgn0035484	787	750	744	80	9	8.88888888888889	707
FBgn0035488	754	750	754	4	1	4	750
FBgn0035490	753	750	751	5	4	1.25	748
FBgn0035491	761	750	733	39	9	4.333333333333333	722
FBgn0035495	772	750	749	45	9	5	727
FBgn0035496	760	750	724	46	12	3.8333333333333335	714
FBgn0035497	755	750	745	15	7	2.142857142857143	740
FBgn0035499	760	750	721	49	7	7	711
FBgn0035501	750	750	598	152	2	76	598
FBgn0035504	758	750	756	10	3	3.3333333333333335	748
FBgn0035505	800	750	787	63	10	6.3	737
FBgn0035508	765	750	713	67	2	33.5	698
FBgn0035510	768	750	764	22	9	2.4444444444444446	746
FBgn0035511	704	704	682	22	3	7.333333333333333	682
FBgn0035512	750	750	722	28	3	9.333333333333334	722
FBgn0035515	767	750	731	53	5	10.6	714
FBgn0035517	760	750	702	68	8	8.5	692
FBgn0035518	753	750	745	11	3	3.6666666666666665	742
FBgn0035519	753	750	745	11	3	3.6666666666666665	742
FBgn0035520	751	750	720	32	9	3.5555555555555554	719
FBgn0035521	750	750	730	20	4	5	730
FBgn0035522	656	647	636	29	6	4.833333333333333	627
FBgn0035523	595	582	562	46	6	7.666666666666667	549
FBgn0035526	780	750	670	140	8	17.5	640
FBgn0035528	752	750	750	4	3	1.3333333333333333	748
FBgn0035529	752	750	750	4	3	1.3333333333333333	748
FBgn0035532	780	750	763	47	6	7.833333333333333	733
FBgn0035533	752	750	743	11	4	2.75	741
FBgn0035534	751	750	742	10	3	3.3333333333333335	741
FBgn0035537	756	750	750	12	4	3	744
FBgn0035538	583	540	556	70	7	10	513
FBgn0035539	809	750	747	121	14	8.642857142857142	688
FBgn0035540	670	643	659	38	7	5.428571428571429	632
FBgn0035541	814	750	806	72	8	9	742
FBgn0035542	784	750	734	84	8	10.5	700
FBgn0035543	758	750	756	10	3	3.3333333333333335	748
FBgn0035544	750	750	748	2	1	2	748
FBgn0035546	770	750	755	35	5	7	735
FBgn0035548	778	750	773	33	5	6.6	745
FBgn0035551	752	750	718	36	4	9	716
FBgn0035552	755	750	733	27	4	6.75	728
FBgn0035553	753	750	704	52	7	7.428571428571429	701
FBgn0035554	767	750	749	35	9	3.888888888888889	732
FBgn0035555	750	750	741	9	3	3	741
FBgn0035557	762	750	724	50	7	7.142857142857143	712
FBgn0035558	773	750	728	68	15	4.533333333333333	705
FBgn0035568	757	750	722	42	8	5.25	715
FBgn0035569	800	750	767	83	10	8.3	717
FBgn0035570	757	750	720	44	7	6.285714285714286	713
FBgn0035571	768	750	752	34	8	4.25	734
FBgn0035574	765	750	710	70	12	5.833333333333333	695
FBgn0035575	802	750	780	74	7	10.571428571428571	728
FBgn0035577	750	750	734	16	2	8	734
FBgn0035582	762	750	761	13	3	4.333333333333333	749
FBgn0035586	751	750	750	2	2	1	749
FBgn0035587	756	750	756	6	2	3	750
FBgn0035588	751	750	740	12	2	6	739
FBgn0035589	751	750	746	6	3	2	745
FBgn0035590	751	750	743	9	4	2.25	742
FBgn0035592	750	750	745	5	2	2.5	745
FBgn0035593	762	750	759	15	7	2.142857142857143	747
FBgn0035594	750	750	730	20	3	6.666666666666667	730
FBgn0035598	762	750	698	76	7	10.857142857142858	686
FBgn0035600	778	750	738	68	17	4	710
FBgn0035601	752	750	741	13	5	2.6	739
FBgn0035604	797	750	789	55	5	11	742
FBgn0035607	750	750	746	4	2	2	746
FBgn0035610	756	750	737	25	8	3.125	731
FBgn0035611	753	750	753	3	1	3	750
FBgn0035612	751	750	741	11	4	2.75	740
FBgn0035617	753	750	723	33	9	3.6666666666666665	720
FBgn0035619	750	750	750	0	0	NA	750
FBgn0035620	762	750	758	16	2	8	746
FBgn0035621	765	750	760	20	3	6.666666666666667	745
FBgn0035624	802	750	790	64	10	6.4	738
FBgn0035625	760	750	550	220	5	44	540
FBgn0035626	830	750	815	95	8	11.875	735
FBgn0035627	753	750	751	5	3	1.6666666666666667	748
FBgn0035630	751	750	729	23	3	7.666666666666667	728
FBgn0035631	763	750	763	13	4	3.25	750
FBgn0035632	764	750	763	15	4	3.75	749
FBgn0035636	781	750	762	50	9	5.555555555555555	731
FBgn0035638	788	750	764	62	11	5.636363636363637	726
FBgn0035639	750	750	737	13	3	4.333333333333333	737
FBgn0035641	755	750	735	25	8	3.125	730
FBgn0035643	782	750	762	52	7	7.428571428571429	730
FBgn0035644	751	750	747	5	3	1.6666666666666667	746
FBgn0035645	763	750	757	19	5	3.8	744
FBgn0035647	783	750	764	52	7	7.428571428571429	731
FBgn0035648	779	750	764	44	6	7.333333333333333	735
FBgn0035649	804	750	787	71	10	7.1	733
FBgn0035656	770	750	744	46	5	9.2	724
FBgn0035657	754	750	739	19	3	6.333333333333333	735
FBgn0035661	757	750	756	8	2	4	749
FBgn0035665	751	750	747	5	4	1.25	746
FBgn0035666	660	660	596	64	9	7.111111111111111	596
FBgn0035670	770	750	768	22	5	4.4	748
FBgn0035673	768	750	747	39	7	5.571428571428571	729
FBgn0035674	770	750	735	55	9	6.111111111111111	715
FBgn0035675	769	750	756	32	4	8	737
FBgn0035677	770	750	764	26	4	6.5	744
FBgn0035679	765	750	762	18	8	2.25	747
FBgn0035685	752	742	706	56	6	9.333333333333334	696
FBgn0035686	757	750	731	33	6	5.5	724
FBgn0035687	750	750	731	19	2	9.5	731
FBgn0035688	784	750	772	46	11	4.181818181818182	738
FBgn0035689	783	750	773	43	10	4.3	740
FBgn0035690	604	587	602	19	5	3.8	585
FBgn0035691	766	750	742	40	10	4	726
FBgn0035692	813	750	790	86	9	9.555555555555555	727
FBgn0035693	753	750	746	10	6	1.6666666666666667	743
FBgn0035695	537	522	536	16	3	5.333333333333333	521
FBgn0035696	770	750	731	59	10	5.9	711
FBgn0035697	756	750	755	7	3	2.3333333333333335	749
FBgn0035699	750	750	747	3	1	3	747
FBgn0035702	776	750	773	29	5	5.8	747
FBgn0035703	776	750	776	26	3	8.666666666666666	750
FBgn0035704	752	750	739	15	5	3	737
FBgn0035708	765	750	738	42	10	4.2	723
FBgn0035711	750	750	646	104	1	104	646
FBgn0035713	754	750	750	8	3	2.6666666666666665	746
FBgn0035714	754	750	751	7	2	3.5	747
FBgn0035718	761	750	744	28	7	4	733
FBgn0035720	753	750	751	5	2	2.5	748
FBgn0035721	756	750	727	35	10	3.5	721
FBgn0035722	751	750	746	6	3	2	745
FBgn0035725	772	750	748	46	12	3.8333333333333335	726
FBgn0035726	772	750	752	42	12	3.5	730
FBgn0035727	752	750	746	8	5	1.6	744
FBgn0035730	757	750	570	194	10	19.4	563
FBgn0035733	750	750	729	21	4	5.25	729
FBgn0035734	795	750	772	68	8	8.5	727
FBgn0035736	753	750	747	9	5	1.8	744
FBgn0035737	752	750	749	5	4	1.25	747
FBgn0035741	762	750	750	24	5	4.8	738
FBgn0035742	786	750	769	53	4	13.25	733
FBgn0035743	786	750	781	41	3	13.666666666666666	745
FBgn0035750	760	750	752	18	4	4.5	742
FBgn0035751	780	750	770	40	3	13.333333333333334	740
FBgn0035753	773	750	751	45	5	9	728
FBgn0035755	799	750	741	107	14	7.642857142857143	692
FBgn0035756	778	750	735	71	6	11.833333333333334	707
FBgn0035761	752	750	734	20	3	6.666666666666667	732
FBgn0035762	752	750	734	20	3	6.666666666666667	732
FBgn0035763	750	750	745	5	2	2.5	745
FBgn0035766	776	750	755	47	11	4.2727272727272725	729
FBgn0035770	766	750	737	45	5	9	721
FBgn0035771	750	750	727	23	2	11.5	727
FBgn0035776	750	750	633	117	8	14.625	633
FBgn0035777	765	750	761	19	9	2.111111111111111	746
FBgn0035781	797	750	784	60	9	6.666666666666667	737
FBgn0035782	750	750	705	45	6	7.5	705
FBgn0035785	752	750	671	83	3	27.666666666666668	669
FBgn0035787	755	750	749	11	7	1.5714285714285714	744
FBgn0035788	783	750	781	35	7	5	748
FBgn0035789	754	750	499	259	6	43.166666666666664	495
FBgn0035790	794	750	768	70	8	8.75	724
FBgn0035792	750	750	750	0	0	NA	750
FBgn0035793	751	750	702	50	7	7.142857142857143	701
FBgn0035797	820	750	729	161	8	20.125	659
FBgn0035798	778	750	754	52	7	7.428571428571429	726
FBgn0035800	782	750	736	78	12	6.5	704
FBgn0035802	761	750	686	86	15	5.733333333333333	675
FBgn0035805	791	750	711	121	12	10.083333333333334	670
FBgn0035807	780	750	739	71	12	5.916666666666667	709
FBgn0035812	750	750	366	384	1	384	366
FBgn0035813	751	750	744	8	2	4	743
FBgn0035815	760	750	710	60	11	5.454545454545454	700
FBgn0035824	797	750	765	79	9	8.777777777777779	718
FBgn0035827	764	750	756	22	8	2.75	742
FBgn0035829	755	750	723	37	9	4.111111111111111	718
FBgn0035830	780	750	742	68	12	5.666666666666667	712
FBgn0035831	753	750	732	24	7	3.4285714285714284	729
FBgn0035833	753	750	715	41	6	6.833333333333333	712
FBgn0035838	752	750	736	18	5	3.6	734
FBgn0035842	754	750	742	16	5	3.2	738
FBgn0035844	777	750	736	68	8	8.5	709
FBgn0035847	769	750	757	31	5	6.2	738
FBgn0035848	769	750	757	31	5	6.2	738
FBgn0035849	750	750	740	10	4	2.5	740
FBgn0035850	756	750	749	13	3	4.333333333333333	743
FBgn0035851	757	750	750	14	6	2.3333333333333335	743
FBgn0035852	750	750	750	0	0	NA	750
FBgn0035853	764	750	760	18	5	3.6	746
FBgn0035854	784	750	777	41	8	5.125	743
FBgn0035856	806	750	802	60	4	15	746
FBgn0035857	750	750	746	4	1	4	746
FBgn0035858	787	750	758	66	10	6.6	721
FBgn0035859	754	750	730	28	4	7	726
FBgn0035861	751	750	725	27	3	9	724
FBgn0035865	750	750	739	11	1	11	739
FBgn0035866	768	750	767	19	4	4.75	749
FBgn0035867	770	750	761	29	8	3.625	741
FBgn0035868	779	750	768	40	3	13.333333333333334	739
FBgn0035872	785	750	753	67	11	6.090909090909091	718
FBgn0035873	782	750	728	86	6	14.333333333333334	696
FBgn0035875	789	750	734	94	11	8.545454545454545	695
FBgn0035876	758	750	728	38	4	9.5	720
FBgn0035878	751	750	670	82	5	16.4	669
FBgn0035879	763	750	713	63	7	9	700
FBgn0035886	767	750	745	39	10	3.9	728
FBgn0035887	755	750	716	44	8	5.5	711
FBgn0035888	777	750	597	207	11	18.818181818181817	570
FBgn0035890	750	750	709	41	4	10.25	709
FBgn0035896	766	750	749	33	5	6.6	733
FBgn0035900	753	750	749	7	5	1.4	746
FBgn0035901	755	750	742	18	5	3.6	737
FBgn0035902	754	750	743	15	3	5	739
FBgn0035904	761	750	729	43	6	7.166666666666667	718
FBgn0035907	844	750	815	123	15	8.2	721
FBgn0035909	763	750	705	71	7	10.142857142857142	692
FBgn0035911	783	750	767	49	9	5.444444444444445	734
FBgn0035914	762	750	756	18	5	3.6	744
FBgn0035915	755	750	745	15	5	3	740
FBgn0035916	802	750	784	70	9	7.777777777777778	732
FBgn0035917	802	750	784	70	9	7.777777777777778	732
FBgn0035918	750	750	727	23	2	11.5	727
FBgn0035921	671	668	664	10	5	2	661
FBgn0035922	752	750	743	11	5	2.2	741
FBgn0035923	754	750	689	69	5	13.8	685
FBgn0035926	760	750	757	13	6	2.1666666666666665	747
FBgn0035928	750	750	745	5	4	1.25	745
FBgn0035929	752	750	748	6	3	2	746
FBgn0035931	750	750	746	4	1	4	746
FBgn0035934	779	750	746	62	8	7.75	717
FBgn0035943	757	750	754	10	4	2.5	747
FBgn0035944	757	750	754	10	4	2.5	747
FBgn0035945	633	632	593	41	4	10.25	592
FBgn0035948	761	750	726	46	8	5.75	715
FBgn0035949	756	750	729	33	8	4.125	723
FBgn0035951	768	750	749	37	5	7.4	731
FBgn0035952	755	750	753	7	4	1.75	748
FBgn0035953	751	750	751	1	1	1	750
FBgn0035954	760	750	715	55	9	6.111111111111111	705
FBgn0035955	821	750	701	191	9	21.22222222222222	630
FBgn0035956	753	750	743	13	3	4.333333333333333	740
FBgn0035957	750	750	710	40	7	5.714285714285714	710
FBgn0035959	793	750	793	43	2	21.5	750
FBgn0035960	793	750	790	46	3	15.333333333333334	747
FBgn0035965	818	750	790	96	12	8	722
FBgn0035968	797	750	794	50	8	6.25	747
FBgn0035969	758	750	750	16	5	3.2	742
FBgn0035970	774	750	758	40	8	5	734
FBgn0035971	784	750	779	39	8	4.875	745
FBgn0035975	770	750	752	38	8	4.75	732
FBgn0035976	764	750	732	46	11	4.181818181818182	718
FBgn0035977	752	750	526	228	5	45.6	524
FBgn0035978	772	750	764	30	6	5	742
FBgn0035980	750	750	739	11	4	2.75	739
FBgn0035981	750	750	750	0	0	NA	750
FBgn0035982	775	750	742	58	11	5.2727272727272725	717
FBgn0035983	665	642	626	62	8	7.75	603
FBgn0035985	769	750	735	53	9	5.888888888888889	716
FBgn0035986	751	750	751	1	1	1	750
FBgn0035987	751	750	745	7	2	3.5	744
FBgn0035989	753	750	734	22	3	7.333333333333333	731
FBgn0035996	750	750	714	36	4	9	714
FBgn0035998	755	750	748	12	6	2	743
FBgn0035999	750	750	750	0	0	NA	750
FBgn0036000	777	750	700	104	9	11.555555555555555	673
FBgn0036004	750	750	750	0	0	NA	750
FBgn0036009	760	750	753	17	5	3.4	743
FBgn0036010	752	750	737	17	5	3.4	735
FBgn0036015	755	750	753	7	3	2.3333333333333335	748
FBgn0036018	779	750	747	61	10	6.1	718
FBgn0036019	773	750	565	231	6	38.5	542
FBgn0036020	760	750	756	14	2	7	746
FBgn0036022	766	750	759	23	3	7.666666666666667	743
FBgn0036024	760	750	714	56	7	8	704
FBgn0036028	756	750	750	12	6	2	744
FBgn0036035	763	750	759	17	4	4.25	746
FBgn0036036	763	750	758	18	5	3.6	745
FBgn0036038	763	750	718	58	7	8.285714285714286	705
FBgn0036040	755	750	738	22	7	3.142857142857143	733
FBgn0036043	757	750	733	31	10	3.1	726
FBgn0036044	779	750	751	57	9	6.333333333333333	722
FBgn0036052	790	750	785	45	7	6.428571428571429	745
FBgn0036053	765	750	677	103	6	17.166666666666668	662
FBgn0036058	752	750	744	10	4	2.5	742
FBgn0036062	751	750	623	129	4	32.25	622
FBgn0036063	751	750	734	18	4	4.5	733
FBgn0036066	788	750	779	47	8	5.875	741
FBgn0036070	762	750	727	47	4	11.75	715
FBgn0036075	770	750	756	34	7	4.857142857142857	736
FBgn0036078	773	750	773	23	5	4.6	750
FBgn0036080	757	750	746	18	4	4.5	739
FBgn0036082	766	750	753	29	5	5.8	737
FBgn0036085	760	750	741	29	7	4.142857142857143	731
FBgn0036089	776	733	766	53	10	5.3	723
FBgn0036090	769	750	729	59	8	7.375	710
FBgn0036093	750	750	720	30	5	6	720
FBgn0036094	660	650	657	13	4	3.25	647
FBgn0036096	843	750	802	134	17	7.882352941176471	709
FBgn0036099	803	750	739	117	9	13	686
FBgn0036101	797	750	720	124	14	8.857142857142858	673
FBgn0036102	753	750	732	24	7	3.4285714285714284	729
FBgn0036104	750	750	730	20	2	10	730
FBgn0036105	750	750	737	13	2	6.5	737
FBgn0036106	761	750	753	19	7	2.7142857142857144	742
FBgn0036107	761	750	752	20	6	3.3333333333333335	741
FBgn0036108	784	750	756	62	11	5.636363636363637	722
FBgn0036110	767	750	690	94	7	13.428571428571429	673
FBgn0036111	819	750	785	103	11	9.363636363636363	716
FBgn0036112	753	750	725	31	6	5.166666666666667	722
FBgn0036116	761	750	711	61	14	4.357142857142857	700
FBgn0036117	773	750	769	27	6	4.5	746
FBgn0036118	777	750	773	31	7	4.428571428571429	746
FBgn0036121	835	750	795	125	19	6.578947368421052	710
FBgn0036126	756	750	749	13	3	4.333333333333333	743
FBgn0036133	777	750	765	39	5	7.8	738
FBgn0036134	764	750	734	44	4	11	720
FBgn0036135	750	750	747	3	2	1.5	747
FBgn0036136	765	750	744	36	12	3	729
FBgn0036138	751	750	732	20	9	2.2222222222222223	731
FBgn0036139	758	750	720	46	11	4.181818181818182	712
FBgn0036141	761	750	745	27	6	4.5	734
FBgn0036142	752	750	752	2	1	2	750
FBgn0036143	750	750	704	46	4	11.5	704
FBgn0036144	760	750	724	46	8	5.75	714
FBgn0036145	758	750	736	30	5	6	728
FBgn0036146	782	750	770	44	10	4.4	738
FBgn0036147	786	750	746	76	12	6.333333333333333	710
FBgn0036152	778	750	768	38	8	4.75	740
FBgn0036153	790	750	776	54	8	6.75	736
FBgn0036154	780	750	723	87	12	7.25	693
FBgn0036155	750	750	748	2	1	2	748
FBgn0036156	757	750	728	36	8	4.5	721
FBgn0036157	819	750	798	90	8	11.25	729
FBgn0036158	769	750	719	69	10	6.9	700
FBgn0036159	764	750	646	132	10	13.2	632
FBgn0036160	750	750	748	2	2	1	748
FBgn0036161	754	750	752	6	3	2	748
FBgn0036162	759	750	744	24	8	3	735
FBgn0036165	771	750	710	82	13	6.3076923076923075	689
FBgn0036173	763	750	757	19	10	1.9	744
FBgn0036176	774	750	641	157	10	15.7	617
FBgn0036177	783	750	761	55	8	6.875	728
FBgn0036179	751	750	745	7	2	3.5	744
FBgn0036180	786	750	758	64	13	4.923076923076923	722
FBgn0036181	564	564	564	0	0	NA	564
FBgn0036187	751	750	723	29	5	5.8	722
FBgn0036188	754	750	726	32	6	5.333333333333333	722
FBgn0036192	750	750	747	3	3	1	747
FBgn0036193	760	750	748	22	7	3.142857142857143	738
FBgn0036195	750	750	711	39	5	7.8	711
FBgn0036196	775	750	747	53	11	4.818181818181818	722
FBgn0036198	759	750	729	39	8	4.875	720
FBgn0036199	770	750	767	23	4	5.75	747
FBgn0036202	755	750	682	78	6	13	677
FBgn0036203	788	750	736	90	8	11.25	698
FBgn0036204	773	750	695	101	7	14.428571428571429	672
FBgn0036205	779	750	779	29	3	9.666666666666666	750
FBgn0036206	772	750	754	40	6	6.666666666666667	732
FBgn0036207	773	750	752	44	8	5.5	729
FBgn0036208	625	609	591	50	10	5	575
FBgn0036214	758	750	707	59	8	7.375	699
FBgn0036218	760	750	681	89	6	14.833333333333334	671
FBgn0036221	764	750	710	68	9	7.555555555555555	696
FBgn0036224	777	750	770	34	7	4.857142857142857	743
FBgn0036225	818	750	780	106	13	8.153846153846153	712
FBgn0036226	767	750	743	41	6	6.833333333333333	726
FBgn0036227	632	632	551	81	7	11.571428571428571	551
FBgn0036228	762	750	749	25	5	5	737
FBgn0036229	762	750	753	21	4	5.25	741
FBgn0036230	754	750	729	29	7	4.142857142857143	725
FBgn0036235	766	750	734	48	13	3.6923076923076925	718
FBgn0036237	586	573	546	53	9	5.888888888888889	533
FBgn0036239	785	750	784	36	4	9	749
FBgn0036240	797	750	778	66	8	8.25	731
FBgn0036242	768	750	747	39	8	4.875	729
FBgn0036246	808	750	757	109	12	9.083333333333334	699
FBgn0036250	774	750	739	59	12	4.916666666666667	715
FBgn0036254	761	750	755	17	5	3.4	744
FBgn0036255	761	750	759	13	3	4.333333333333333	748
FBgn0036257	751	750	722	30	5	6	721
FBgn0036258	755	750	751	9	5	1.8	746
FBgn0036259	769	750	763	25	9	2.7777777777777777	744
FBgn0036260	753	750	698	58	7	8.285714285714286	695
FBgn0036262	756	750	739	23	7	3.2857142857142856	733
FBgn0036263	758	750	732	34	5	6.8	724
FBgn0036264	767	750	749	35	7	5	732
FBgn0036266	784	750	756	62	5	12.4	722
FBgn0036271	764	750	758	20	7	2.857142857142857	744
FBgn0036272	797	750	757	87	15	5.8	710
FBgn0036273	796	750	757	85	13	6.538461538461538	711
FBgn0036274	765	750	760	20	5	4	745
FBgn0036278	756	750	754	8	4	2	748
FBgn0036279	796	750	794	48	7	6.857142857142857	748
FBgn0036282	756	750	740	22	7	3.142857142857143	734
FBgn0036285	766	750	694	88	9	9.777777777777779	678
FBgn0036286	809	750	790	78	13	6	731
FBgn0036289	769	750	750	38	6	6.333333333333333	731
FBgn0036290	781	750	775	37	9	4.111111111111111	744
FBgn0036291	755	750	626	134	4	33.5	621
FBgn0036292	754	750	738	20	9	2.2222222222222223	734
FBgn0036294	524	516	486	46	7	6.571428571428571	478
FBgn0036298	578	576	565	15	4	3.75	563
FBgn0036299	758	750	746	20	6	3.3333333333333335	738
FBgn0036301	757	750	723	41	13	3.1538461538461537	716
FBgn0036302	794	750	782	56	12	4.666666666666667	738
FBgn0036305	796	750	777	65	7	9.285714285714286	731
FBgn0036306	759	750	754	14	2	7	745
FBgn0036310	754	750	744	14	4	3.5	740
FBgn0036311	754	750	749	9	3	3	745
FBgn0036314	760	750	735	35	7	5	725
FBgn0036316	755	750	746	14	6	2.3333333333333335	741
FBgn0036317	750	750	724	26	2	13	724
FBgn0036318	750	750	746	4	2	2	746
FBgn0036319	773	750	721	75	8	9.375	698
FBgn0036320	751	750	733	19	4	4.75	732
FBgn0036321	801	750	783	69	6	11.5	732
FBgn0036325	750	750	735	15	2	7.5	735
FBgn0036327	751	750	750	2	2	1	749
FBgn0036328	751	750	747	5	3	1.6666666666666667	746
FBgn0036331	597	575	570	49	10	4.9	548
FBgn0036333	756	750	683	79	9	8.777777777777779	677
FBgn0036334	756	750	686	76	8	9.5	680
FBgn0036336	755	750	734	26	7	3.7142857142857144	729
FBgn0036340	723	719	699	28	9	3.111111111111111	695
FBgn0036341	643	606	629	51	10	5.1	592
FBgn0036342	587	581	583	10	2	5	577
FBgn0036343	757	750	755	9	4	2.25	748
FBgn0036345	751	750	735	17	5	3.4	734
FBgn0036346	776	750	739	63	9	7	713
FBgn0036348	769	750	724	64	11	5.818181818181818	705
FBgn0036350	779	750	773	35	7	5	744
FBgn0036351	753	750	729	27	3	9	726
FBgn0036352	791	750	745	87	16	5.4375	704
FBgn0036353	780	722	761	77	14	5.5	703
FBgn0036354	774	750	743	55	11	5	719
FBgn0036356	750	750	485	265	2	132.5	485
FBgn0036359	770	750	577	213	11	19.363636363636363	557
FBgn0036360	661	624	613	85	8	10.625	576
FBgn0036361	759	750	729	39	8	4.875	720
FBgn0036362	759	750	729	39	8	4.875	720
FBgn0036363	752	750	742	12	5	2.4	740
FBgn0036364	752	750	751	3	2	1.5	749
FBgn0036367	755	750	755	5	2	2.5	750
FBgn0036369	839	750	805	123	10	12.3	716
FBgn0036372	794	750	770	68	10	6.8	726
FBgn0036373	793	750	769	67	9	7.444444444444445	726
FBgn0036374	651	651	642	9	3	3	642
FBgn0036376	750	750	731	19	3	6.333333333333333	731
FBgn0036377	765	750	763	17	4	4.25	748
FBgn0036381	847	750	814	130	5	26	717
FBgn0036382	768	750	709	77	9	8.555555555555555	691
FBgn0036386	797	750	744	100	10	10	697
FBgn0036390	775	750	718	82	10	8.2	693
FBgn0036391	791	750	742	90	14	6.428571428571429	701
FBgn0036393	765	750	760	20	6	3.3333333333333335	745
FBgn0036394	773	750	747	49	10	4.9	724
FBgn0036395	745	720	654	116	11	10.545454545454545	629
FBgn0036397	755	750	738	22	8	2.75	733
FBgn0036402	776	750	771	31	3	10.333333333333334	745
FBgn0036403	751	750	619	133	3	44.333333333333336	618
FBgn0036411	757	750	741	23	7	3.2857142857142856	734
FBgn0036414	754	750	413	345	5	69	409
FBgn0036416	751	750	750	2	2	1	749
FBgn0036417	750	750	717	33	3	11	717
FBgn0036421	751	750	716	36	5	7.2	715
FBgn0036422	852	750	793	161	13	12.384615384615385	691
FBgn0036423	760	750	733	37	11	3.3636363636363638	723
FBgn0036426	757	750	751	13	3	4.333333333333333	744
FBgn0036428	784	750	746	72	10	7.2	712
FBgn0036433	760	750	756	14	6	2.3333333333333335	746
FBgn0036436	767	750	726	58	7	8.285714285714286	709
FBgn0036443	766	750	317	465	4	116.25	301
FBgn0036446	757	750	753	11	3	3.6666666666666665	746
FBgn0036448	790	750	780	50	9	5.555555555555555	740
FBgn0036449	750	750	504	246	1	246	504
FBgn0036450	804	750	617	241	5	48.2	563
FBgn0036454	770	750	733	57	13	4.384615384615385	713
FBgn0036459	770	750	704	86	7	12.285714285714286	684
FBgn0036462	766	750	750	32	7	4.571428571428571	734
FBgn0036470	761	750	756	16	7	2.2857142857142856	745
FBgn0036481	751	750	696	56	9	6.222222222222222	695
FBgn0036483	761	750	719	53	8	6.625	708
FBgn0036486	789	750	777	51	6	8.5	738
FBgn0036487	789	750	778	50	6	8.333333333333334	739
FBgn0036488	759	750	753	15	7	2.142857142857143	744
FBgn0036489	785	750	760	60	10	6	725
FBgn0036490	756	750	756	6	3	2	750
FBgn0036492	750	750	727	23	4	5.75	727
FBgn0036493	774	750	765	33	8	4.125	741
FBgn0036494	520	520	519	1	1	1	519
FBgn0036495	755	750	749	11	4	2.75	744
FBgn0036497	775	750	669	131	6	21.833333333333332	644
FBgn0036498	763	750	719	57	11	5.181818181818182	706
FBgn0036502	790	750	787	43	6	7.166666666666667	747
FBgn0036503	770	750	720	70	10	7	700
FBgn0036504	757	750	741	23	7	3.2857142857142856	734
FBgn0036509	751	750	732	20	4	5	731
FBgn0036510	751	750	732	20	6	3.3333333333333335	731
FBgn0036512	750	750	494	256	4	64	494
FBgn0036514	760	750	752	18	4	4.5	742
FBgn0036516	766	750	709	73	13	5.615384615384615	693
FBgn0036518	765	750	709	71	12	5.916666666666667	694
FBgn0036522	751	750	746	6	4	1.5	745
FBgn0036527	773	750	750	46	8	5.75	727
FBgn0036528	760	750	754	16	4	4	744
FBgn0036529	760	750	757	13	4	3.25	747
FBgn0036531	755	750	697	63	4	15.75	692
FBgn0036532	790	750	787	43	6	7.166666666666667	747
FBgn0036534	764	750	758	20	6	3.3333333333333335	744
FBgn0036536	776	750	727	75	13	5.769230769230769	701
FBgn0036537	763	750	761	15	8	1.875	748
FBgn0036538	765	750	741	39	6	6.5	726
FBgn0036544	813	750	757	119	9	13.222222222222221	694
FBgn0036545	760	750	748	22	13	1.6923076923076923	738
FBgn0036547	757	750	730	34	6	5.666666666666667	723
FBgn0036549	773	750	772	24	4	6	749
FBgn0036550	787	750	773	51	5	10.2	736
FBgn0036556	756	750	744	18	6	3	738
FBgn0036557	756	750	741	21	8	2.625	735
FBgn0036560	681	631	621	110	9	12.222222222222221	571
FBgn0036563	553	518	510	78	6	13	475
FBgn0036565	754	750	728	30	4	7.5	724
FBgn0036566	750	750	749	1	1	1	749
FBgn0036567	816	750	812	70	9	7.777777777777778	746
FBgn0036568	802	750	799	55	6	9.166666666666666	747
FBgn0036570	758	750	752	14	4	3.5	744
FBgn0036571	758	750	727	39	2	19.5	719
FBgn0036574	782	750	771	43	13	3.3076923076923075	739
FBgn0036575	756	750	755	7	2	3.5	749
FBgn0036577	755	750	734	26	6	4.333333333333333	729
FBgn0036579	769	750	758	30	4	7.5	739
FBgn0036580	752	750	748	6	3	2	746
FBgn0036581	760	750	759	11	2	5.5	749
FBgn0036583	773	750	582	214	10	21.4	559
FBgn0036584	754	750	722	36	4	9	718
FBgn0036585	776	750	773	29	6	4.833333333333333	747
FBgn0036587	766	750	764	18	5	3.6	748
FBgn0036588	750	750	747	3	1	3	747
FBgn0036589	753	750	747	9	3	3	744
FBgn0036590	801	750	765	87	13	6.6923076923076925	714
FBgn0036591	762	750	736	38	5	7.6	724
FBgn0036592	762	750	751	23	6	3.8333333333333335	739
FBgn0036593	764	750	745	33	9	3.6666666666666665	731
FBgn0036594	764	750	735	43	7	6.142857142857143	721
FBgn0036595	754	750	746	12	5	2.4	742
FBgn0036596	774	750	746	52	11	4.7272727272727275	722
FBgn0036597	760	750	757	13	4	3.25	747
FBgn0036598	763	750	742	34	6	5.666666666666667	729
FBgn0036600	756	750	739	23	5	4.6	733
FBgn0036601	756	750	739	23	5	4.6	733
FBgn0036602	751	750	738	14	7	2	737
FBgn0036607	750	750	717	33	2	16.5	717
FBgn0036609	572	554	528	62	7	8.857142857142858	510
FBgn0036612	767	750	755	29	7	4.142857142857143	738
FBgn0036614	750	750	750	0	0	NA	750
FBgn0036617	799	750	787	61	9	6.777777777777778	738
FBgn0036618	765	750	731	49	8	6.125	716
FBgn0036619	798	750	766	80	11	7.2727272727272725	718
FBgn0036620	808	750	779	87	14	6.214285714285714	721
FBgn0036623	766	750	756	26	9	2.888888888888889	740
FBgn0036624	784	750	774	44	10	4.4	740
FBgn0036639	762	750	756	18	7	2.5714285714285716	744
FBgn0036652	766	750	761	21	3	7	745
FBgn0036654	770	750	731	59	9	6.555555555555555	711
FBgn0036655	752	750	739	15	7	2.142857142857143	737
FBgn0036656	750	750	746	4	1	4	746
FBgn0036661	751	750	717	35	5	7	716
FBgn0036663	771	750	718	74	15	4.933333333333334	697
FBgn0036665	755	750	720	40	8	5	715
FBgn0036667	786	750	554	268	4	67	518
FBgn0036668	750	750	428	322	1	322	428
FBgn0036671	770	750	767	23	4	5.75	747
FBgn0036676	790	750	761	69	15	4.6	721
FBgn0036677	764	750	754	24	2	12	740
FBgn0036678	750	750	750	0	0	NA	750
FBgn0036680	762	750	757	17	4	4.25	745
FBgn0036681	751	750	750	2	2	1	749
FBgn0036684	766	750	728	54	6	9	712
FBgn0036685	856	750	837	125	8	15.625	731
FBgn0036686	755	750	561	199	3	66.33333333333333	556
FBgn0036688	799	750	770	78	11	7.090909090909091	721
FBgn0036689	714	709	659	60	8	7.5	654
FBgn0036695	752	750	718	36	4	9	716
FBgn0036696	780	750	728	82	8	10.25	698
FBgn0036697	791	750	726	106	14	7.571428571428571	685
FBgn0036698	750	750	748	2	2	1	748
FBgn0036704	767	750	761	23	9	2.5555555555555554	744
FBgn0036706	760	750	760	10	4	2.5	750
FBgn0036707	759	750	739	29	4	7.25	730
FBgn0036708	780	750	780	30	3	10	750
FBgn0036709	753	750	750	6	4	1.5	747
FBgn0036711	760	750	712	58	6	9.666666666666666	702
FBgn0036712	721	721	697	24	1	24	697
FBgn0036713	756	750	754	8	3	2.6666666666666665	748
FBgn0036714	780	750	778	32	3	10.666666666666666	748
FBgn0036715	713	642	693	91	9	10.11111111111111	622
FBgn0036716	750	750	730	20	6	3.3333333333333335	730
FBgn0036717	751	750	747	5	2	2.5	746
FBgn0036723	750	750	750	0	0	NA	750
FBgn0036725	757	750	749	15	5	3	742
FBgn0036727	847	750	824	120	11	10.909090909090908	727
FBgn0036730	750	750	655	95	2	47.5	655
FBgn0036731	777	750	750	54	10	5.4	723
FBgn0036732	774	750	749	49	7	7	725
FBgn0036733	822	750	813	81	10	8.1	741
FBgn0036734	822	750	813	81	10	8.1	741
FBgn0036738	770	750	736	54	5	10.8	716
FBgn0036740	761	750	724	48	3	16	713
FBgn0036742	778	750	543	263	11	23.90909090909091	515
FBgn0036745	753	750	704	52	6	8.666666666666666	701
FBgn0036746	807	750	796	68	11	6.181818181818182	739
FBgn0036747	762	750	707	67	5	13.4	695
FBgn0036750	837	750	826	98	10	9.8	739
FBgn0036751	766	750	754	28	5	5.6	738
FBgn0036756	751	750	740	12	3	4	739
FBgn0036760	711	709	700	13	5	2.6	698
FBgn0036761	752	750	716	38	8	4.75	714
FBgn0036762	752	750	720	34	7	4.857142857142857	718
FBgn0036763	635	581	619	70	10	7	565
FBgn0036764	768	750	718	68	12	5.666666666666667	700
FBgn0036766	791	750	723	109	15	7.266666666666667	682
FBgn0036768	751	750	673	79	8	9.875	672
FBgn0036769	766	750	683	99	10	9.9	667
FBgn0036770	751	750	736	16	5	3.2	735
FBgn0036771	751	750	741	11	5	2.2	740
FBgn0036772	765	750	765	15	3	5	750
FBgn0036773	763	750	739	37	8	4.625	726
FBgn0036774	761	750	740	32	6	5.333333333333333	729
FBgn0036775	794	750	760	78	5	15.6	716
FBgn0036778	763	750	696	80	10	8	683
FBgn0036780	771	750	728	64	14	4.571428571428571	707
FBgn0036781	772	750	697	97	10	9.7	675
FBgn0036782	781	750	758	54	13	4.153846153846154	727
FBgn0036783	800	750	793	57	8	7.125	743
FBgn0036784	752	750	545	209	5	41.8	543
FBgn0036785	751	750	750	2	2	1	749
FBgn0036786	782	750	732	82	10	8.2	700
FBgn0036789	752	750	724	30	5	6	722
FBgn0036790	792	750	779	55	12	4.583333333333333	737
FBgn0036791	758	750	746	20	6	3.3333333333333335	738
FBgn0036801	801	750	575	277	10	27.7	524
FBgn0036804	750	750	480	270	4	67.5	480
FBgn0036806	809	750	798	70	8	8.75	739
FBgn0036807	750	750	671	79	6	13.166666666666666	671
FBgn0036809	766	750	639	143	9	15.88888888888889	623
FBgn0036810	783	750	747	69	13	5.3076923076923075	714
FBgn0036812	766	750	757	25	5	5	741
FBgn0036813	755	750	750	10	4	2.5	745
FBgn0036814	752	750	748	6	4	1.5	746
FBgn0036815	753	750	753	3	3	1	750
FBgn0036816	761	750	572	200	11	18.181818181818183	561
FBgn0036817	770	750	740	50	6	8.333333333333334	720
FBgn0036822	764	750	747	31	10	3.1	733
FBgn0036826	750	750	750	0	0	NA	750
FBgn0036827	771	750	765	27	3	9	744
FBgn0036828	751	750	342	410	5	82	341
FBgn0036830	760	750	728	42	5	8.4	718
FBgn0036831	758	750	729	37	6	6.166666666666667	721
FBgn0036833	761	750	751	21	6	3.5	740
FBgn0036834	788	750	781	45	9	5	743
FBgn0036835	750	750	749	1	1	1	749
FBgn0036836	574	574	564	10	2	5	564
FBgn0036839	752	750	713	41	5	8.2	711
FBgn0036842	811	750	807	65	9	7.222222222222222	746
FBgn0036843	811	750	800	72	13	5.538461538461538	739
FBgn0036844	755	750	743	17	6	2.8333333333333335	738
FBgn0036848	805	750	791	69	12	5.75	736
FBgn0036849	777	750	719	85	10	8.5	692
FBgn0036850	794	750	761	77	14	5.5	717
FBgn0036851	750	750	741	9	2	4.5	741
FBgn0036853	843	750	835	101	9	11.222222222222221	742
FBgn0036857	769	750	744	44	5	8.8	725
FBgn0036858	750	750	228	522	1	522	228
FBgn0036859	765	750	740	40	4	10	725
FBgn0036860	755	750	732	28	8	3.5	727
FBgn0036861	769	750	733	55	8	6.875	714
FBgn0036868	776	750	756	46	9	5.111111111111111	730
FBgn0036870	752	750	696	58	5	11.6	694
FBgn0036875	798	750	794	52	5	10.4	746
FBgn0036877	762	750	731	43	10	4.3	719
FBgn0036878	758	750	737	29	4	7.25	729
FBgn0036879	752	750	721	33	5	6.6	719
FBgn0036880	667	653	636	45	7	6.428571428571429	622
FBgn0036881	757	750	717	47	6	7.833333333333333	710
FBgn0036886	750	750	750	0	0	NA	750
FBgn0036887	752	750	741	13	5	2.6	739
FBgn0036888	753	750	742	14	6	2.3333333333333335	739
FBgn0036889	756	750	751	11	7	1.5714285714285714	745
FBgn0036891	767	750	736	48	10	4.8	719
FBgn0036893	750	750	549	201	1	201	549
FBgn0036895	706	666	614	132	14	9.428571428571429	574
FBgn0036896	785	750	741	79	14	5.642857142857143	706
FBgn0036897	808	750	784	82	14	5.857142857142857	726
FBgn0036899	780	750	749	61	9	6.777777777777778	719
FBgn0036900	759	750	521	247	4	61.75	512
FBgn0036906	752	750	740	14	4	3.5	738
FBgn0036909	751	750	749	3	2	1.5	748
FBgn0036910	654	649	651	8	3	2.6666666666666665	646
FBgn0036911	762	750	756	18	2	9	744
FBgn0036913	750	750	747	3	1	3	747
FBgn0036918	750	750	750	0	0	NA	750
FBgn0036919	581	572	548	42	10	4.2	539
FBgn0036920	768	750	757	29	6	4.833333333333333	739
FBgn0036921	760	750	750	20	6	3.3333333333333335	740
FBgn0036922	750	750	187	563	1	563	187
FBgn0036923	754	750	673	85	7	12.142857142857142	669
FBgn0036924	765	750	763	17	4	4.25	748
FBgn0036925	765	750	763	17	4	4.25	748
FBgn0036927	761	750	737	35	7	5	726
FBgn0036928	754	750	743	15	9	1.6666666666666667	739
FBgn0036929	587	576	575	23	4	5.75	564
FBgn0036932	783	750	755	61	6	10.166666666666666	722
FBgn0036934	809	750	803	65	8	8.125	744
FBgn0036935	764	750	738	40	6	6.666666666666667	724
FBgn0036936	551	549	295	258	7	36.857142857142854	293
FBgn0036937	769	750	752	36	7	5.142857142857143	733
FBgn0036938	821	750	812	80	12	6.666666666666667	741
FBgn0036939	754	750	748	10	2	5	744
FBgn0036941	752	750	713	41	2	20.5	711
FBgn0036942	817	750	798	86	10	8.6	731
FBgn0036945	769	750	754	34	11	3.090909090909091	735
FBgn0036947	584	559	554	55	7	7.857142857142857	529
FBgn0036948	770	750	736	54	4	13.5	716
FBgn0036949	780	750	740	70	13	5.384615384615385	710
FBgn0036950	754	750	677	81	11	7.363636363636363	673
FBgn0036952	816	750	776	106	13	8.153846153846153	710
FBgn0036953	847	750	835	109	10	10.9	738
FBgn0036973	755	750	751	9	6	1.5	746
FBgn0036974	755	750	752	8	5	1.6	747
FBgn0036978	761	750	729	43	7	6.142857142857143	718
FBgn0036980	765	750	741	39	6	6.5	726
FBgn0036984	756	750	733	29	8	3.625	727
FBgn0036985	771	750	702	90	7	12.857142857142858	681
FBgn0036987	726	686	696	70	6	11.666666666666666	656
FBgn0036990	750	750	701	49	3	16.333333333333332	701
FBgn0036991	750	750	735	15	1	15	735
FBgn0036992	761	750	759	13	5	2.6	748
FBgn0036993	787	750	769	55	8	6.875	732
FBgn0036994	802	750	767	87	14	6.214285714285714	715
FBgn0036996	765	750	728	52	9	5.777777777777778	713
FBgn0036997	776	750	749	53	9	5.888888888888889	723
FBgn0036998	867	750	857	127	9	14.11111111111111	740
FBgn0037000	752	750	743	11	5	2.2	741
FBgn0037001	761	750	705	67	7	9.571428571428571	694
FBgn0037009	769	750	739	49	5	9.8	720
FBgn0037011	785	750	782	38	8	4.75	747
FBgn0037012	768	750	725	61	7	8.714285714285714	707
FBgn0037013	794	750	752	86	11	7.818181818181818	708
FBgn0037014	793	750	789	47	8	5.875	746
FBgn0037015	818	750	804	82	10	8.2	736
FBgn0037016	757	750	726	38	5	7.6	719
FBgn0037017	702	702	693	9	4	2.25	693
FBgn0037018	822	750	712	182	8	22.75	640
FBgn0037019	786	750	726	96	10	9.6	690
FBgn0037020	786	750	732	90	9	10	696
FBgn0037023	750	750	746	4	2	2	746
FBgn0037024	750	750	746	4	2	2	746
FBgn0037026	750	750	746	4	2	2	746
FBgn0037027	750	750	746	4	2	2	746
FBgn0037028	775	750	771	29	5	5.8	746
FBgn0037030	754	750	750	8	3	2.6666666666666665	746
FBgn0037031	765	750	647	133	6	22.166666666666668	632
FBgn0037035	751	750	745	7	2	3.5	744
FBgn0037036	777	750	771	33	5	6.6	744
FBgn0037037	752	750	726	28	3	9.333333333333334	724
FBgn0037042	819	750	806	82	17	4.823529411764706	737
FBgn0037044	757	750	724	40	5	8	717
FBgn0037045	793	750	754	82	12	6.833333333333333	711
FBgn0037046	793	750	779	57	13	4.384615384615385	736
FBgn0037050	754	750	745	13	5	2.6	741
FBgn0037051	764	750	759	19	6	3.1666666666666665	745
FBgn0037057	768	750	758	28	9	3.111111111111111	740
FBgn0037059	759	750	759	9	2	4.5	750
FBgn0037060	779	750	755	53	7	7.571428571428571	726
FBgn0037061	758	750	713	53	4	13.25	705
FBgn0037064	754	750	747	11	6	1.8333333333333333	743
FBgn0037065	750	750	749	1	1	1	749
FBgn0037067	751	750	742	10	3	3.3333333333333335	741
FBgn0037069	781	750	762	50	8	6.25	731
FBgn0037070	750	750	745	5	1	5	745
FBgn0037071	569	561	538	39	8	4.875	530
FBgn0037073	752	750	752	2	1	2	750
FBgn0037074	752	750	733	21	3	7	731
FBgn0037076	771	750	731	61	5	12.2	710
FBgn0037078	750	750	476	274	4	68.5	476
FBgn0037081	758	750	749	17	6	2.8333333333333335	741
FBgn0037084	752	750	728	26	6	4.333333333333333	726
FBgn0037085	756	750	360	402	4	100.5	354
FBgn0037086	769	750	766	22	6	3.6666666666666665	747
FBgn0037087	769	750	690	98	12	8.166666666666666	671
FBgn0037090	808	750	738	128	8	16	680
FBgn0037092	807	750	802	62	7	8.857142857142858	745
FBgn0037093	764	750	738	40	12	3.3333333333333335	724
FBgn0037094	782	750	777	37	9	4.111111111111111	745
FBgn0037098	783	722	775	69	9	7.666666666666667	714
FBgn0037099	767	750	740	44	5	8.8	723
FBgn0037100	774	750	743	55	12	4.583333333333333	719
FBgn0037101	767	750	767	17	4	4.25	750
FBgn0037102	761	750	746	26	5	5.2	735
FBgn0037105	750	750	734	16	6	2.6666666666666665	734
FBgn0037106	776	750	765	37	6	6.166666666666667	739
FBgn0037107	751	750	723	29	6	4.833333333333333	722
FBgn0037108	751	750	726	26	6	4.333333333333333	725
FBgn0037109	833	750	617	299	14	21.357142857142858	534
FBgn0037110	814	750	453	425	11	38.63636363636363	389
FBgn0037114	762	750	762	12	1	12	750
FBgn0037115	820	750	629	261	18	14.5	559
FBgn0037116	768	750	733	53	11	4.818181818181818	715
FBgn0037120	751	750	746	6	2	3	745
FBgn0037121	769	750	751	37	7	5.285714285714286	732
FBgn0037124	763	750	754	22	4	5.5	741
FBgn0037125	763	750	754	22	4	5.5	741
FBgn0037126	814	750	718	160	8	20	654
FBgn0037127	755	750	739	21	6	3.5	734
FBgn0037128	754	750	733	25	7	3.5714285714285716	729
FBgn0037130	753	750	234	522	2	261	231
FBgn0037131	754	750	751	7	2	3.5	747
FBgn0037133	765	750	755	25	6	4.166666666666667	740
FBgn0037135	703	639	649	118	11	10.727272727272727	585
FBgn0037137	764	750	370	408	8	51	356
FBgn0037139	750	750	743	7	2	3.5	743
FBgn0037140	779	750	765	43	7	6.142857142857143	736
FBgn0037141	774	750	735	63	10	6.3	711
FBgn0037142	774	750	743	55	8	6.875	719
FBgn0037146	768	750	766	20	4	5	748
FBgn0037150	752	724	418	362	9	40.22222222222222	390
FBgn0037151	760	750	759	11	2	5.5	749
FBgn0037162	750	750	740	10	4	2.5	740
FBgn0037163	802	750	781	73	8	9.125	729
FBgn0037166	815	750	805	75	15	5	740
FBgn0037167	755	750	744	16	5	3.2	739
FBgn0037170	753	750	719	37	7	5.285714285714286	716
FBgn0037171	796	750	765	77	11	7	719
FBgn0037172	755	750	750	10	4	2.5	745
FBgn0037174	755	750	685	75	5	15	680
FBgn0037175	750	750	750	0	0	NA	750
FBgn0037176	750	750	750	0	0	NA	750
FBgn0037178	757	750	687	77	10	7.7	680
FBgn0037181	753	750	722	34	7	4.857142857142857	719
FBgn0037182	762	750	742	32	6	5.333333333333333	730
FBgn0037184	793	750	768	68	5	13.6	725
FBgn0037185	769	750	739	49	5	9.8	720
FBgn0037186	683	680	664	22	3	7.333333333333333	661
FBgn0037188	777	750	766	38	8	4.75	739
FBgn0037191	750	750	28	722	2	361	28
FBgn0037195	767	750	747	37	6	6.166666666666667	730
FBgn0037197	750	750	676	74	4	18.5	676
FBgn0037199	751	750	748	4	3	1.3333333333333333	747
FBgn0037202	755	750	755	5	3	1.6666666666666667	750
FBgn0037204	767	750	679	105	5	21	662
FBgn0037206	755	750	678	82	5	16.4	673
FBgn0037213	767	750	348	436	7	62.285714285714285	331
FBgn0037223	775	750	718	82	5	16.4	693
FBgn0037225	656	636	326	350	9	38.888888888888886	306
FBgn0037227	766	750	764	18	3	6	748
FBgn0037228	751	750	292	460	4	115	291
FBgn0037229	764	750	476	302	8	37.75	462
FBgn0037230	797	750	797	47	3	15.666666666666666	750
FBgn0037231	876	750	863	139	14	9.928571428571429	737
FBgn0037232	811	685	809	128	13	9.846153846153847	683
FBgn0037234	772	750	765	29	7	4.142857142857143	743
FBgn0037235	753	750	737	19	3	6.333333333333333	734
FBgn0037236	750	750	745	5	3	1.6666666666666667	745
FBgn0037242	753	750	322	434	3	144.66666666666666	319
FBgn0037244	763	750	738	38	7	5.428571428571429	725
FBgn0037249	799	728	668	202	6	33.666666666666664	597
FBgn0037250	752	750	752	2	1	2	750
FBgn0037251	756	750	744	18	2	9	738
FBgn0037260	768	750	764	22	7	3.142857142857143	746
FBgn0037261	758	750	732	34	4	8.5	724
FBgn0037265	745	710	724	56	8	7	689
FBgn0037275	753	750	697	59	10	5.9	694
FBgn0037276	780	750	739	71	13	5.461538461538462	709
FBgn0037279	789	750	762	66	13	5.076923076923077	723
FBgn0037280	630	630	354	276	3	92	354
FBgn0037282	770	750	693	97	10	9.7	673
FBgn0037288	781	750	758	54	7	7.714285714285714	727
FBgn0037290	772	750	743	51	6	8.5	721
FBgn0037292	754	750	745	13	3	4.333333333333333	741
FBgn0037295	752	750	687	67	11	6.090909090909091	685
FBgn0037296	764	750	763	15	3	5	749
FBgn0037297	757	750	378	386	7	55.142857142857146	371
FBgn0037299	750	750	91	659	1	659	91
FBgn0037301	776	750	757	45	11	4.090909090909091	731
FBgn0037305	775	750	757	43	6	7.166666666666667	732
FBgn0037307	779	750	726	82	13	6.3076923076923075	697
FBgn0037310	778	750	692	114	12	9.5	664
FBgn0037312	776	750	773	29	9	3.2222222222222223	747
FBgn0037313	772	750	768	26	9	2.888888888888889	746
FBgn0037315	750	750	126	624	2	312	126
FBgn0037322	755	750	754	6	3	2	749
FBgn0037323	750	750	733	17	3	5.666666666666667	733
FBgn0037324	751	750	699	53	7	7.571428571428571	698
FBgn0037325	754	750	719	39	8	4.875	715
FBgn0037327	802	750	764	90	19	4.7368421052631575	712
FBgn0037328	770	750	749	41	10	4.1	729
FBgn0037329	768	750	747	39	8	4.875	729
FBgn0037330	755	750	711	49	9	5.444444444444445	706
FBgn0037332	810	750	765	105	13	8.076923076923077	705
FBgn0037336	662	611	623	90	16	5.625	572
FBgn0037340	750	750	747	3	2	1.5	747
FBgn0037341	750	750	750	0	0	NA	750
FBgn0037342	759	750	751	17	6	2.8333333333333335	742
FBgn0037345	751	750	435	317	3	105.66666666666667	434
FBgn0037347	760	750	745	25	5	5	735
FBgn0037351	766	750	718	64	6	10.666666666666666	702
FBgn0037356	801	750	785	67	8	8.375	734
FBgn0037358	750	750	743	7	4	1.75	743
FBgn0037359	753	750	746	10	6	1.6666666666666667	743
FBgn0037363	755	750	695	65	6	10.833333333333334	690
FBgn0037364	793	750	763	73	10	7.3	720
FBgn0037369	759	750	704	64	7	9.142857142857142	695
FBgn0037370	768	750	710	76	9	8.444444444444445	692
FBgn0037371	760	750	756	14	3	4.666666666666667	746
FBgn0037375	750	750	732	18	4	4.5	732
FBgn0037376	758	750	758	8	1	8	750
FBgn0037378	751	750	751	1	1	1	750
FBgn0037379	751	750	745	7	4	1.75	744
FBgn0037382	810	750	780	90	12	7.5	720
FBgn0037383	778	750	778	28	3	9.333333333333334	750
FBgn0037384	750	750	750	0	0	NA	750
FBgn0037387	757	750	705	59	7	8.428571428571429	698
FBgn0037388	762	750	413	361	11	32.81818181818182	401
FBgn0037391	750	750	367	383	3	127.66666666666667	367
FBgn0037395	793	750	789	47	12	3.9166666666666665	746
FBgn0037396	827	750	814	90	13	6.923076923076923	737
FBgn0037397	813	750	791	85	14	6.071428571428571	728
FBgn0037398	771	750	731	61	9	6.777777777777778	710
FBgn0037399	767	750	485	299	5	59.8	468
FBgn0037402	754	750	751	7	2	3.5	747
FBgn0037406	778	750	749	57	4	14.25	721
FBgn0037408	755	750	524	236	7	33.714285714285715	519
FBgn0037409	770	750	750	40	10	4	730
FBgn0037410	753	750	753	3	1	3	750
FBgn0037411	750	750	746	4	2	2	746
FBgn0037412	779	750	733	75	10	7.5	704
FBgn0037413	815	750	809	71	4	17.75	744
FBgn0037414	761	750	727	45	5	9	716
FBgn0037415	752	750	748	6	5	1.2	746
FBgn0037416	752	750	711	43	3	14.333333333333334	709
FBgn0037419	754	750	693	65	8	8.125	689
FBgn0037420	751	750	725	27	8	3.375	724
FBgn0037421	813	750	792	84	8	10.5	729
FBgn0037422	779	750	727	81	7	11.571428571428571	698
FBgn0037424	764	750	762	16	3	5.333333333333333	748
FBgn0037427	754	750	360	398	3	132.66666666666666	356
FBgn0037428	791	750	779	53	4	13.25	738
FBgn0037429	760	750	567	203	4	50.75	557
FBgn0037430	827	750	800	104	7	14.857142857142858	723
FBgn0037435	776	750	765	37	6	6.166666666666667	739
FBgn0037436	800	750	770	80	5	16	720
FBgn0037439	781	750	712	100	12	8.333333333333334	681
FBgn0037440	753	750	586	170	5	34	583
FBgn0037443	795	750	745	95	13	7.3076923076923075	700
FBgn0037445	764	750	389	389	2	194.5	375
FBgn0037446	762	750	639	135	7	19.285714285714285	627
FBgn0037447	771	750	748	44	7	6.285714285714286	727
FBgn0037448	754	750	753	5	2	2.5	749
FBgn0037449	783	750	726	90	13	6.923076923076923	693
FBgn0037455	761	750	758	14	2	7	747
FBgn0037456	758	750	355	411	3	137	347
FBgn0037460	532	507	460	97	11	8.818181818181818	435
FBgn0037461	757	750	741	23	4	5.75	734
FBgn0037462	757	750	746	18	3	6	739
FBgn0037465	768	750	761	25	4	6.25	743
FBgn0037466	770	750	762	28	6	4.666666666666667	742
FBgn0037468	756	750	732	30	13	2.3076923076923075	726
FBgn0037470	751	750	747	5	4	1.25	746
FBgn0037472	780	750	762	48	6	8	732
FBgn0037473	755	750	355	405	7	57.857142857142854	350
FBgn0037475	750	750	746	4	1	4	746
FBgn0037477	794	750	772	66	10	6.6	728
FBgn0037481	751	750	734	18	5	3.6	733
FBgn0037482	768	750	762	24	6	4	744
FBgn0037483	764	750	764	14	2	7	750
FBgn0037486	764	750	750	28	6	4.666666666666667	736
FBgn0037487	759	750	625	143	2	71.5	616
FBgn0037488	750	750	735	15	2	7.5	735
FBgn0037489	759	750	748	20	5	4	739
FBgn0037490	751	750	729	23	2	11.5	728
FBgn0037491	750	750	749	1	1	1	749
FBgn0037492	756	750	752	10	4	2.5	746
FBgn0037498	755	750	195	565	3	188.33333333333334	190
FBgn0037500	779	750	760	48	7	6.857142857142857	731
FBgn0037501	823	750	770	126	15	8.4	697
FBgn0037503	760	750	754	16	3	5.333333333333333	744
FBgn0037512	769	750	760	28	8	3.5	741
FBgn0037513	800	750	746	104	10	10.4	696
FBgn0037514	757	750	718	46	10	4.6	711
FBgn0037516	750	750	734	16	5	3.2	734
FBgn0037517	759	750	756	12	3	4	747
FBgn0037518	767	750	384	400	5	80	367
FBgn0037520	750	750	722	28	5	5.6	722
FBgn0037521	759	750	722	46	10	4.6	713
FBgn0037525	773	750	772	24	5	4.8	749
FBgn0037526	754	750	747	11	3	3.6666666666666665	743
FBgn0037529	809	750	798	70	9	7.777777777777778	739
FBgn0037530	761	750	746	26	6	4.333333333333333	735
FBgn0037531	774	750	664	134	5	26.8	640
FBgn0037533	750	750	748	2	2	1	748
FBgn0037535	757	750	729	35	5	7	722
FBgn0037536	722	709	705	30	6	5	692
FBgn0037538	764	750	748	30	6	5	734
FBgn0037539	774	750	751	47	10	4.7	727
FBgn0037540	774	750	750	48	11	4.363636363636363	726
FBgn0037541	755	750	747	13	3	4.333333333333333	742
FBgn0037543	775	750	769	31	7	4.428571428571429	744
FBgn0037544	765	750	764	16	2	8	749
FBgn0037547	762	750	714	60	6	10	702
FBgn0037549	757	750	756	8	3	2.6666666666666665	749
FBgn0037550	791	750	777	55	5	11	736
FBgn0037551	758	750	743	23	3	7.666666666666667	735
FBgn0037552	782	750	767	47	12	3.9166666666666665	735
FBgn0037555	791	750	763	69	15	4.6	722
FBgn0037556	771	750	770	22	4	5.5	749
FBgn0037561	758	750	756	10	6	1.6666666666666667	748
FBgn0037563	792	750	731	103	13	7.923076923076923	689
FBgn0037565	758	750	711	55	8	6.875	703
FBgn0037566	758	750	711	55	8	6.875	703
FBgn0037571	750	750	741	9	1	9	741
FBgn0037572	750	750	720	30	3	10	720
FBgn0037574	758	750	743	23	5	4.6	735
FBgn0037576	816	750	759	123	9	13.666666666666666	693
FBgn0037577	777	750	735	69	8	8.625	708
FBgn0037578	760	750	757	13	5	2.6	747
FBgn0037579	757	750	753	11	4	2.75	746
FBgn0037584	758	750	673	93	5	18.6	665
FBgn0037591	776	750	759	43	4	10.75	733
FBgn0037594	755	750	754	6	3	2	749
FBgn0037602	750	750	747	3	2	1.5	747
FBgn0037603	750	750	750	0	0	NA	750
FBgn0037607	750	750	743	7	2	3.5	743
FBgn0037608	583	553	541	72	13	5.538461538461538	511
FBgn0037609	760	750	752	18	5	3.6	742
FBgn0037612	775	750	722	78	10	7.8	697
FBgn0037613	771	750	761	31	6	5.166666666666667	740
FBgn0037614	752	750	743	11	3	3.6666666666666665	741
FBgn0037616	753	750	741	15	4	3.75	738
FBgn0037618	778	750	751	55	9	6.111111111111111	723
FBgn0037621	753	750	724	32	7	4.571428571428571	721
FBgn0037622	754	750	721	37	10	3.7	717
FBgn0037623	752	750	723	31	2	15.5	721
FBgn0037624	751	750	747	5	3	1.6666666666666667	746
FBgn0037625	768	750	737	49	4	12.25	719
FBgn0037626	796	750	771	71	7	10.142857142857142	725
FBgn0037627	750	750	749	1	1	1	749
FBgn0037630	751	750	725	27	5	5.4	724
FBgn0037632	803	750	797	59	4	14.75	744
FBgn0037633	751	750	747	5	3	1.6666666666666667	746
FBgn0037635	777	750	768	36	10	3.6	741
FBgn0037637	750	750	732	18	5	3.6	732
FBgn0037638	763	750	745	31	6	5.166666666666667	732
FBgn0037643	755	750	732	28	6	4.666666666666667	727
FBgn0037644	799	750	795	53	7	7.571428571428571	746
FBgn0037647	777	750	768	36	6	6	741
FBgn0037648	750	750	748	2	1	2	748
FBgn0037650	780	750	749	61	10	6.1	719
FBgn0037652	764	750	761	17	4	4.25	747
FBgn0037653	750	750	714	36	6	6	714
FBgn0037656	752	750	752	2	2	1	750
FBgn0037657	803	750	800	56	6	9.333333333333334	747
FBgn0037659	793	746	778	62	8	7.75	731
FBgn0037660	750	750	750	0	0	NA	750
FBgn0037661	750	750	750	0	0	NA	750
FBgn0037662	828	750	819	87	13	6.6923076923076925	741
FBgn0037664	765	750	745	35	8	4.375	730
FBgn0037665	581	549	535	78	13	6	503
FBgn0037666	606	579	477	156	11	14.181818181818182	450
FBgn0037669	832	750	829	85	7	12.142857142857142	747
FBgn0037670	832	750	829	85	7	12.142857142857142	747
FBgn0037672	818	750	808	78	9	8.666666666666666	740
FBgn0037675	750	750	690	60	6	10	690
FBgn0037676	769	750	769	19	3	6.333333333333333	750
FBgn0037677	674	622	650	76	8	9.5	598
FBgn0037678	770	750	764	26	6	4.333333333333333	744
FBgn0037679	767	750	765	19	6	3.1666666666666665	748
FBgn0037680	769	750	760	28	9	3.111111111111111	741
FBgn0037683	770	750	756	34	8	4.25	736
FBgn0037685	755	750	743	17	4	4.25	738
FBgn0037686	768	750	768	18	3	6	750
FBgn0037687	773	750	770	26	5	5.2	747
FBgn0037688	760	750	754	16	5	3.2	744
FBgn0037690	755	750	752	8	6	1.3333333333333333	747
FBgn0037696	750	750	718	32	5	6.4	718
FBgn0037698	776	750	775	27	2	13.5	749
FBgn0037707	763	750	686	90	6	15	673
FBgn0037708	752	750	735	19	6	3.1666666666666665	733
FBgn0037709	752	750	734	20	7	2.857142857142857	732
FBgn0037710	760	750	757	13	4	3.25	747
FBgn0037715	750	750	738	12	3	4	738
FBgn0037716	778	750	743	63	10	6.3	715
FBgn0037718	765	750	756	24	4	6	741
FBgn0037719	773	750	749	47	8	5.875	726
FBgn0037720	769	750	760	28	4	7	741
FBgn0037721	751	750	743	9	3	3	742
FBgn0037722	751	750	738	14	5	2.8	737
FBgn0037723	750	750	746	4	2	2	746
FBgn0037724	750	750	748	2	2	1	748
FBgn0037727	842	750	829	105	10	10.5	737
FBgn0037736	752	750	693	61	6	10.166666666666666	691
FBgn0037737	755	750	704	56	8	7	699
FBgn0037739	750	750	741	9	3	3	741
FBgn0037742	753	750	751	5	2	2.5	748
FBgn0037743	750	750	747	3	2	1.5	747
FBgn0037747	750	750	746	4	1	4	746
FBgn0037753	786	750	782	40	7	5.714285714285714	746
FBgn0037754	754	750	718	40	7	5.714285714285714	714
FBgn0037755	759	750	752	16	6	2.6666666666666665	743
FBgn0037756	768	750	767	19	5	3.8	749
FBgn0037758	752	750	746	8	4	2	744
FBgn0037759	753	750	750	6	4	1.5	747
FBgn0037760	667	651	660	23	4	5.75	644
FBgn0037761	802	750	775	79	12	6.583333333333333	723
FBgn0037763	527	522	497	35	5	7	492
FBgn0037764	616	613	552	67	6	11.166666666666666	549
FBgn0037765	770	750	767	23	6	3.8333333333333335	747
FBgn0037766	756	750	517	245	6	40.833333333333336	511
FBgn0037770	767	750	754	30	5	6	737
FBgn0037772	750	750	734	16	3	5.333333333333333	734
FBgn0037773	757	750	715	49	5	9.8	708
FBgn0037777	757	750	755	9	3	3	748
FBgn0037778	750	750	750	0	0	NA	750
FBgn0037779	771	750	761	31	7	4.428571428571429	740
FBgn0037780	781	750	771	41	8	5.125	740
FBgn0037783	783	750	764	52	4	13	731
FBgn0037786	758	750	754	12	4	3	746
FBgn0037788	751	750	732	20	6	3.3333333333333335	731
FBgn0037794	655	653	635	22	8	2.75	633
FBgn0037796	786	750	764	58	7	8.285714285714286	728
FBgn0037797	763	750	748	28	5	5.6	735
FBgn0037798	750	750	740	10	2	5	740
FBgn0037802	754	750	749	9	4	2.25	745
FBgn0037807	784	750	779	39	7	5.571428571428571	745
FBgn0037809	752	750	726	28	7	4	724
FBgn0037810	536	515	525	32	6	5.333333333333333	504
FBgn0037814	751	750	744	8	3	2.6666666666666665	743
FBgn0037815	752	750	746	8	4	2	744
FBgn0037816	781	750	770	42	6	7	739
FBgn0037817	786	750	765	57	10	5.7	729
FBgn0037818	636	635	631	6	5	1.2	630
FBgn0037819	754	750	722	36	7	5.142857142857143	718
FBgn0037826	757	750	747	17	8	2.125	740
FBgn0037827	762	750	754	20	4	5	742
FBgn0037828	765	750	740	40	7	5.714285714285714	725
FBgn0037829	794	750	771	67	8	8.375	727
FBgn0037831	774	750	746	52	6	8.666666666666666	722
FBgn0037832	755	750	733	27	5	5.4	728
FBgn0037834	769	750	766	22	4	5.5	747
FBgn0037835	751	750	739	13	6	2.1666666666666665	738
FBgn0037837	750	750	749	1	1	1	749
FBgn0037838	750	750	735	15	2	7.5	735
FBgn0037841	761	750	675	97	7	13.857142857142858	664
FBgn0037842	764	750	760	18	4	4.5	746
FBgn0037843	750	750	750	0	0	NA	750
FBgn0037844	801	750	786	66	8	8.25	735
FBgn0037845	814	750	796	82	6	13.666666666666666	732
FBgn0037846	667	646	665	23	3	7.666666666666667	644
FBgn0037848	754	750	732	26	6	4.333333333333333	728
FBgn0037849	790	750	770	60	12	5	730
FBgn0037850	688	686	665	25	7	3.5714285714285716	663
FBgn0037855	750	750	749	1	1	1	749
FBgn0037857	750	750	724	26	4	6.5	724
FBgn0037860	751	750	737	15	3	5	736
FBgn0037862	768	750	766	20	4	5	748
FBgn0037870	781	750	745	67	9	7.444444444444445	714
FBgn0037874	768	750	762	24	6	4	744
FBgn0037875	818	750	800	86	15	5.733333333333333	732
FBgn0037876	779	750	775	33	3	11	746
FBgn0037878	753	750	629	127	5	25.4	626
FBgn0037879	771	750	432	360	8	45	411
FBgn0037882	754	750	746	12	6	2	742
FBgn0037883	789	750	787	41	2	20.5	748
FBgn0037884	786	750	633	189	7	27	597
FBgn0037885	758	750	741	25	6	4.166666666666667	733
FBgn0037890	750	750	744	6	5	1.2	744
FBgn0037891	754	750	748	10	6	1.6666666666666667	744
FBgn0037892	752	750	751	3	3	1	749
FBgn0037894	753	750	680	76	6	12.666666666666666	677
FBgn0037895	752	750	734	20	5	4	732
FBgn0037896	752	750	740	14	6	2.3333333333333335	738
FBgn0037897	763	750	755	21	7	3	742
FBgn0037898	528	521	525	10	5	2	518
FBgn0037899	756	750	756	6	3	2	750
FBgn0037900	750	750	749	1	1	1	749
FBgn0037901	751	750	746	6	4	1.5	745
FBgn0037902	764	750	761	17	4	4.25	747
FBgn0037906	754	750	737	21	5	4.2	733
FBgn0037908	761	750	758	14	3	4.666666666666667	747
FBgn0037910	796	750	785	57	10	5.7	739
FBgn0037911	753	750	715	41	2	20.5	712
FBgn0037915	750	750	689	61	1	61	689
FBgn0037916	750	750	699	51	2	25.5	699
FBgn0037918	782	750	748	66	9	7.333333333333333	716
FBgn0037920	750	750	736	14	4	3.5	736
FBgn0037922	761	750	751	21	7	3	740
FBgn0037923	770	750	769	21	3	7	749
FBgn0037926	755	750	742	18	6	3	737
FBgn0037930	756	750	732	30	7	4.285714285714286	726
FBgn0037933	751	750	742	10	5	2	741
FBgn0037937	762	750	612	162	8	20.25	600
FBgn0037939	767	750	767	17	5	3.4	750
FBgn0037940	755	750	732	28	3	9.333333333333334	727
FBgn0037941	750	750	724	26	4	6.5	724
FBgn0037942	768	750	760	26	6	4.333333333333333	742
FBgn0037943	761	750	752	20	3	6.666666666666667	741
FBgn0037944	750	750	742	8	3	2.6666666666666665	742
FBgn0037949	750	750	750	0	0	NA	750
FBgn0037950	774	750	774	24	6	4	750
FBgn0037955	756	750	742	20	3	6.666666666666667	736
FBgn0037956	779	750	764	44	9	4.888888888888889	735
FBgn0037958	752	750	745	9	3	3	743
FBgn0037960	755	750	718	42	7	6	713
FBgn0037962	759	750	758	10	2	5	749
FBgn0037963	792	750	789	45	6	7.5	747
FBgn0037964	754	750	734	24	8	3	730
FBgn0037970	518	518	515	3	1	3	515
FBgn0037976	778	750	748	58	3	19.333333333333332	720
FBgn0037978	759	750	711	57	4	14.25	702
FBgn0037979	759	750	698	70	5	14	689
FBgn0037980	750	750	698	52	2	26	698
FBgn0037981	778	750	754	52	7	7.428571428571429	726
FBgn0037985	759	750	728	40	9	4.444444444444445	719
FBgn0037986	762	750	761	13	3	4.333333333333333	749
FBgn0037987	758	750	749	17	4	4.25	741
FBgn0037989	767	750	760	24	5	4.8	743
FBgn0037992	825	750	809	91	8	11.375	734
FBgn0037993	754	750	739	19	4	4.75	735
FBgn0037994	805	750	803	57	5	11.4	748
FBgn0037995	752	750	732	22	4	5.5	730
FBgn0037996	756	750	748	14	3	4.666666666666667	742
FBgn0037997	757	750	756	8	3	2.6666666666666665	749
FBgn0037999	764	750	761	17	7	2.4285714285714284	747
FBgn0038000	765	750	763	17	7	2.4285714285714284	748
FBgn0038002	750	750	733	17	1	17	733
FBgn0038003	750	750	745	5	4	1.25	745
FBgn0038007	753	750	750	6	3	2	747
FBgn0038008	763	750	760	16	4	4	747
FBgn0038011	750	750	750	0	0	NA	750
FBgn0038012	761	750	743	29	4	7.25	732
FBgn0038016	762	750	695	79	7	11.285714285714286	683
FBgn0038017	825	750	824	76	10	7.6	749
FBgn0038028	756	750	750	12	5	2.4	744
FBgn0038029	756	750	750	12	5	2.4	744
FBgn0038037	775	750	637	163	9	18.11111111111111	612
FBgn0038043	750	750	576	174	2	87	576
FBgn0038045	783	750	776	40	7	5.714285714285714	743
FBgn0038046	753	750	738	18	7	2.5714285714285716	735
FBgn0038047	754	750	751	7	6	1.1666666666666667	747
FBgn0038049	751	750	723	29	4	7.25	722
FBgn0038055	593	567	583	36	6	6	557
FBgn0038056	751	750	746	6	3	2	745
FBgn0038057	763	750	756	20	6	3.3333333333333335	743
FBgn0038063	802	750	778	76	8	9.5	726
FBgn0038065	750	750	739	11	1	11	739
FBgn0038070	779	750	776	32	6	5.333333333333333	747
FBgn0038071	777	750	762	42	8	5.25	735
FBgn0038072	758	750	756	10	3	3.3333333333333335	748
FBgn0038073	761	750	749	23	6	3.8333333333333335	738
FBgn0038074	765	750	754	26	10	2.6	739
FBgn0038076	799	750	774	74	6	12.333333333333334	725
FBgn0038078	762	750	755	19	5	3.8	743
FBgn0038079	763	750	762	14	4	3.5	749
FBgn0038080	756	750	755	7	2	3.5	749
FBgn0038082	789	750	756	72	7	10.285714285714286	717
FBgn0038083	763	750	751	25	9	2.7777777777777777	738
FBgn0038084	751	750	735	17	4	4.25	734
FBgn0038087	671	670	653	19	5	3.8	652
FBgn0038088	750	750	746	4	1	4	746
FBgn0038089	750	750	740	10	3	3.3333333333333335	740
FBgn0038090	769	750	746	42	7	6	727
FBgn0038092	776	750	760	42	6	7	734
FBgn0038095	802	749	747	108	15	7.2	694
FBgn0038098	751	750	737	15	3	5	736
FBgn0038099	751	750	736	16	4	4	735
FBgn0038102	750	750	750	0	0	NA	750
FBgn0038105	766	750	746	36	5	7.2	730
FBgn0038106	766	750	746	36	5	7.2	730
FBgn0038108	772	750	760	34	10	3.4	738
FBgn0038109	752	750	752	2	1	2	750
FBgn0038110	759	750	747	21	6	3.5	738
FBgn0038114	755	750	734	26	3	8.666666666666666	729
FBgn0038115	817	750	768	116	14	8.285714285714286	701
FBgn0038118	750	750	749	1	1	1	749
FBgn0038122	750	750	491	259	3	86.33333333333333	491
FBgn0038123	754	750	716	42	5	8.4	712
FBgn0038124	768	750	725	61	2	30.5	707
FBgn0038125	794	750	721	117	3	39	677
FBgn0038126	753	750	752	4	3	1.3333333333333333	749
FBgn0038127	751	750	624	128	4	32	623
FBgn0038128	751	750	728	24	6	4	727
FBgn0038129	767	750	754	30	8	3.75	737
FBgn0038130	764	750	740	38	7	5.428571428571429	726
FBgn0038131	775	750	762	38	7	5.428571428571429	737
FBgn0038132	750	750	707	43	6	7.166666666666667	707
FBgn0038133	751	750	746	6	4	1.5	745
FBgn0038134	750	750	652	98	3	32.666666666666664	652
FBgn0038135	771	750	755	37	5	7.4	734
FBgn0038136	628	597	618	41	7	5.857142857142857	587
FBgn0038139	767	750	754	30	5	6	737
FBgn0038140	752	750	742	12	5	2.4	740
FBgn0038143	777	750	747	57	9	6.333333333333333	720
FBgn0038144	808	750	788	78	11	7.090909090909091	730
FBgn0038145	801	750	782	70	6	11.666666666666666	731
FBgn0038146	767	750	747	37	8	4.625	730
FBgn0038147	751	750	693	59	7	8.428571428571429	692
FBgn0038151	778	750	776	30	6	5	748
FBgn0038153	757	750	707	57	13	4.384615384615385	700
FBgn0038156	775	750	774	26	3	8.666666666666666	749
FBgn0038157	754	750	719	39	5	7.8	715
FBgn0038158	758	750	743	23	6	3.8333333333333335	735
FBgn0038159	774	750	738	60	8	7.5	714
FBgn0038160	774	750	721	77	8	9.625	697
FBgn0038161	792	750	776	58	11	5.2727272727272725	734
FBgn0038166	759	750	759	9	1	9	750
FBgn0038168	756	750	718	44	8	5.5	712
FBgn0038170	751	750	742	10	4	2.5	741
FBgn0038172	802	750	801	53	10	5.3	749
FBgn0038173	773	750	767	29	9	3.2222222222222223	744
FBgn0038179	787	750	756	68	7	9.714285714285714	719
FBgn0038180	516	512	504	16	6	2.6666666666666665	500
FBgn0038181	752	750	715	39	6	6.5	713
FBgn0038183	806	750	801	61	12	5.083333333333333	745
FBgn0038186	750	750	730	20	4	5	730
FBgn0038188	763	750	722	54	7	7.714285714285714	709
FBgn0038189	793	750	746	90	9	10	703
FBgn0038190	770	750	745	45	11	4.090909090909091	725
FBgn0038191	774	750	359	439	6	73.16666666666667	335
FBgn0038194	783	750	770	46	10	4.6	737
FBgn0038195	778	750	761	45	7	6.428571428571429	733
FBgn0038196	796	750	726	116	16	7.25	680
FBgn0038197	769	750	749	39	10	3.9	730
FBgn0038198	762	750	753	21	8	2.625	741
FBgn0038200	753	750	724	32	4	8	721
FBgn0038201	752	750	745	9	4	2.25	743
FBgn0038202	770	750	761	29	9	3.2222222222222223	741
FBgn0038203	772	750	758	36	13	2.769230769230769	736
FBgn0038205	752	750	747	7	4	1.75	745
FBgn0038206	759	750	741	27	5	5.4	732
FBgn0038207	772	750	721	73	9	8.11111111111111	699
FBgn0038210	801	750	769	83	10	8.3	718
FBgn0038213	753	750	731	25	8	3.125	728
FBgn0038214	763	750	763	13	4	3.25	750
FBgn0038218	753	750	753	3	1	3	750
FBgn0038219	750	750	747	3	1	3	747
FBgn0038221	754	750	723	35	8	4.375	719
FBgn0038223	755	750	755	5	1	5	750
FBgn0038224	755	750	753	7	2	3.5	748
FBgn0038225	774	750	733	65	6	10.833333333333334	709
FBgn0038233	758	750	758	8	4	2	750
FBgn0038234	753	750	745	11	3	3.6666666666666665	742
FBgn0038235	752	750	718	36	5	7.2	716
FBgn0038236	767	750	755	29	10	2.9	738
FBgn0038237	751	750	570	182	5	36.4	569
FBgn0038238	767	750	721	63	8	7.875	704
FBgn0038239	776	750	727	75	10	7.5	701
FBgn0038240	771	750	667	125	11	11.363636363636363	646
FBgn0038241	762	750	454	320	7	45.714285714285715	442
FBgn0038242	757	750	517	247	6	41.166666666666664	510
FBgn0038246	762	750	756	18	7	2.5714285714285716	744
FBgn0038247	788	750	775	51	8	6.375	737
FBgn0038248	751	750	744	8	5	1.6	743
FBgn0038250	774	750	633	165	14	11.785714285714286	609
FBgn0038252	760	750	751	19	3	6.333333333333333	741
FBgn0038256	769	750	758	30	11	2.727272727272727	739
FBgn0038258	758	750	737	29	8	3.625	729
FBgn0038260	756	750	746	16	6	2.6666666666666665	740
FBgn0038261	599	567	563	68	10	6.8	531
FBgn0038262	809	750	777	91	10	9.1	718
FBgn0038266	765	750	724	56	8	7	709
FBgn0038268	765	750	736	44	7	6.285714285714286	721
FBgn0038269	750	750	634	116	3	38.666666666666664	634
FBgn0038271	751	750	751	1	1	1	750
FBgn0038272	778	750	764	42	12	3.5	736
FBgn0038273	778	750	767	39	10	3.9	739
FBgn0038274	756	750	516	246	4	61.5	510
FBgn0038275	755	750	678	82	7	11.714285714285714	673
FBgn0038277	765	750	698	82	12	6.833333333333333	683
FBgn0038279	773	750	736	60	11	5.454545454545454	713
FBgn0038280	750	750	739	11	2	5.5	739
FBgn0038281	750	750	716	34	2	17	716
FBgn0038282	778	750	707	99	7	14.142857142857142	679
FBgn0038285	750	750	568	182	5	36.4	568
FBgn0038286	755	750	744	16	4	4	739
FBgn0038291	787	750	774	50	7	7.142857142857143	737
FBgn0038294	750	750	743	7	2	3.5	743
FBgn0038295	750	750	737	13	5	2.6	737
FBgn0038296	779	750	772	36	5	7.2	743
FBgn0038299	774	750	746	52	7	7.428571428571429	722
FBgn0038300	774	750	721	77	10	7.7	697
FBgn0038301	774	750	750	48	9	5.333333333333333	726
FBgn0038302	772	750	770	24	6	4	748
FBgn0038303	774	750	755	43	9	4.777777777777778	731
FBgn0038304	778	750	768	38	9	4.222222222222222	740
FBgn0038306	768	750	744	42	9	4.666666666666667	726
FBgn0038307	768	750	733	53	11	4.818181818181818	715
FBgn0038309	801	750	784	68	9	7.555555555555555	733
FBgn0038311	753	750	747	9	5	1.8	744
FBgn0038312	756	750	745	17	5	3.4	739
FBgn0038313	750	750	733	17	3	5.666666666666667	733
FBgn0038315	769	750	732	56	9	6.222222222222222	713
FBgn0038316	785	750	769	51	6	8.5	734
FBgn0038318	768	750	739	47	6	7.833333333333333	721
FBgn0038320	758	750	749	17	2	8.5	741
FBgn0038321	779	750	775	33	10	3.3	746
FBgn0038324	750	750	747	3	2	1.5	747
FBgn0038325	761	750	737	35	6	5.833333333333333	726
FBgn0038326	761	750	740	32	5	6.4	729
FBgn0038327	750	750	742	8	2	4	742
FBgn0038330	753	750	729	27	8	3.375	726
FBgn0038331	752	750	752	2	1	2	750
FBgn0038332	750	750	731	19	2	9.5	731
FBgn0038334	759	750	741	27	6	4.5	732
FBgn0038337	750	750	743	7	2	3.5	743
FBgn0038339	762	750	753	21	2	10.5	741
FBgn0038342	789	750	767	61	7	8.714285714285714	728
FBgn0038343	779	750	757	51	9	5.666666666666667	728
FBgn0038344	779	750	757	51	9	5.666666666666667	728
FBgn0038345	760	750	663	107	3	35.666666666666664	653
FBgn0038350	757	750	756	8	4	2	749
FBgn0038353	760	750	739	31	5	6.2	729
FBgn0038354	757	750	744	20	5	4	737
FBgn0038355	758	750	662	104	5	20.8	654
FBgn0038356	753	750	708	48	6	8	705
FBgn0038357	765	750	737	43	5	8.6	722
FBgn0038359	770	750	736	54	7	7.714285714285714	716
FBgn0038360	801	750	762	90	14	6.428571428571429	711
FBgn0038363	759	750	759	9	1	9	750
FBgn0038365	769	750	725	63	7	9	706
FBgn0038366	758	750	754	12	4	3	746
FBgn0038369	761	750	624	148	4	37	613
FBgn0038371	751	750	625	127	3	42.333333333333336	624
FBgn0038373	776	750	752	50	10	5	726
FBgn0038376	759	750	738	30	7	4.285714285714286	729
FBgn0038377	750	750	748	2	1	2	748
FBgn0038380	765	750	746	34	4	8.5	731
FBgn0038385	764	750	728	50	7	7.142857142857143	714
FBgn0038386	756	750	743	19	6	3.1666666666666665	737
FBgn0038387	752	750	702	52	4	13	700
FBgn0038388	750	750	750	0	0	NA	750
FBgn0038389	750	750	749	1	1	1	749
FBgn0038390	750	750	748	2	2	1	748
FBgn0038391	750	750	745	5	1	5	745
FBgn0038394	766	750	750	32	6	5.333333333333333	734
FBgn0038396	766	750	727	55	10	5.5	711
FBgn0038397	758	750	757	9	4	2.25	749
FBgn0038398	770	750	719	71	9	7.888888888888889	699
FBgn0038400	760	750	697	73	4	18.25	687
FBgn0038401	782	750	769	45	6	7.5	737
FBgn0038402	767	750	755	29	6	4.833333333333333	738
FBgn0038404	750	750	728	22	4	5.5	728
FBgn0038405	751	750	751	1	1	1	750
FBgn0038407	767	750	767	17	2	8.5	750
FBgn0038412	761	750	750	22	6	3.6666666666666665	739
FBgn0038414	782	750	753	61	4	15.25	721
FBgn0038416	634	630	603	35	9	3.888888888888889	599
FBgn0038418	753	750	746	10	4	2.5	743
FBgn0038419	750	750	750	0	0	NA	750
FBgn0038420	757	750	757	7	2	3.5	750
FBgn0038422	758	750	755	11	2	5.5	747
FBgn0038423	753	750	721	35	4	8.75	718
FBgn0038428	763	750	749	27	8	3.375	736
FBgn0038429	755	750	745	15	4	3.75	740
FBgn0038431	753	750	693	63	9	7	690
FBgn0038435	750	750	744	6	1	6	744
FBgn0038436	794	750	776	62	7	8.857142857142858	732
FBgn0038437	636	576	609	87	10	8.7	549
FBgn0038439	760	750	747	23	5	4.6	737
FBgn0038445	760	750	707	63	4	15.75	697
FBgn0038446	775	750	721	79	7	11.285714285714286	696
FBgn0038447	753	750	736	20	5	4	733
FBgn0038449	751	750	724	28	7	4	723
FBgn0038450	762	750	755	19	8	2.375	743
FBgn0038451	772	750	722	72	18	4	700
FBgn0038453	804	750	682	176	17	10.352941176470589	628
FBgn0038454	783	750	774	42	10	4.2	741
FBgn0038458	761	750	753	19	2	9.5	742
FBgn0038465	781	750	766	46	4	11.5	735
FBgn0038466	781	750	751	61	10	6.1	720
FBgn0038467	757	750	697	67	9	7.444444444444445	690
FBgn0038468	752	750	743	11	4	2.75	741
FBgn0038469	602	602	584	18	2	9	584
FBgn0038470	756	750	693	69	14	4.928571428571429	687
FBgn0038471	752	750	702	52	11	4.7272727272727275	700
FBgn0038472	771	750	735	57	9	6.333333333333333	714
FBgn0038473	751	750	739	13	2	6.5	738
FBgn0038474	750	750	748	2	1	2	748
FBgn0038475	753	750	733	23	7	3.2857142857142856	730
FBgn0038476	755	750	738	22	5	4.4	733
FBgn0038478	554	553	524	31	6	5.166666666666667	523
FBgn0038481	801	750	793	59	8	7.375	742
FBgn0038482	752	750	752	2	1	2	750
FBgn0038484	756	750	733	29	9	3.2222222222222223	727
FBgn0038487	790	750	773	57	10	5.7	733
FBgn0038488	753	750	740	16	3	5.333333333333333	737
FBgn0038492	765	750	749	31	6	5.166666666666667	734
FBgn0038494	750	750	735	15	3	5	735
FBgn0038498	778	750	769	37	4	9.25	741
FBgn0038505	533	530	522	14	5	2.8	519
FBgn0038508	816	750	787	95	13	7.3076923076923075	721
FBgn0038509	753	750	749	7	3	2.3333333333333335	746
FBgn0038510	750	750	732	18	3	6	732
FBgn0038511	757	750	743	21	7	3	736
FBgn0038512	753	750	330	426	5	85.2	327
FBgn0038515	804	750	722	136	14	9.714285714285714	668
FBgn0038516	774	750	737	61	7	8.714285714285714	713
FBgn0038519	756	750	730	32	7	4.571428571428571	724
FBgn0038523	760	750	746	24	6	4	736
FBgn0038524	798	750	751	95	13	7.3076923076923075	703
FBgn0038525	780	750	769	41	6	6.833333333333333	739
FBgn0038527	750	750	749	1	1	1	749
FBgn0038528	750	750	749	1	1	1	749
FBgn0038531	750	750	745	5	1	5	745
FBgn0038532	760	750	719	51	5	10.2	709
FBgn0038533	757	750	744	20	5	4	737
FBgn0038535	750	750	748	2	2	1	748
FBgn0038536	752	750	751	3	2	1.5	749
FBgn0038539	808	750	791	75	11	6.818181818181818	733
FBgn0038540	831	750	794	118	14	8.428571428571429	713
FBgn0038545	772	750	743	51	11	4.636363636363637	721
FBgn0038546	774	695	753	100	16	6.25	674
FBgn0038550	577	568	539	47	13	3.6153846153846154	530
FBgn0038552	782	750	774	40	6	6.666666666666667	742
FBgn0038558	750	750	587	163	3	54.333333333333336	587
FBgn0038564	533	527	499	40	6	6.666666666666667	493
FBgn0038565	756	750	650	112	7	16	644
FBgn0038566	764	750	732	46	7	6.571428571428571	718
FBgn0038567	766	750	739	43	9	4.777777777777778	723
FBgn0038569	753	750	711	45	4	11.25	708
FBgn0038575	759	750	758	10	2	5	749
FBgn0038576	750	750	736	14	5	2.8	736
FBgn0038577	752	750	741	13	3	4.333333333333333	739
FBgn0038578	750	750	739	11	2	5.5	739
FBgn0038579	767	750	744	40	11	3.6363636363636362	727
FBgn0038582	765	750	755	25	4	6.25	740
FBgn0038583	752	750	752	2	1	2	750
FBgn0038584	752	750	752	2	1	2	750
FBgn0038585	755	750	735	25	4	6.25	730
FBgn0038586	756	750	745	17	4	4.25	739
FBgn0038588	758	750	742	24	9	2.6666666666666665	734
FBgn0038589	766	750	738	44	6	7.333333333333333	722
FBgn0038592	756	750	736	26	8	3.25	730
FBgn0038593	751	750	749	3	3	1	748
FBgn0038595	761	750	731	41	10	4.1	720
FBgn0038596	753	750	747	9	4	2.25	744
FBgn0038597	754	750	754	4	2	2	750
FBgn0038598	750	750	746	4	3	1.3333333333333333	746
FBgn0038602	751	750	689	63	7	9	688
FBgn0038603	768	750	692	94	8	11.75	674
FBgn0038606	780	750	747	63	7	9	717
FBgn0038607	783	750	755	61	7	8.714285714285714	722
FBgn0038610	761	750	717	55	12	4.583333333333333	706
FBgn0038613	750	750	734	16	3	5.333333333333333	734
FBgn0038617	779	750	760	48	10	4.8	731
FBgn0038626	770	750	743	47	11	4.2727272727272725	723
FBgn0038629	763	750	753	23	9	2.5555555555555554	740
FBgn0038632	756	750	719	43	8	5.375	713
FBgn0038640	758	750	757	9	5	1.8	749
FBgn0038642	601	600	582	20	4	5	581
FBgn0038643	763	750	733	43	8	5.375	720
FBgn0038645	765	750	750	30	6	5	735
FBgn0038646	759	750	739	29	7	4.142857142857143	730
FBgn0038647	753	750	715	41	11	3.727272727272727	712
FBgn0038649	756	750	707	55	5	11	701
FBgn0038651	594	594	571	23	3	7.666666666666667	571
FBgn0038653	762	750	700	74	9	8.222222222222221	688
FBgn0038654	784	750	773	45	6	7.5	739
FBgn0038655	776	750	757	45	7	6.428571428571429	731
FBgn0038658	802	750	785	69	10	6.9	733
FBgn0038659	803	750	781	75	13	5.769230769230769	728
FBgn0038660	766	750	717	65	16	4.0625	701
FBgn0038662	793	750	723	113	14	8.071428571428571	680
FBgn0038666	750	750	745	5	1	5	745
FBgn0038672	750	750	737	13	3	4.333333333333333	737
FBgn0038673	750	750	749	1	1	1	749
FBgn0038675	752	750	719	35	6	5.833333333333333	717
FBgn0038676	750	750	750	0	0	NA	750
FBgn0038678	752	750	707	47	7	6.714285714285714	705
FBgn0038679	752	750	410	344	5	68.8	408
FBgn0038680	758	750	747	19	8	2.375	739
FBgn0038681	630	625	600	35	7	5	595
FBgn0038682	763	750	710	66	9	7.333333333333333	697
FBgn0038685	786	750	783	39	10	3.9	747
FBgn0038686	760	750	753	17	9	1.8888888888888888	743
FBgn0038691	754	750	745	13	3	4.333333333333333	741
FBgn0038692	750	750	721	29	3	9.666666666666666	721
FBgn0038693	760	750	745	25	5	5	735
FBgn0038694	783	750	775	41	6	6.833333333333333	742
FBgn0038695	774	750	748	50	11	4.545454545454546	724
FBgn0038702	773	750	765	31	11	2.8181818181818183	742
FBgn0038705	770	750	699	91	8	11.375	679
FBgn0038706	765	750	742	38	9	4.222222222222222	727
FBgn0038709	773	750	725	71	12	5.916666666666667	702
FBgn0038714	751	750	749	3	3	1	748
FBgn0038715	755	750	751	9	3	3	746
FBgn0038716	763	750	741	35	8	4.375	728
FBgn0038717	778	750	715	91	9	10.11111111111111	687
FBgn0038718	756	750	752	10	5	2	746
FBgn0038719	761	750	756	16	4	4	745
FBgn0038720	759	750	719	49	9	5.444444444444445	710
FBgn0038721	773	750	742	54	11	4.909090909090909	719
FBgn0038722	758	750	724	42	9	4.666666666666667	716
FBgn0038725	768	750	764	22	3	7.333333333333333	746
FBgn0038727	759	750	754	14	6	2.3333333333333335	745
FBgn0038732	812	750	612	262	9	29.11111111111111	550
FBgn0038733	685	673	638	59	5	11.8	626
FBgn0038735	823	750	742	154	14	11	669
FBgn0038737	752	750	739	15	2	7.5	737
FBgn0038738	772	750	764	30	8	3.75	742
FBgn0038739	755	750	746	14	5	2.8	741
FBgn0038740	572	534	561	49	11	4.454545454545454	523
FBgn0038741	754	750	734	24	5	4.8	730
FBgn0038742	751	750	750	2	2	1	749
FBgn0038744	774	750	756	42	8	5.25	732
FBgn0038746	767	750	715	69	5	13.8	698
FBgn0038747	771	750	742	50	5	10	721
FBgn0038750	757	750	753	11	5	2.2	746
FBgn0038751	757	750	755	9	4	2.25	748
FBgn0038752	769	750	749	39	8	4.875	730
FBgn0038753	761	750	737	35	5	7	726
FBgn0038755	757	750	749	15	8	1.875	742
FBgn0038756	753	750	744	12	5	2.4	741
FBgn0038760	757	750	752	12	7	1.7142857142857142	745
FBgn0038761	753	750	734	22	6	3.6666666666666665	731
FBgn0038763	826	750	806	96	9	10.666666666666666	730
FBgn0038765	753	750	750	6	2	3	747
FBgn0038766	751	750	742	10	3	3.3333333333333335	741
FBgn0038767	758	750	705	61	14	4.357142857142857	697
FBgn0038768	757	750	709	55	13	4.230769230769231	702
FBgn0038769	758	750	727	39	6	6.5	719
FBgn0038771	760	750	755	15	6	2.5	745
FBgn0038772	771	750	761	31	9	3.4444444444444446	740
FBgn0038774	780	750	774	36	4	9	744
FBgn0038775	765	750	760	20	6	3.3333333333333335	745
FBgn0038783	750	750	385	365	3	121.66666666666667	385
FBgn0038784	768	750	591	195	5	39	573
FBgn0038787	762	750	760	14	5	2.8	748
FBgn0038788	751	750	749	3	3	1	748
FBgn0038789	752	750	708	46	6	7.666666666666667	706
FBgn0038796	774	750	766	32	7	4.571428571428571	742
FBgn0038803	770	750	734	56	6	9.333333333333334	714
FBgn0038804	753	750	745	11	6	1.8333333333333333	742
FBgn0038805	761	750	761	11	1	11	750
FBgn0038806	750	750	750	0	0	NA	750
FBgn0038808	751	750	749	3	2	1.5	748
FBgn0038809	514	512	482	34	6	5.666666666666667	480
FBgn0038814	763	750	734	42	12	3.5	721
FBgn0038815	765	750	731	49	13	3.769230769230769	716
FBgn0038816	772	750	727	67	17	3.9411764705882355	705
FBgn0038818	764	750	573	205	7	29.285714285714285	559
FBgn0038819	753	750	753	3	1	3	750
FBgn0038820	766	750	745	37	4	9.25	729
FBgn0038821	750	750	729	21	6	3.5	729
FBgn0038826	752	750	741	13	5	2.6	739
FBgn0038827	782	750	771	43	6	7.166666666666667	739
FBgn0038829	755	750	753	7	3	2.3333333333333335	748
FBgn0038830	772	750	512	282	4	70.5	490
FBgn0038832	771	750	765	27	6	4.5	744
FBgn0038833	751	750	694	58	7	8.285714285714286	693
FBgn0038834	762	750	461	313	4	78.25	449
FBgn0038837	787	750	771	53	6	8.833333333333334	734
FBgn0038839	761	750	760	12	2	6	749
FBgn0038840	769	750	745	43	6	7.166666666666667	726
FBgn0038842	791	750	787	45	4	11.25	746
FBgn0038845	753	750	751	5	2	2.5	748
FBgn0038846	753	750	752	4	2	2	749
FBgn0038847	768	750	740	46	5	9.2	722
FBgn0038850	758	750	743	23	6	3.8333333333333335	735
FBgn0038851	770	750	738	52	7	7.428571428571429	718
FBgn0038852	763	750	749	27	4	6.75	736
FBgn0038855	760	750	743	27	8	3.375	733
FBgn0038857	761	750	756	16	8	2	745
FBgn0038858	752	750	751	3	2	1.5	749
FBgn0038859	760	750	702	68	11	6.181818181818182	692
FBgn0038860	760	750	714	56	11	5.090909090909091	704
FBgn0038861	808	750	797	69	7	9.857142857142858	739
FBgn0038862	812	750	806	68	7	9.714285714285714	744
FBgn0038865	780	750	754	56	12	4.666666666666667	724
FBgn0038869	758	750	757	9	4	2.25	749
FBgn0038870	768	750	762	24	6	4	744
FBgn0038872	779	750	779	29	2	14.5	750
FBgn0038876	752	750	752	2	1	2	750
FBgn0038877	636	624	597	51	10	5.1	585
FBgn0038878	750	750	742	8	3	2.6666666666666665	742
FBgn0038879	758	750	748	18	3	6	740
FBgn0038880	751	750	751	1	1	1	750
FBgn0038881	770	750	767	23	5	4.6	747
FBgn0038886	754	750	711	47	8	5.875	707
FBgn0038887	766	750	759	23	8	2.875	743
FBgn0038888	802	750	770	84	8	10.5	718
FBgn0038889	770	750	758	32	5	6.4	738
FBgn0038892	756	750	755	7	3	2.3333333333333335	749
FBgn0038893	791	750	759	73	10	7.3	718
FBgn0038894	750	750	738	12	4	3	738
FBgn0038897	777	750	754	50	8	6.25	727
FBgn0038902	751	750	749	3	3	1	748
FBgn0038903	504	504	487	17	2	8.5	487
FBgn0038909	760	750	750	20	7	2.857142857142857	740
FBgn0038917	804	750	766	92	13	7.076923076923077	712
FBgn0038918	751	750	730	22	4	5.5	729
FBgn0038921	760	750	709	61	8	7.625	699
FBgn0038923	750	750	750	0	0	NA	750
FBgn0038925	759	750	714	54	7	7.714285714285714	705
FBgn0038926	753	750	745	11	2	5.5	742
FBgn0038929	773	750	756	40	8	5	733
FBgn0038930	806	750	794	68	9	7.555555555555555	738
FBgn0038931	765	750	731	49	8	6.125	716
FBgn0038941	765	750	754	26	4	6.5	739
FBgn0038944	809	750	772	96	9	10.666666666666666	713
FBgn0038945	757	750	745	19	4	4.75	738
FBgn0038946	757	750	753	11	4	2.75	746
FBgn0038948	750	750	268	482	1	482	268
FBgn0038951	750	750	712	38	2	19	712
FBgn0038956	760	750	751	19	7	2.7142857142857144	741
FBgn0038957	756	750	725	37	10	3.7	719
FBgn0038958	750	750	747	3	1	3	747
FBgn0038959	764	750	762	16	5	3.2	748
FBgn0038964	753	750	745	11	3	3.6666666666666665	742
FBgn0038965	750	750	750	0	0	NA	750
FBgn0038966	610	604	607	9	4	2.25	601
FBgn0038967	760	750	758	12	6	2	748
FBgn0038972	758	750	745	21	6	3.5	737
FBgn0038974	754	750	754	4	2	2	750
FBgn0038975	754	750	752	6	3	2	748
FBgn0038976	751	750	749	3	2	1.5	748
FBgn0038979	660	645	480	195	7	27.857142857142858	465
FBgn0038980	777	750	768	36	7	5.142857142857143	741
FBgn0038983	759	750	755	13	5	2.6	746
FBgn0038984	752	750	749	5	5	1	747
FBgn0038989	751	750	746	6	2	3	745
FBgn0038993	792	750	792	42	5	8.4	750
FBgn0039002	754	750	748	10	4	2.5	744
FBgn0039003	750	750	745	5	2	2.5	745
FBgn0039004	750	750	750	0	0	NA	750
FBgn0039007	752	750	744	10	6	1.6666666666666667	742
FBgn0039009	629	627	615	16	3	5.333333333333333	613
FBgn0039010	764	750	763	15	3	5	749
FBgn0039013	793	750	778	58	13	4.461538461538462	735
FBgn0039016	763	750	748	28	3	9.333333333333334	735
FBgn0039017	750	750	747	3	1	3	747
FBgn0039019	750	750	747	3	1	3	747
FBgn0039022	530	524	505	31	5	6.2	499
FBgn0039024	751	750	741	11	5	2.2	740
FBgn0039027	751	750	708	44	6	7.333333333333333	707
FBgn0039028	820	750	811	79	9	8.777777777777779	741
FBgn0039029	771	750	768	24	5	4.8	747
FBgn0039031	772	750	764	30	5	6	742
FBgn0039033	750	750	747	3	1	3	747
FBgn0039034	758	750	737	29	7	4.142857142857143	729
FBgn0039038	750	750	628	122	6	20.333333333333332	628
FBgn0039039	758	750	724	42	7	6	716
FBgn0039040	813	750	766	110	19	5.7894736842105265	703
FBgn0039041	757	750	745	19	8	2.375	738
FBgn0039042	756	750	699	63	8	7.875	693
FBgn0039043	762	750	738	36	6	6	726
FBgn0039048	773	750	739	57	9	6.333333333333333	716
FBgn0039051	753	750	725	31	6	5.166666666666667	722
FBgn0039052	625	614	580	56	6	9.333333333333334	569
FBgn0039054	758	750	745	21	6	3.5	737
FBgn0039055	763	750	762	14	5	2.8	749
FBgn0039056	762	750	753	21	5	4.2	741
FBgn0039058	830	750	798	112	9	12.444444444444445	718
FBgn0039059	769	750	742	46	10	4.6	723
FBgn0039064	688	688	670	18	6	3	670
FBgn0039065	750	750	729	21	4	5.25	729
FBgn0039066	779	750	747	61	8	7.625	718
FBgn0039067	780	750	778	32	7	4.571428571428571	748
FBgn0039068	778	750	775	31	6	5.166666666666667	747
FBgn0039071	756	750	735	27	6	4.5	729
FBgn0039073	779	750	753	55	9	6.111111111111111	724
FBgn0039075	760	750	682	88	11	8	672
FBgn0039077	750	750	750	0	0	NA	750
FBgn0039078	754	750	751	7	3	2.3333333333333335	747
FBgn0039080	751	750	747	5	3	1.6666666666666667	746
FBgn0039081	750	750	750	0	0	NA	750
FBgn0039083	775	750	734	66	9	7.333333333333333	709
FBgn0039084	781	750	748	64	10	6.4	717
FBgn0039087	753	750	745	11	7	1.5714285714285714	742
FBgn0039088	789	750	765	63	10	6.3	726
FBgn0039089	820	750	816	74	10	7.4	746
FBgn0039093	772	750	741	53	6	8.833333333333334	719
FBgn0039094	757	750	737	27	9	3	730
FBgn0039098	769	750	667	121	13	9.307692307692308	648
FBgn0039099	584	543	577	48	6	8	536
FBgn0039106	771	750	753	39	9	4.333333333333333	732
FBgn0039108	750	750	274	476	5	95.2	274
FBgn0039109	776	750	734	68	12	5.666666666666667	708
FBgn0039110	751	750	751	1	1	1	750
FBgn0039111	784	750	781	37	3	12.333333333333334	747
FBgn0039113	762	750	759	15	4	3.75	747
FBgn0039114	762	750	759	15	4	3.75	747
FBgn0039115	766	750	751	31	6	5.166666666666667	735
FBgn0039116	766	750	730	52	8	6.5	714
FBgn0039120	756	750	752	10	2	5	746
FBgn0039126	733	729	722	15	3	5	718
FBgn0039128	751	750	749	3	3	1	748
FBgn0039129	750	750	734	16	2	8	734
FBgn0039130	750	750	731	19	4	4.75	731
FBgn0039131	761	750	748	24	5	4.8	737
FBgn0039135	750	750	750	0	0	NA	750
FBgn0039136	751	750	749	3	2	1.5	748
FBgn0039137	751	750	740	12	3	4	739
FBgn0039139	751	750	743	9	4	2.25	742
FBgn0039140	771	750	760	32	4	8	739
FBgn0039141	763	750	762	14	3	4.666666666666667	749
FBgn0039147	762	750	745	29	5	5.8	733
FBgn0039149	753	750	732	24	5	4.8	729
FBgn0039151	777	750	771	33	9	3.6666666666666665	744
FBgn0039153	750	750	747	3	2	1.5	747
FBgn0039154	520	520	520	0	0	NA	520
FBgn0039156	754	750	750	8	5	1.6	746
FBgn0039157	763	750	753	23	5	4.6	740
FBgn0039158	766	750	759	23	5	4.6	743
FBgn0039159	761	750	746	26	8	3.25	735
FBgn0039160	764	750	763	15	3	5	749
FBgn0039161	750	750	741	9	2	4.5	741
FBgn0039165	777	750	767	37	9	4.111111111111111	740
FBgn0039169	764	750	764	14	2	7	750
FBgn0039170	750	750	747	3	1	3	747
FBgn0039175	648	638	641	17	5	3.4	631
FBgn0039178	768	750	722	64	12	5.333333333333333	704
FBgn0039180	771	750	758	34	8	4.25	737
FBgn0039182	755	750	755	5	1	5	750
FBgn0039183	750	750	745	5	1	5	745
FBgn0039186	751	750	751	1	1	1	750
FBgn0039187	750	750	747	3	1	3	747
FBgn0039189	776	746	551	255	10	25.5	521
FBgn0039190	750	750	749	1	1	1	749
FBgn0039192	761	750	759	13	2	6.5	748
FBgn0039193	761	750	759	13	2	6.5	748
FBgn0039195	728	728	710	18	4	4.5	710
FBgn0039196	761	750	635	137	6	22.833333333333332	624
FBgn0039197	762	750	750	24	6	4	738
FBgn0039198	753	750	742	14	3	4.666666666666667	739
FBgn0039199	757	750	738	26	4	6.5	731
FBgn0039200	761	750	752	20	5	4	741
FBgn0039201	751	750	750	2	2	1	749
FBgn0039203	756	750	739	23	4	5.75	733
FBgn0039204	599	596	578	24	7	3.4285714285714284	575
FBgn0039205	750	750	745	5	3	1.6666666666666667	745
FBgn0039210	751	750	707	45	8	5.625	706
FBgn0039213	750	750	750	0	0	NA	750
FBgn0039214	756	750	753	9	5	1.8	747
FBgn0039215	757	750	756	8	3	2.6666666666666665	749
FBgn0039219	761	750	733	39	7	5.571428571428571	722
FBgn0039223	768	750	766	20	6	3.3333333333333335	748
FBgn0039224	780	750	741	69	7	9.857142857142858	711
FBgn0039225	768	750	766	20	6	3.3333333333333335	748
FBgn0039228	750	750	736	14	1	14	736
FBgn0039232	750	750	732	18	3	6	732
FBgn0039237	784	750	775	43	7	6.142857142857143	741
FBgn0039238	784	750	775	43	7	6.142857142857143	741
FBgn0039239	767	750	748	36	3	12	731
FBgn0039240	774	750	752	46	6	7.666666666666667	728
FBgn0039244	767	750	754	30	4	7.5	737
FBgn0039246	751	750	746	6	3	2	745
FBgn0039249	755	750	731	29	6	4.833333333333333	726
FBgn0039254	751	750	737	15	3	5	736
FBgn0039257	820	750	803	87	8	10.875	733
FBgn0039258	762	750	722	52	5	10.4	710
FBgn0039259	773	750	771	25	5	5	748
FBgn0039260	761	750	742	30	4	7.5	731
FBgn0039261	752	750	742	12	3	4	740
FBgn0039264	754	750	739	19	5	3.8	735
FBgn0039269	756	750	745	17	3	5.666666666666667	739
FBgn0039270	750	750	742	8	2	4	742
FBgn0039271	751	750	746	6	3	2	745
FBgn0039273	752	750	707	47	6	7.833333333333333	705
FBgn0039274	752	750	724	30	5	6	722
FBgn0039277	691	691	679	12	3	4	679
FBgn0039286	768	750	739	47	7	6.714285714285714	721
FBgn0039288	756	750	753	9	2	4.5	747
FBgn0039290	775	750	764	36	6	6	739
FBgn0039291	824	750	805	93	12	7.75	731
FBgn0039294	753	750	712	44	4	11	709
FBgn0039296	774	750	731	67	10	6.7	707
FBgn0039297	800	750	747	103	10	10.3	697
FBgn0039298	760	750	740	30	5	6	730
FBgn0039299	782	750	775	39	8	4.875	743
FBgn0039300	754	750	398	360	3	120	394
FBgn0039301	754	750	751	7	5	1.4	747
FBgn0039304	771	750	769	23	3	7.666666666666667	748
FBgn0039306	750	750	740	10	2	5	740
FBgn0039310	807	750	802	62	7	8.857142857142858	745
FBgn0039311	750	750	725	25	1	25	725
FBgn0039312	788	750	773	53	7	7.571428571428571	735
FBgn0039313	778	750	775	31	7	4.428571428571429	747
FBgn0039319	826	750	804	98	10	9.8	728
FBgn0039321	775	750	771	29	5	5.8	746
FBgn0039323	540	504	506	70	13	5.384615384615385	470
FBgn0039324	515	515	268	247	2	123.5	268
FBgn0039325	763	750	736	40	9	4.444444444444445	723
FBgn0039326	616	547	598	87	10	8.7	529
FBgn0039329	750	750	750	0	0	NA	750
FBgn0039331	751	750	739	13	2	6.5	738
FBgn0039335	784	750	781	37	5	7.4	747
FBgn0039336	754	750	754	4	2	2	750
FBgn0039337	751	750	749	3	2	1.5	748
FBgn0039338	755	750	736	24	5	4.8	731
FBgn0039341	788	750	753	73	12	6.083333333333333	715
FBgn0039342	713	712	681	33	9	3.6666666666666665	680
FBgn0039344	751	750	741	11	4	2.75	740
FBgn0039346	764	750	753	25	7	3.5714285714285716	739
FBgn0039347	769	750	752	36	9	4	733
FBgn0039349	751	750	743	9	6	1.5	742
FBgn0039350	766	750	692	90	12	7.5	676
FBgn0039354	760	750	755	15	3	5	745
FBgn0039355	684	683	683	2	2	1	682
FBgn0039356	762	750	750	24	5	4.8	738
FBgn0039357	751	750	746	6	3	2	745
FBgn0039358	751	750	750	2	2	1	749
FBgn0039370	795	750	795	45	5	9	750
FBgn0039371	766	750	701	81	8	10.125	685
FBgn0039373	780	750	770	40	4	10	740
FBgn0039376	752	750	747	7	3	2.3333333333333335	745
FBgn0039378	805	750	780	80	10	8	725
FBgn0039379	756	750	755	7	2	3.5	749
FBgn0039380	817	750	784	100	5	20	717
FBgn0039385	789	750	777	51	5	10.2	738
FBgn0039395	768	750	768	18	3	6	750
FBgn0039396	752	750	717	37	5	7.4	715
FBgn0039398	752	750	634	120	4	30	632
FBgn0039403	750	750	750	0	0	NA	750
FBgn0039404	750	750	746	4	2	2	746
FBgn0039406	752	750	752	2	2	1	750
FBgn0039407	752	750	750	4	3	1.3333333333333333	748
FBgn0039408	776	750	750	52	8	6.5	724
FBgn0039411	793	750	783	53	7	7.571428571428571	740
FBgn0039415	750	750	736	14	3	4.666666666666667	736
FBgn0039420	753	750	747	9	3	3	744
FBgn0039421	750	750	750	0	0	NA	750
FBgn0039424	776	750	776	26	4	6.5	750
FBgn0039425	754	750	749	9	3	3	745
FBgn0039428	762	750	746	28	10	2.8	734
FBgn0039429	754	750	719	39	7	5.571428571428571	715
FBgn0039431	784	750	772	46	11	4.181818181818182	738
FBgn0039434	761	750	726	46	5	9.2	715
FBgn0039435	750	750	750	0	0	NA	750
FBgn0039436	750	750	716	34	3	11.333333333333334	716
FBgn0039438	766	750	764	18	5	3.6	748
FBgn0039439	750	750	744	6	1	6	744
FBgn0039440	757	750	757	7	2	3.5	750
FBgn0039441	750	750	750	0	0	NA	750
FBgn0039443	753	750	752	4	2	2	749
FBgn0039444	750	750	743	7	1	7	743
FBgn0039448	751	750	743	9	2	4.5	742
FBgn0039449	785	750	744	76	9	8.444444444444445	709
FBgn0039450	787	750	744	80	12	6.666666666666667	707
FBgn0039451	765	750	741	39	10	3.9	726
FBgn0039453	752	750	733	21	4	5.25	731
FBgn0039454	766	750	762	20	4	5	746
FBgn0039459	770	750	766	24	8	3	746
FBgn0039462	750	750	638	112	7	16	638
FBgn0039464	779	750	768	40	5	8	739
FBgn0039466	755	750	743	17	3	5.666666666666667	738
FBgn0039469	750	750	683	67	4	16.75	683
FBgn0039473	560	524	539	57	8	7.125	503
FBgn0039474	727	721	697	36	6	6	691
FBgn0039475	764	750	754	24	6	4	740
FBgn0039476	756	750	527	235	7	33.57142857142857	521
FBgn0039478	752	750	738	16	5	3.2	736
FBgn0039479	762	750	635	139	7	19.857142857142858	623
FBgn0039480	755	750	704	56	8	7	699
FBgn0039481	761	750	756	16	6	2.6666666666666665	745
FBgn0039482	778	750	762	44	4	11	734
FBgn0039485	756	750	720	42	8	5.25	714
FBgn0039486	778	750	768	38	10	3.8	740
FBgn0039488	751	750	751	1	1	1	750
FBgn0039489	751	750	751	1	1	1	750
FBgn0039491	753	750	750	6	3	2	747
FBgn0039494	760	750	758	12	5	2.4	748
FBgn0039495	789	750	776	52	8	6.5	737
FBgn0039503	750	750	750	0	0	NA	750
FBgn0039504	774	750	763	35	3	11.666666666666666	739
FBgn0039505	753	750	739	17	6	2.8333333333333335	736
FBgn0039507	793	750	792	44	7	6.285714285714286	749
FBgn0039508	825	750	813	87	14	6.214285714285714	738
FBgn0039509	781	750	780	32	5	6.4	749
FBgn0039510	756	750	746	16	3	5.333333333333333	740
FBgn0039511	785	750	769	51	7	7.285714285714286	734
FBgn0039518	755	750	692	68	8	8.5	687
FBgn0039519	776	750	744	58	9	6.444444444444445	718
FBgn0039520	766	750	735	47	4	11.75	719
FBgn0039522	766	750	746	36	5	7.2	730
FBgn0039523	751	750	674	78	3	26	673
FBgn0039527	761	750	741	31	8	3.875	730
FBgn0039528	781	750	754	58	12	4.833333333333333	723
FBgn0039529	770	750	739	51	8	6.375	719
FBgn0039530	781	750	759	53	11	4.818181818181818	728
FBgn0039531	761	750	754	18	6	3	743
FBgn0039532	752	750	733	21	3	7	731
FBgn0039536	769	750	742	46	5	9.2	723
FBgn0039537	664	626	644	58	9	6.444444444444445	606
FBgn0039543	750	750	726	24	4	6	726
FBgn0039544	750	750	721	29	6	4.833333333333333	721
FBgn0039551	535	535	447	88	7	12.571428571428571	447
FBgn0039554	753	750	592	164	4	41	589
FBgn0039555	785	750	733	87	8	10.875	698
FBgn0039558	776	750	747	55	9	6.111111111111111	721
FBgn0039559	802	750	778	76	11	6.909090909090909	726
FBgn0039560	797	750	771	73	8	9.125	724
FBgn0039561	769	750	765	23	6	3.8333333333333335	746
FBgn0039562	769	750	765	23	6	3.8333333333333335	746
FBgn0039563	770	750	751	39	9	4.333333333333333	731
FBgn0039564	769	750	754	34	9	3.7777777777777777	735
FBgn0039568	770	750	753	37	7	5.285714285714286	733
FBgn0039577	750	750	749	1	1	1	749
FBgn0039580	651	646	649	7	5	1.4	644
FBgn0039581	755	750	749	11	6	1.8333333333333333	744
FBgn0039582	750	750	746	4	2	2	746
FBgn0039584	759	750	751	17	3	5.666666666666667	742
FBgn0039585	750	750	616	134	4	33.5	616
FBgn0039588	780	750	756	54	10	5.4	726
FBgn0039589	640	617	617	46	8	5.75	594
FBgn0039590	752	750	365	389	3	129.66666666666666	363
FBgn0039592	756	750	744	18	4	4.5	738
FBgn0039594	751	750	702	50	6	8.333333333333334	701
FBgn0039595	763	750	755	21	6	3.5	742
FBgn0039596	750	750	743	7	2	3.5	743
FBgn0039600	769	750	699	89	7	12.714285714285714	680
FBgn0039601	760	750	750	20	7	2.857142857142857	740
FBgn0039602	760	750	747	23	8	2.875	737
FBgn0039609	750	750	749	1	1	1	749
FBgn0039611	662	660	660	4	3	1.3333333333333333	658
FBgn0039613	754	750	726	32	6	5.333333333333333	722
FBgn0039616	757	750	724	40	7	5.714285714285714	717
FBgn0039617	752	750	731	23	4	5.75	729
FBgn0039620	760	750	731	39	7	5.571428571428571	721
FBgn0039621	752	750	743	11	2	5.5	741
FBgn0039622	750	750	749	1	1	1	749
FBgn0039623	779	750	741	67	5	13.4	712
FBgn0039625	752	750	732	22	6	3.6666666666666665	730
FBgn0039626	750	750	744	6	2	3	744
FBgn0039627	751	750	707	45	4	11.25	706
FBgn0039629	513	513	497	16	3	5.333333333333333	497
FBgn0039630	595	570	275	345	8	43.125	250
FBgn0039632	751	750	748	4	4	1	747
FBgn0039633	752	750	751	3	3	1	749
FBgn0039634	750	750	707	43	5	8.6	707
FBgn0039635	761	750	731	41	5	8.2	720
FBgn0039637	751	750	735	17	2	8.5	734
FBgn0039638	750	750	741	9	5	1.8	741
FBgn0039639	755	750	752	8	2	4	747
FBgn0039640	750	750	750	0	0	NA	750
FBgn0039642	762	750	761	13	6	2.1666666666666665	749
FBgn0039644	762	750	684	90	10	9	672
FBgn0039645	778	750	775	31	4	7.75	747
FBgn0039647	822	750	794	100	11	9.090909090909092	722
FBgn0039648	750	750	721	29	3	9.666666666666666	721
FBgn0039651	750	750	731	19	5	3.8	731
FBgn0039654	761	750	760	12	2	6	749
FBgn0039655	753	750	712	44	5	8.8	709
FBgn0039659	760	750	758	12	3	4	748
FBgn0039663	764	750	754	24	4	6	740
FBgn0039664	772	750	764	30	4	7.5	742
FBgn0039665	774	750	738	60	4	15	714
FBgn0039666	790	750	775	55	9	6.111111111111111	735
FBgn0039667	595	555	580	55	10	5.5	540
FBgn0039668	753	750	740	16	4	4	737
FBgn0039669	770	750	735	55	7	7.857142857142857	715
FBgn0039670	794	750	656	182	14	13	612
FBgn0039673	795	750	790	50	8	6.25	745
FBgn0039674	750	750	714	36	5	7.2	714
FBgn0039675	759	750	750	18	5	3.6	741
FBgn0039676	765	750	759	21	3	7	744
FBgn0039677	750	750	743	7	3	2.3333333333333335	743
FBgn0039680	751	750	746	6	4	1.5	745
FBgn0039681	764	750	751	27	7	3.857142857142857	737
FBgn0039682	750	750	731	19	4	4.75	731
FBgn0039683	778	750	772	34	5	6.8	744
FBgn0039684	798	750	788	58	11	5.2727272727272725	740
FBgn0039685	755	750	735	25	6	4.166666666666667	730
FBgn0039686	751	750	733	19	3	6.333333333333333	732
FBgn0039687	755	750	755	5	1	5	750
FBgn0039689	750	750	739	11	3	3.6666666666666665	739
FBgn0039691	750	750	732	18	4	4.5	732
FBgn0039694	790	750	762	68	13	5.230769230769231	722
FBgn0039696	782	750	769	45	6	7.5	737
FBgn0039697	751	750	749	3	2	1.5	748
FBgn0039698	750	750	749	1	1	1	749
FBgn0039703	765	750	746	34	9	3.7777777777777777	731
FBgn0039704	768	750	743	43	6	7.166666666666667	725
FBgn0039707	769	750	626	162	4	40.5	607
FBgn0039709	767	750	742	42	7	6	725
FBgn0039712	750	750	714	36	4	9	714
FBgn0039713	750	750	748	2	1	2	748
FBgn0039714	761	750	753	19	5	3.8	742
FBgn0039718	761	750	719	53	15	3.533333333333333	708
FBgn0039719	750	750	745	5	3	1.6666666666666667	745
FBgn0039722	754	750	722	36	4	9	718
FBgn0039723	751	750	732	20	4	5	731
FBgn0039726	750	750	735	15	3	5	735
FBgn0039727	750	750	726	24	3	8	726
FBgn0039728	802	750	777	77	10	7.7	725
FBgn0039730	750	750	750	0	0	NA	750
FBgn0039731	755	750	752	8	3	2.6666666666666665	747
FBgn0039732	750	750	750	0	0	NA	750
FBgn0039733	750	750	744	6	2	3	744
FBgn0039735	752	750	745	9	4	2.25	743
FBgn0039736	754	750	750	8	2	4	746
FBgn0039737	752	750	745	9	3	3	743
FBgn0039739	752	750	751	3	3	1	749
FBgn0039741	756	750	755	7	2	3.5	749
FBgn0039742	750	750	718	32	4	8	718
FBgn0039747	778	750	772	34	5	6.8	744
FBgn0039748	761	750	712	60	5	12	701
FBgn0039749	793	750	787	49	6	8.166666666666666	744
FBgn0039751	751	750	736	16	5	3.2	735
FBgn0039752	750	750	738	12	4	3	738
FBgn0039754	762	750	748	26	9	2.888888888888889	736
FBgn0039756	769	750	740	48	3	16	721
FBgn0039757	813	750	807	69	9	7.666666666666667	744
FBgn0039758	771	750	736	56	8	7	715
FBgn0039759	770	750	740	50	9	5.555555555555555	720
FBgn0039764	641	641	641	0	0	NA	641
FBgn0039765	754	750	744	14	3	4.666666666666667	740
FBgn0039766	755	750	723	37	8	4.625	718
FBgn0039767	778	750	773	33	7	4.714285714285714	745
FBgn0039768	778	750	775	31	7	4.428571428571429	747
FBgn0039769	797	750	784	60	9	6.666666666666667	737
FBgn0039770	554	549	549	10	6	1.6666666666666667	544
FBgn0039771	751	750	731	21	3	7	730
FBgn0039773	797	750	751	93	12	7.75	704
FBgn0039774	773	750	717	79	5	15.8	694
FBgn0039780	754	750	722	36	4	9	718
FBgn0039782	759	750	742	26	7	3.7142857142857144	733
FBgn0039787	761	750	758	14	4	3.5	747
FBgn0039788	835	750	826	94	11	8.545454545454545	741
FBgn0039789	781	750	762	50	4	12.5	731
FBgn0039792	753	750	724	32	5	6.4	721
FBgn0039795	750	750	749	1	1	1	749
FBgn0039797	755	750	684	76	8	9.5	679
FBgn0039798	774	750	745	53	10	5.3	721
FBgn0039799	750	750	745	5	2	2.5	745
FBgn0039800	617	523	614	97	9	10.777777777777779	520
FBgn0039802	764	750	747	31	8	3.875	733
FBgn0039804	772	750	756	38	9	4.222222222222222	734
FBgn0039805	788	750	782	44	6	7.333333333333333	744
FBgn0039806	782	750	755	59	10	5.9	723
FBgn0039807	767	750	690	94	11	8.545454545454545	673
FBgn0039808	781	750	745	67	7	9.571428571428571	714
FBgn0039811	784	750	768	50	9	5.555555555555555	734
FBgn0039812	765	750	748	32	3	10.666666666666666	733
FBgn0039816	763	750	750	26	4	6.5	737
FBgn0039817	759	750	717	51	8	6.375	708
FBgn0039818	784	750	760	58	8	7.25	726
FBgn0039820	773	750	760	36	5	7.2	737
FBgn0039821	756	750	739	23	9	2.5555555555555554	733
FBgn0039828	760	750	751	19	3	6.333333333333333	741
FBgn0039829	762	750	748	26	5	5.2	736
FBgn0039830	766	750	675	107	13	8.23076923076923	659
FBgn0039831	771	750	706	86	10	8.6	685
FBgn0039833	759	750	749	19	4	4.75	740
FBgn0039835	752	750	752	2	1	2	750
FBgn0039836	776	750	768	34	5	6.8	742
FBgn0039838	758	750	717	49	9	5.444444444444445	709
FBgn0039839	750	750	735	15	2	7.5	735
FBgn0039840	770	750	744	46	8	5.75	724
FBgn0039844	758	750	748	18	9	2	740
FBgn0039846	764	750	763	15	4	3.75	749
FBgn0039849	753	750	739	17	5	3.4	736
FBgn0039850	753	750	740	16	7	2.2857142857142856	737
FBgn0039852	783	750	778	38	5	7.6	745
FBgn0039854	568	565	555	16	5	3.2	552
FBgn0039856	684	684	674	10	3	3.3333333333333335	674
FBgn0039857	788	750	773	53	6	8.833333333333334	735
FBgn0039858	753	750	749	7	3	2.3333333333333335	746
FBgn0039859	751	750	738	14	4	3.5	737
FBgn0039860	753	750	741	15	5	3	738
FBgn0039863	764	750	731	47	9	5.222222222222222	717
FBgn0039864	715	715	703	12	4	3	703
FBgn0039867	750	750	742	8	1	8	742
FBgn0039868	755	750	752	8	2	4	747
FBgn0039869	750	750	750	0	0	NA	750
FBgn0039872	735	728	692	50	5	10	685
FBgn0039875	756	750	739	23	7	3.2857142857142856	733
FBgn0039876	761	750	741	31	10	3.1	730
FBgn0039877	750	750	742	8	4	2	742
FBgn0039879	767	750	766	18	2	9	749
FBgn0039881	750	750	739	11	4	2.75	739
FBgn0039882	752	750	747	7	4	1.75	745
FBgn0039883	777	750	773	31	4	7.75	746
FBgn0039889	767	750	526	258	12	21.5	509
FBgn0039902	776	750	424	378	9	42	398
FBgn0039907	791	750	566	266	15	17.733333333333334	525
FBgn0039908	760	750	721	49	9	5.444444444444445	711
FBgn0039909	756	750	641	121	6	20.166666666666668	635
FBgn0039911	750	750	29	721	2	360.5	29
FBgn0039916	781	750	756	56	11	5.090909090909091	725
FBgn0039920	763	750	315	461	6	76.83333333333333	302
FBgn0039928	807	750	750	114	19	6	693
FBgn0039929	761	750	721	51	11	4.636363636363637	710
FBgn0039930	667	609	653	72	12	6	595
FBgn0039932	783	750	770	46	9	5.111111111111111	737
FBgn0039937	839	750	817	111	12	9.25	728
FBgn0039938	760	750	591	179	10	17.9	581
FBgn0039941	778	750	720	86	11	7.818181818181818	692
FBgn0039942	750	750	748	2	2	1	748
FBgn0039943	755	750	728	32	7	4.571428571428571	723
FBgn0039944	795	750	731	109	15	7.266666666666667	686
FBgn0039965	760	750	728	42	6	7	718
FBgn0039966	750	750	698	52	2	26	698
FBgn0039969	750	750	245	505	3	168.33333333333334	245
FBgn0039970	843	750	567	369	15	24.6	474
FBgn0039977	750	750	28	722	2	361	28
FBgn0040007	750	750	271	479	3	159.66666666666666	271
FBgn0040009	750	750	48	702	2	351	48
FBgn0040011	758	750	410	356	8	44.5	402
FBgn0040020	760	750	415	355	2	177.5	405
FBgn0040031	765	750	717	63	14	4.5	702
FBgn0040060	757	750	756	8	2	4	749
FBgn0040063	790	750	776	54	8	6.75	736
FBgn0040064	675	663	650	37	9	4.111111111111111	638
FBgn0040066	760	750	736	34	5	6.8	726
FBgn0040068	795	750	772	68	9	7.555555555555555	727
FBgn0040069	785	750	755	65	13	5	720
FBgn0040070	630	630	570	60	7	8.571428571428571	570
FBgn0040071	773	750	754	42	12	3.5	731
FBgn0040075	844	750	827	111	10	11.1	733
FBgn0040078	751	750	748	4	3	1.3333333333333333	747
FBgn0040079	777	750	764	40	7	5.714285714285714	737
FBgn0040080	808	750	801	65	9	7.222222222222222	743
FBgn0040087	755	750	753	7	4	1.75	748
FBgn0040089	768	750	749	37	5	7.4	731
FBgn0040091	754	750	736	22	7	3.142857142857143	732
FBgn0040092	754	750	741	17	4	4.25	737
FBgn0040093	792	750	780	54	8	6.75	738
FBgn0040097	796	750	775	67	6	11.166666666666666	729
FBgn0040099	794	750	616	222	6	37	572
FBgn0040102	757	750	756	8	5	1.6	749
FBgn0040106	750	750	709	41	3	13.666666666666666	709
FBgn0040107	751	750	746	6	3	2	745
FBgn0040153	795	750	779	61	9	6.777777777777778	734
FBgn0040207	753	750	751	5	3	1.6666666666666667	748
FBgn0040208	774	750	769	29	9	3.2222222222222223	745
FBgn0040211	789	750	788	40	3	13.333333333333334	749
FBgn0040228	769	750	712	76	6	12.666666666666666	693
FBgn0040230	768	750	758	28	9	3.111111111111111	740
FBgn0040234	750	750	732	18	3	6	732
FBgn0040235	750	750	614	136	5	27.2	614
FBgn0040236	799	750	773	75	10	7.5	724
FBgn0040250	751	750	745	7	4	1.75	744
FBgn0040252	776	750	744	58	9	6.444444444444445	718
FBgn0040255	642	606	534	144	8	18	498
FBgn0040256	805	750	777	83	14	5.928571428571429	722
FBgn0040259	605	584	411	215	5	43	390
FBgn0040260	786	750	765	57	15	3.8	729
FBgn0040262	807	750	795	69	12	5.75	738
FBgn0040268	750	750	736	14	2	7	736
FBgn0040271	765	750	749	31	4	7.75	734
FBgn0040273	757	750	755	9	3	3	748
FBgn0040281	753	750	339	417	4	104.25	336
FBgn0040283	767	750	707	77	10	7.7	690
FBgn0040285	783	750	777	39	4	9.75	744
FBgn0040291	532	521	427	116	11	10.545454545454545	416
FBgn0040294	762	750	755	19	5	3.8	743
FBgn0040296	764	750	657	121	11	11	643
FBgn0040298	539	510	531	37	6	6.166666666666667	502
FBgn0040299	752	750	726	28	3	9.333333333333334	724
FBgn0040305	798	750	787	59	5	11.8	739
FBgn0040309	757	750	733	31	8	3.875	726
FBgn0040318	761	750	758	14	5	2.8	747
FBgn0040319	770	750	763	27	6	4.5	743
FBgn0040321	763	750	711	65	7	9.285714285714286	698
FBgn0040322	763	750	754	22	3	7.333333333333333	741
FBgn0040323	769	750	754	34	6	5.666666666666667	735
FBgn0040324	767	750	497	287	10	28.7	480
FBgn0040333	772	750	747	47	8	5.875	725
FBgn0040334	757	750	752	12	3	4	745
FBgn0040338	763	750	734	42	5	8.4	721
FBgn0040339	751	750	689	63	6	10.5	688
FBgn0040341	765	750	736	44	6	7.333333333333333	721
FBgn0040342	781	750	778	34	8	4.25	747
FBgn0040345	750	750	726	24	2	12	726
FBgn0040346	750	750	746	4	2	2	746
FBgn0040347	750	750	746	4	2	2	746
FBgn0040348	773	750	761	35	6	5.833333333333333	738
FBgn0040349	759	750	747	21	8	2.625	738
FBgn0040350	762	750	750	24	4	6	738
FBgn0040351	774	750	713	85	3	28.333333333333332	689
FBgn0040352	767	750	706	78	12	6.5	689
FBgn0040353	767	750	743	41	13	3.1538461538461537	726
FBgn0040354	752	750	704	50	10	5	702
FBgn0040357	756	750	750	12	4	3	744
FBgn0040358	794	750	787	51	7	7.285714285714286	743
FBgn0040360	760	750	752	18	5	3.6	742
FBgn0040361	751	750	700	52	6	8.666666666666666	699
FBgn0040363	763	750	762	14	3	4.666666666666667	749
FBgn0040364	754	750	699	59	9	6.555555555555555	695
FBgn0040366	759	750	751	17	3	5.666666666666667	742
FBgn0040367	772	750	734	60	9	6.666666666666667	712
FBgn0040368	758	750	676	90	2	45	668
FBgn0040372	754	750	751	7	4	1.75	747
FBgn0040373	766	750	724	58	6	9.666666666666666	708
FBgn0040375	750	750	738	12	3	4	738
FBgn0040376	763	750	718	58	13	4.461538461538462	705
FBgn0040377	767	750	725	59	15	3.933333333333333	708
FBgn0040383	753	750	747	9	3	3	744
FBgn0040385	775	750	775	25	5	5	750
FBgn0040388	761	750	725	47	9	5.222222222222222	714
FBgn0040389	754	750	713	45	11	4.090909090909091	709
FBgn0040392	794	750	736	102	16	6.375	692
FBgn0040393	763	750	684	92	14	6.571428571428571	671
FBgn0040394	751	750	743	9	4	2.25	742
FBgn0040395	750	750	738	12	4	3	738
FBgn0040396	765	750	705	75	19	3.9473684210526314	690
FBgn0040397	770	750	765	25	7	3.5714285714285716	745
FBgn0040466	751	750	495	257	5	51.4	494
FBgn0040467	750	750	744	6	2	3	744
FBgn0040475	788	750	775	51	6	8.5	737
FBgn0040477	756	750	756	6	2	3	750
FBgn0040487	765	750	650	130	5	26	635
FBgn0040491	759	750	750	18	3	6	741
FBgn0040496	778	750	737	69	9	7.666666666666667	709
FBgn0040502	764	750	763	15	3	5	749
FBgn0040503	766	750	744	38	8	4.75	728
FBgn0040505	771	750	755	37	6	6.166666666666667	734
FBgn0040506	750	750	723	27	4	6.75	723
FBgn0040507	767	750	766	18	3	6	749
FBgn0040508	750	750	747	3	2	1.5	747
FBgn0040512	767	750	761	23	5	4.6	744
FBgn0040524	750	750	746	4	2	2	746
FBgn0040529	751	750	750	2	2	1	749
FBgn0040531	758	750	757	9	2	4.5	749
FBgn0040532	813	750	793	83	7	11.857142857142858	730
FBgn0040534	751	750	743	9	5	1.8	742
FBgn0040551	775	750	749	51	11	4.636363636363637	724
FBgn0040565	635	537	616	117	10	11.7	518
FBgn0040569	798	750	523	323	8	40.375	475
FBgn0040575	770	750	734	56	6	9.333333333333334	714
FBgn0040582	796	750	784	58	8	7.25	738
FBgn0040588	542	542	511	31	6	5.166666666666667	511
FBgn0040600	811	750	811	61	7	8.714285714285714	750
FBgn0040601	770	750	712	78	7	11.142857142857142	692
FBgn0040602	758	750	756	10	4	2.5	748
FBgn0040607	761	750	744	28	8	3.5	733
FBgn0040608	789	750	734	94	11	8.545454545454545	695
FBgn0040609	770	750	753	37	8	4.625	733
FBgn0040623	664	597	613	118	12	9.833333333333334	546
FBgn0040629	770	750	762	28	5	5.6	742
FBgn0040634	750	750	750	0	0	NA	750
FBgn0040636	538	532	528	16	7	2.2857142857142856	522
FBgn0040648	757	750	745	19	5	3.8	738
FBgn0040649	760	750	556	214	14	15.285714285714286	546
FBgn0040650	717	697	691	46	6	7.666666666666667	671
FBgn0040653	779	750	766	42	12	3.5	737
FBgn0040660	766	750	581	201	5	40.2	565
FBgn0040674	773	750	769	27	5	5.4	746
FBgn0040679	760	750	754	16	4	4	744
FBgn0040688	753	750	483	273	4	68.25	480
FBgn0040694	767	750	749	35	5	7	732
FBgn0040699	753	750	745	11	4	2.75	742
FBgn0040705	750	750	724	26	4	6.5	724
FBgn0040717	735	725	704	41	4	10.25	694
FBgn0040718	756	750	702	60	5	12	696
FBgn0040725	754	750	738	20	4	5	734
FBgn0040726	797	750	777	67	12	5.583333333333333	730
FBgn0040729	808	750	804	62	9	6.888888888888889	746
FBgn0040730	754	750	441	317	9	35.22222222222222	437
FBgn0040732	776	750	619	183	8	22.875	593
FBgn0040733	767	750	759	25	5	5	742
FBgn0040734	576	562	409	181	8	22.625	395
FBgn0040735	621	619	593	30	6	5	591
FBgn0040736	753	750	474	282	10	28.2	471
FBgn0040737	778	750	755	51	6	8.5	727
FBgn0040743	761	750	756	16	5	3.2	745
FBgn0040747	750	750	722	28	6	4.666666666666667	722
FBgn0040751	750	750	733	17	4	4.25	733
FBgn0040752	757	750	747	17	5	3.4	740
FBgn0040754	755	750	754	6	4	1.5	749
FBgn0040755	762	750	760	14	5	2.8	748
FBgn0040759	787	750	781	43	11	3.909090909090909	744
FBgn0040764	778	750	601	205	5	41	573
FBgn0040765	761	750	715	57	5	11.4	704
FBgn0040773	797	750	762	82	8	10.25	715
FBgn0040777	784	750	766	52	6	8.666666666666666	732
FBgn0040778	759	750	756	12	3	4	747
FBgn0040793	751	750	750	2	2	1	749
FBgn0040796	752	750	717	37	5	7.4	715
FBgn0040797	753	750	695	61	4	15.25	692
FBgn0040801	772	750	624	170	3	56.666666666666664	602
FBgn0040805	752	750	509	245	7	35	507
FBgn0040809	770	750	487	303	8	37.875	467
FBgn0040812	752	750	569	185	3	61.666666666666664	567
FBgn0040814	777	750	757	47	4	11.75	730
FBgn0040816	762	750	477	297	10	29.7	465
FBgn0040817	849	750	849	99	6	16.5	750
FBgn0040823	798	750	778	68	9	7.555555555555555	730
FBgn0040827	781	750	747	65	11	5.909090909090909	716
FBgn0040828	751	750	749	3	3	1	748
FBgn0040832	773	750	733	63	8	7.875	710
FBgn0040837	780	750	704	106	11	9.636363636363637	674
FBgn0040842	754	750	707	51	6	8.5	703
FBgn0040843	763	750	755	21	8	2.625	742
FBgn0040849	753	750	255	501	2	250.5	252
FBgn0040850	776	750	716	86	10	8.6	690
FBgn0040871	779	750	747	61	10	6.1	718
FBgn0040892	787	750	733	91	10	9.1	696
FBgn0040899	751	750	749	3	2	1.5	748
FBgn0040900	750	750	747	3	2	1.5	747
FBgn0040905	768	750	755	31	6	5.166666666666667	737
FBgn0040907	768	750	755	31	7	4.428571428571429	737
FBgn0040918	780	750	767	43	12	3.5833333333333335	737
FBgn0040922	654	635	639	34	7	4.857142857142857	620
FBgn0040928	752	750	693	61	8	7.625	691
FBgn0040929	754	750	751	7	2	3.5	747
FBgn0040941	775	750	751	49	8	6.125	726
FBgn0040942	750	750	691	59	8	7.375	691
FBgn0040958	791	750	739	93	17	5.470588235294118	698
FBgn0040959	815	750	812	68	8	8.5	747
FBgn0040964	750	750	744	6	2	3	744
FBgn0040967	757	750	735	29	7	4.142857142857143	728
FBgn0040972	751	750	734	18	3	6	733
FBgn0040984	808	750	775	91	17	5.352941176470588	717
FBgn0040985	769	750	764	24	8	3	745
FBgn0040989	752	750	729	25	3	8.333333333333334	727
FBgn0040996	761	750	739	33	11	3	728
FBgn0041004	809	750	634	234	11	21.272727272727273	575
FBgn0041087	771	750	654	138	18	7.666666666666667	633
FBgn0041092	753	750	750	6	4	1.5	747
FBgn0041094	763	750	739	37	11	3.3636363636363638	726
FBgn0041096	770	750	746	44	8	5.5	726
FBgn0041097	751	750	716	36	3	12	715
FBgn0041100	642	628	642	14	1	14	628
FBgn0041103	771	750	757	35	7	5	736
FBgn0041105	766	750	737	45	6	7.5	721
FBgn0041111	786	750	749	73	9	8.11111111111111	713
FBgn0041150	764	750	734	44	10	4.4	720
FBgn0041156	761	750	761	11	3	3.6666666666666665	750
FBgn0041160	751	750	695	57	7	8.142857142857142	694
FBgn0041171	760	750	702	68	8	8.5	692
FBgn0041174	750	750	743	7	4	1.75	743
FBgn0041180	778	750	726	80	15	5.333333333333333	698
FBgn0041181	769	750	759	29	10	2.9	740
FBgn0041183	754	750	707	51	14	3.642857142857143	703
FBgn0041184	847	750	793	151	11	13.727272727272727	696
FBgn0041186	752	750	747	7	2	3.5	745
FBgn0041188	750	750	743	7	3	2.3333333333333335	743
FBgn0041191	757	750	743	21	6	3.5	736
FBgn0041194	753	750	730	26	5	5.2	727
FBgn0041195	825	750	812	88	10	8.8	737
FBgn0041205	765	750	754	26	4	6.5	739
FBgn0041210	772	750	740	54	5	10.8	718
FBgn0041224	757	750	745	19	5	3.8	738
FBgn0041225	750	750	747	3	1	3	747
FBgn0041229	811	750	752	120	8	15	691
FBgn0041231	784	750	753	65	8	8.125	719
FBgn0041232	751	750	730	22	4	5.5	729
FBgn0041233	759	750	759	9	1	9	750
FBgn0041234	750	750	750	0	0	NA	750
FBgn0041237	755	750	737	23	6	3.8333333333333335	732
FBgn0041238	750	750	750	0	0	NA	750
FBgn0041239	750	750	750	0	0	NA	750
FBgn0041240	828	750	807	99	6	16.5	729
FBgn0041242	754	750	742	16	5	3.2	738
FBgn0041243	507	507	504	3	1	3	504
FBgn0041246	795	750	702	138	12	11.5	657
FBgn0041249	818	750	800	86	7	12.285714285714286	732
FBgn0041250	757	750	717	47	6	7.833333333333333	710
FBgn0041252	759	750	734	34	4	8.5	725
FBgn0041337	756	750	483	279	3	93	477
FBgn0041342	763	750	752	24	5	4.8	739
FBgn0041581	769	750	764	24	9	2.6666666666666665	745
FBgn0041582	751	750	747	5	2	2.5	746
FBgn0041585	778	750	772	34	9	3.7777777777777777	744
FBgn0041605	750	750	522	228	2	114	522
FBgn0041622	755	750	728	32	9	3.5555555555555554	723
FBgn0041623	558	558	128	430	4	107.5	128
FBgn0041624	764	750	756	22	6	3.6666666666666665	742
FBgn0041625	750	750	749	1	1	1	749
FBgn0041629	797	750	762	82	10	8.2	715
FBgn0041702	758	750	734	32	5	6.4	726
FBgn0041706	751	750	745	7	2	3.5	744
FBgn0041709	770	750	752	38	8	4.75	732
FBgn0041711	751	750	750	2	2	1	749
FBgn0041712	750	750	749	1	1	1	749
FBgn0041713	750	750	713	37	7	5.285714285714286	713
FBgn0041717	754	750	745	13	4	3.25	741
FBgn0041719	757	750	755	9	4	2.25	748
FBgn0041721	798	750	787	59	10	5.9	739
FBgn0041775	751	750	734	18	4	4.5	733
FBgn0041781	754	750	727	31	7	4.428571428571429	723
FBgn0041789	757	750	754	10	3	3.3333333333333335	747
FBgn0042083	674	642	659	47	11	4.2727272727272725	627
FBgn0042085	764	750	740	38	5	7.6	726
FBgn0042092	789	750	775	53	5	10.6	736
FBgn0042101	777	750	752	52	5	10.4	725
FBgn0042103	756	750	756	6	1	6	750
FBgn0042110	750	750	719	31	3	10.333333333333334	719
FBgn0042111	750	750	724	26	6	4.333333333333333	724
FBgn0042118	797	750	785	59	10	5.9	738
FBgn0042125	750	750	734	16	2	8	734
FBgn0042126	659	658	653	7	4	1.75	652
FBgn0042146	820	750	729	161	9	17.88888888888889	659
FBgn0042179	756	750	703	59	10	5.9	697
FBgn0042185	770	750	757	33	4	8.25	737
FBgn0042189	764	750	713	65	10	6.5	699
FBgn0042198	750	750	720	30	8	3.75	720
FBgn0042201	788	750	732	94	11	8.545454545454545	694
FBgn0042205	763	750	763	13	2	6.5	750
FBgn0042206	516	505	508	19	9	2.111111111111111	497
FBgn0042213	750	750	750	0	0	NA	750
FBgn0042630	751	750	751	1	1	1	750
FBgn0042693	806	750	767	95	10	9.5	711
FBgn0042712	752	750	726	28	6	4.666666666666667	724
FBgn0043001	751	750	471	281	6	46.833333333333336	470
FBgn0043002	750	750	749	1	1	1	749
FBgn0043005	774	750	743	55	11	5	719
FBgn0043010	752	750	749	5	3	1.6666666666666667	747
FBgn0043012	750	750	748	2	1	2	748
FBgn0043362	758	750	744	22	4	5.5	736
FBgn0043364	751	750	728	24	3	8	727
FBgn0043455	761	750	760	12	3	4	749
FBgn0043456	785	750	769	51	8	6.375	734
FBgn0043457	751	750	714	38	6	6.333333333333333	713
FBgn0043458	571	569	562	11	6	1.8333333333333333	560
FBgn0043470	750	750	713	37	7	5.285714285714286	713
FBgn0043471	558	523	546	47	6	7.833333333333333	511
FBgn0043530	794	750	781	57	8	7.125	737
FBgn0043532	750	750	744	6	4	1.5	744
FBgn0043533	557	543	543	28	9	3.111111111111111	529
FBgn0043539	750	750	741	9	5	1.8	741
FBgn0043550	766	750	701	81	6	13.5	685
FBgn0043575	795	750	768	72	10	7.2	723
FBgn0043577	750	750	746	4	1	4	746
FBgn0043578	604	567	570	71	10	7.1	533
FBgn0043783	776	750	296	506	3	168.66666666666666	270
FBgn0043791	812	750	810	64	4	16	748
FBgn0043792	756	750	753	9	3	3	747
FBgn0043796	769	750	727	61	9	6.777777777777778	708
FBgn0043806	756	750	671	91	8	11.375	665
FBgn0043825	639	595	623	60	7	8.571428571428571	579
FBgn0043841	802	750	771	83	12	6.916666666666667	719
FBgn0043854	767	750	724	60	9	6.666666666666667	707
FBgn0043884	758	750	757	9	3	3	749
FBgn0043900	750	750	750	0	0	NA	750
FBgn0043903	751	750	741	11	2	5.5	740
FBgn0044020	754	750	752	6	4	1.5	748
FBgn0044030	758	750	750	16	4	4	742
FBgn0044046	788	750	748	78	14	5.571428571428571	710
FBgn0044047	776	750	736	66	9	7.333333333333333	710
FBgn0044048	778	750	754	52	11	4.7272727272727275	726
FBgn0044049	782	750	774	40	4	10	742
FBgn0044050	777	750	759	45	5	9	732
FBgn0044323	777	750	744	60	11	5.454545454545454	717
FBgn0044328	777	750	764	40	8	5	737
FBgn0044452	798	750	779	67	6	11.166666666666666	731
FBgn0044511	801	750	777	75	9	8.333333333333334	726
FBgn0044809	751	750	722	30	5	6	721
FBgn0044810	764	750	747	31	3	10.333333333333334	733
FBgn0044811	756	677	698	137	15	9.133333333333333	619
FBgn0044812	756	750	501	261	11	23.727272727272727	495
FBgn0044826	753	750	693	63	9	7	690
FBgn0044871	777	750	763	41	6	6.833333333333333	736
FBgn0045035	775	750	772	28	8	3.5	747
FBgn0045038	553	545	548	13	3	4.333333333333333	540
FBgn0045063	758	750	215	551	6	91.83333333333333	207
FBgn0045064	763	750	722	54	9	6	709
FBgn0045073	750	750	724	26	6	4.333333333333333	724
FBgn0045443	772	750	506	288	5	57.6	484
FBgn0045471	751	750	730	22	6	3.6666666666666665	729
FBgn0045473	750	750	733	17	4	4.25	733
FBgn0045474	759	750	738	30	6	5	729
FBgn0045479	787	750	742	82	10	8.2	705
FBgn0045483	796	750	446	396	8	49.5	400
FBgn0045495	797	750	783	61	9	6.777777777777778	736
FBgn0045497	786	750	782	40	4	10	746
FBgn0045759	750	750	747	3	3	1	747
FBgn0045770	662	641	655	28	7	4	634
FBgn0045823	770	750	757	33	4	8.25	737
FBgn0045842	769	750	729	59	16	3.6875	710
FBgn0045843	811	750	796	76	10	7.6	735
FBgn0045852	758	750	744	22	5	4.4	736
FBgn0045862	755	750	732	28	5	5.6	727
FBgn0045866	751	750	748	4	4	1	747
FBgn0046113	785	750	778	42	7	6	743
FBgn0046114	761	750	751	21	5	4.2	740
FBgn0046225	563	561	544	21	3	7	542
FBgn0046253	789	750	780	48	7	6.857142857142857	741
FBgn0046258	763	750	700	76	7	10.857142857142858	687
FBgn0046294	771	750	765	27	7	3.857142857142857	744
FBgn0046296	646	630	613	49	11	4.454545454545454	597
FBgn0046297	780	750	765	45	7	6.428571428571429	735
FBgn0046301	771	750	472	320	7	45.714285714285715	451
FBgn0046302	813	750	748	128	13	9.846153846153847	685
FBgn0046332	761	750	749	23	10	2.3	738
FBgn0046685	763	750	763	13	1	13	750
FBgn0046687	682	649	664	51	13	3.923076923076923	631
FBgn0046689	771	750	762	30	9	3.3333333333333335	741
FBgn0046692	773	750	448	348	12	29	425
FBgn0046704	754	750	716	42	7	6	712
FBgn0046756	780	750	755	55	9	6.111111111111111	725
FBgn0046763	761	750	757	15	3	5	746
FBgn0046873	793	750	464	372	5	74.4	421
FBgn0046875	766	750	747	35	8	4.375	731
FBgn0046876	784	708	770	90	15	6	694
FBgn0046878	786	750	768	54	9	6	732
FBgn0046879	755	750	754	6	2	3	749
FBgn0046880	755	750	737	23	8	2.875	732
FBgn0046887	751	750	715	37	6	6.166666666666667	714
FBgn0047000	752	750	730	24	8	3	728
FBgn0047092	766	750	754	28	6	4.666666666666667	738
FBgn0047095	757	750	740	24	7	3.4285714285714284	733
FBgn0047114	750	750	750	0	0	NA	750
FBgn0047135	750	750	744	6	2	3	744
FBgn0047178	781	750	760	52	5	10.4	729
FBgn0047199	752	750	698	56	8	7	696
FBgn0047205	791	750	765	67	6	11.166666666666666	724
FBgn0047338	758	750	721	45	5	9	713
FBgn0047351	756	750	753	9	2	4.5	747
FBgn0050000	750	750	741	9	3	3	741
FBgn0050008	756	750	754	8	2	4	748
FBgn0050009	750	750	729	21	2	10.5	729
FBgn0050010	758	750	724	42	11	3.8181818181818183	716
FBgn0050016	776	750	720	82	9	9.11111111111111	694
FBgn0050020	509	502	472	44	10	4.4	465
FBgn0050021	787	747	773	54	11	4.909090909090909	733
FBgn0050033	750	750	745	5	2	2.5	745
FBgn0050035	764	750	473	305	8	38.125	459
FBgn0050037	797	750	722	122	13	9.384615384615385	675
FBgn0050039	760	750	752	18	8	2.25	742
FBgn0050042	770	750	761	29	6	4.833333333333333	741
FBgn0050045	756	750	750	12	4	3	744
FBgn0050047	719	714	716	8	3	2.6666666666666665	711
FBgn0050050	610	604	578	38	4	9.5	572
FBgn0050051	755	750	748	12	7	1.7142857142857142	743
FBgn0050052	588	582	577	17	6	2.8333333333333335	571
FBgn0050054	775	750	724	76	7	10.857142857142858	699
FBgn0050055	751	750	748	4	3	1.3333333333333333	747
FBgn0050067	751	750	747	5	3	1.6666666666666667	746
FBgn0050069	764	750	738	40	8	5	724
FBgn0050075	752	750	752	2	2	1	750
FBgn0050076	754	750	752	6	4	1.5	748
FBgn0050077	752	750	748	6	3	2	746
FBgn0050081	757	750	757	7	2	3.5	750
FBgn0050082	791	750	791	41	1	41	750
FBgn0050083	759	750	740	28	6	4.666666666666667	731
FBgn0050085	780	750	776	34	8	4.25	746
FBgn0050089	758	750	740	26	7	3.7142857142857144	732
FBgn0050090	796	750	707	135	16	8.4375	661
FBgn0050091	827	750	825	79	11	7.181818181818182	748
FBgn0050094	613	608	552	66	9	7.333333333333333	547
FBgn0050095	763	750	735	41	9	4.555555555555555	722
FBgn0050096	750	750	744	6	2	3	744
FBgn0050098	792	750	772	62	6	10.333333333333334	730
FBgn0050101	750	750	742	8	4	2	742
FBgn0050103	754	696	665	147	14	10.5	607
FBgn0050104	784	750	575	243	11	22.09090909090909	541
FBgn0050105	753	750	735	21	5	4.2	732
FBgn0050106	753	750	750	6	4	1.5	747
FBgn0050108	557	533	553	28	6	4.666666666666667	529
FBgn0050110	761	750	562	210	6	35	551
FBgn0050114	770	750	760	30	9	3.3333333333333335	740
FBgn0050121	766	750	734	48	11	4.363636363636363	718
FBgn0050125	762	750	757	17	4	4.25	745
FBgn0050145	702	669	689	46	7	6.571428571428571	656
FBgn0050147	766	750	718	64	6	10.666666666666666	702
FBgn0050151	750	750	741	9	5	1.8	741
FBgn0050157	752	750	744	10	7	1.4285714285714286	742
FBgn0050158	772	750	766	28	5	5.6	744
FBgn0050160	759	750	745	23	4	5.75	736
FBgn0050161	751	750	749	3	3	1	748
FBgn0050169	750	750	747	3	2	1.5	747
FBgn0050177	793	750	764	72	7	10.285714285714286	721
FBgn0050178	753	750	746	10	4	2.5	743
FBgn0050183	755	750	727	33	7	4.714285714285714	722
FBgn0050192	763	750	758	18	5	3.6	745
FBgn0050197	804	750	728	130	12	10.833333333333334	674
FBgn0050198	756	750	699	63	7	9	693
FBgn0050211	756	750	753	9	4	2.25	747
FBgn0050215	828	750	779	127	11	11.545454545454545	701
FBgn0050222	807	750	807	57	6	9.5	750
FBgn0050223	779	750	766	42	10	4.2	737
FBgn0050227	757	750	740	24	6	4	733
FBgn0050234	753	750	742	14	4	3.5	739
FBgn0050235	754	750	732	26	7	3.7142857142857144	728
FBgn0050241	806	750	785	77	9	8.555555555555555	729
FBgn0050250	718	689	680	67	9	7.444444444444445	651
FBgn0050257	758	750	751	15	6	2.5	743
FBgn0050259	768	750	748	38	4	9.5	730
FBgn0050263	750	750	644	106	4	26.5	644
FBgn0050265	748	730	736	30	10	3	718
FBgn0050272	760	750	751	19	4	4.75	741
FBgn0050279	772	750	766	28	5	5.6	744
FBgn0050280	751	750	728	24	3	8	727
FBgn0050284	800	750	787	63	5	12.6	737
FBgn0050285	761	750	746	26	7	3.7142857142857144	735
FBgn0050289	752	750	372	382	4	95.5	370
FBgn0050296	763	750	751	25	7	3.5714285714285716	738
FBgn0050299	759	750	755	13	4	3.25	746
FBgn0050334	765	750	686	94	11	8.545454545454545	671
FBgn0050339	750	750	748	2	2	1	748
FBgn0050342	750	750	745	5	2	2.5	745
FBgn0050343	775	750	773	27	5	5.4	748
FBgn0050355	750	750	741	9	2	4.5	741
FBgn0050359	760	750	597	173	11	15.727272727272727	587
FBgn0050361	752	750	748	6	5	1.2	746
FBgn0050369	754	750	731	27	5	5.4	727
FBgn0050371	808	750	800	66	8	8.25	742
FBgn0050372	804	750	800	58	4	14.5	746
FBgn0050373	750	750	742	8	1	8	742
FBgn0050376	758	750	754	12	4	3	746
FBgn0050379	757	750	746	18	4	4.5	739
FBgn0050380	759	750	707	61	11	5.545454545454546	698
FBgn0050383	775	750	727	73	8	9.125	702
FBgn0050389	569	517	549	72	8	9	497
FBgn0050390	752	750	745	9	5	1.8	743
FBgn0050393	751	750	724	28	8	3.5	723
FBgn0050394	784	750	775	43	5	8.6	741
FBgn0050395	810	750	784	86	8	10.75	724
FBgn0050398	752	750	745	9	4	2.25	743
FBgn0050401	751	750	749	3	3	1	748
FBgn0050403	769	750	745	43	5	8.6	726
FBgn0050404	754	750	750	8	4	2	746
FBgn0050406	754	750	713	45	7	6.428571428571429	709
FBgn0050407	751	750	724	28	3	9.333333333333334	723
FBgn0050409	784	750	765	53	8	6.625	731
FBgn0050411	770	750	741	49	9	5.444444444444445	721
FBgn0050412	767	750	754	30	6	5	737
FBgn0050413	758	750	682	84	6	14	674
FBgn0050414	524	509	510	29	10	2.9	495
FBgn0050416	750	750	747	3	1	3	747
FBgn0050417	753	750	751	5	4	1.25	748
FBgn0050419	753	750	663	93	9	10.333333333333334	660
FBgn0050421	758	750	725	41	9	4.555555555555555	717
FBgn0050423	789	750	779	49	8	6.125	740
FBgn0050424	750	750	176	574	5	114.8	176
FBgn0050430	755	750	566	194	4	48.5	561
FBgn0050431	765	750	759	21	3	7	744
FBgn0050438	830	750	773	137	15	9.133333333333333	693
FBgn0050440	830	750	770	140	16	8.75	690
FBgn0050443	614	570	591	67	9	7.444444444444445	547
FBgn0050446	761	750	761	11	2	5.5	750
FBgn0050447	778	750	489	317	5	63.4	461
FBgn0050457	754	750	744	14	4	3.5	740
FBgn0050458	752	750	731	23	5	4.6	729
FBgn0050460	751	750	747	5	4	1.25	746
FBgn0050463	770	750	766	24	6	4	746
FBgn0050464	612	581	577	66	6	11	546
FBgn0050466	766	750	766	16	1	16	750
FBgn0050467	525	524	510	16	3	5.333333333333333	509
FBgn0050468	624	590	585	73	9	8.11111111111111	551
FBgn0050471	751	750	728	24	5	4.8	727
FBgn0050472	750	750	676	74	2	37	676
FBgn0050476	750	750	593	157	1	157	593
FBgn0050484	754	750	751	7	5	1.4	747
FBgn0050486	801	743	764	95	12	7.916666666666667	706
FBgn0050487	757	750	756	8	3	2.6666666666666665	749
FBgn0050491	751	750	747	5	2	2.5	746
FBgn0050493	750	750	740	10	1	10	740
FBgn0050502	761	750	697	75	5	15	686
FBgn0050506	757	750	754	10	5	2	747
FBgn0050509	761	750	758	14	7	2	747
FBgn0051002	774	750	761	37	4	9.25	737
FBgn0051004	759	750	750	18	4	4.5	741
FBgn0051005	751	750	751	1	1	1	750
FBgn0051010	760	750	751	19	6	3.1666666666666665	741
FBgn0051013	583	541	561	64	9	7.111111111111111	519
FBgn0051014	759	750	743	25	6	4.166666666666667	734
FBgn0051015	761	750	741	31	10	3.1	730
FBgn0051019	801	750	788	64	4	16	737
FBgn0051023	751	750	734	18	4	4.5	733
FBgn0051028	750	750	733	17	6	2.8333333333333335	733
FBgn0051029	768	750	712	74	6	12.333333333333334	694
FBgn0051036	771	750	734	58	10	5.8	713
FBgn0051038	754	750	735	23	4	5.75	731
FBgn0051040	761	750	754	18	5	3.6	743
FBgn0051044	794	750	786	52	9	5.777777777777778	742
FBgn0051050	750	750	746	4	2	2	746
FBgn0051051	615	613	615	2	2	1	613
FBgn0051053	753	750	723	33	6	5.5	720
FBgn0051055	760	750	727	43	7	6.142857142857143	717
FBgn0051064	750	750	699	51	2	25.5	699
FBgn0051068	750	750	746	4	1	4	746
FBgn0051070	750	750	725	25	1	25	725
FBgn0051072	765	750	765	15	3	5	750
FBgn0051075	527	517	517	20	8	2.5	507
FBgn0051076	758	750	741	25	5	5	733
FBgn0051080	750	750	744	6	5	1.2	744
FBgn0051084	756	750	753	9	2	4.5	747
FBgn0051086	639	638	639	1	1	1	638
FBgn0051087	756	750	708	54	8	6.75	702
FBgn0051089	659	653	659	6	3	2	653
FBgn0051092	778	750	777	29	4	7.25	749
FBgn0051093	753	750	742	14	2	7	739
FBgn0051098	717	680	663	91	11	8.272727272727273	626
FBgn0051100	756	750	756	6	1	6	750
FBgn0051102	751	743	731	28	7	4	723
FBgn0051103	688	675	651	50	11	4.545454545454546	638
FBgn0051106	752	750	742	12	5	2.4	740
FBgn0051111	757	750	744	20	6	3.3333333333333335	737
FBgn0051115	757	750	746	18	5	3.6	739
FBgn0051116	770	750	723	67	9	7.444444444444445	703
FBgn0051121	781	750	767	45	6	7.5	736
FBgn0051122	788	750	623	203	6	33.833333333333336	585
FBgn0051125	751	750	750	2	2	1	749
FBgn0051126	776	750	768	34	5	6.8	742
FBgn0051128	750	750	713	37	6	6.166666666666667	713
FBgn0051130	770	750	754	36	7	5.142857142857143	734
FBgn0051140	759	750	747	21	5	4.2	738
FBgn0051141	750	750	738	12	2	6	738
FBgn0051143	767	750	746	38	6	6.333333333333333	729
FBgn0051144	751	750	751	1	1	1	750
FBgn0051145	774	750	736	62	12	5.166666666666667	712
FBgn0051146	799	750	764	84	11	7.636363636363637	715
FBgn0051148	775	750	772	28	6	4.666666666666667	747
FBgn0051156	750	750	747	3	1	3	747
FBgn0051158	763	750	714	62	7	8.857142857142858	701
FBgn0051159	750	750	701	49	3	16.333333333333332	701
FBgn0051163	756	739	745	28	8	3.5	728
FBgn0051165	799	750	797	51	7	7.285714285714286	748
FBgn0051174	791	750	790	42	3	14	749
FBgn0051176	754	750	730	28	4	7	726
FBgn0051183	754	750	702	56	9	6.222222222222222	698
FBgn0051191	778	750	771	35	8	4.375	743
FBgn0051195	777	750	730	74	12	6.166666666666667	703
FBgn0051198	773	750	771	25	6	4.166666666666667	748
FBgn0051200	773	750	730	66	8	8.25	707
FBgn0051206	751	750	744	8	3	2.6666666666666665	743
FBgn0051207	776	750	754	48	12	4	728
FBgn0051211	792	750	789	45	6	7.5	747
FBgn0051215	771	750	735	57	13	4.384615384615385	714
FBgn0051216	755	750	736	24	8	3	731
FBgn0051220	763	750	752	24	2	12	739
FBgn0051221	765	750	691	89	8	11.125	676
FBgn0051223	750	750	428	322	8	40.25	428
FBgn0051224	753	750	746	10	2	5	743
FBgn0051225	750	750	734	16	2	8	734
FBgn0051226	783	750	758	58	15	3.8666666666666667	725
FBgn0051233	758	750	756	10	5	2	748
FBgn0051251	751	750	716	36	5	7.2	715
FBgn0051262	755	750	743	17	6	2.8333333333333335	738
FBgn0051266	752	750	749	5	2	2.5	747
FBgn0051268	794	750	775	63	9	7	731
FBgn0051269	750	750	747	3	2	1.5	747
FBgn0051272	756	750	731	31	8	3.875	725
FBgn0051279	761	750	726	46	4	11.5	715
FBgn0051281	752	750	744	10	3	3.3333333333333335	742
FBgn0051287	770	750	770	20	4	5	750
FBgn0051288	759	750	739	29	10	2.9	730
FBgn0051294	752	750	696	58	7	8.285714285714286	694
FBgn0051296	764	750	751	27	6	4.5	737
FBgn0051300	559	527	552	39	6	6.5	520
FBgn0051301	750	750	743	7	4	1.75	743
FBgn0051313	826	750	772	130	9	14.444444444444445	696
FBgn0051321	758	750	712	54	10	5.4	704
FBgn0051323	788	750	766	60	4	15	728
FBgn0051324	752	750	734	20	5	4	732
FBgn0051327	803	750	791	65	7	9.285714285714286	738
FBgn0051331	760	750	710	60	8	7.5	700
FBgn0051337	760	750	744	26	6	4.333333333333333	734
FBgn0051342	765	750	720	60	8	7.5	705
FBgn0051343	761	750	751	21	6	3.5	740
FBgn0051344	778	750	775	31	4	7.75	747
FBgn0051345	761	750	760	12	5	2.4	749
FBgn0051347	750	750	750	0	0	NA	750
FBgn0051352	770	750	753	37	5	7.4	733
FBgn0051356	765	750	752	28	9	3.111111111111111	737
FBgn0051357	770	750	766	24	5	4.8	746
FBgn0051360	768	750	754	32	6	5.333333333333333	736
FBgn0051363	752	750	735	19	5	3.8	733
FBgn0051368	752	750	752	2	1	2	750
FBgn0051374	751	750	742	10	5	2	741
FBgn0051382	750	750	749	1	1	1	749
FBgn0051383	585	572	431	167	5	33.4	418
FBgn0051386	750	750	747	3	3	1	747
FBgn0051410	751	750	751	1	1	1	750
FBgn0051415	750	750	734	16	4	4	734
FBgn0051418	750	750	742	8	2	4	742
FBgn0051423	774	750	768	30	4	7.5	744
FBgn0051431	751	750	748	4	3	1.3333333333333333	747
FBgn0051432	761	750	740	32	5	6.4	729
FBgn0051437	750	750	727	23	4	5.75	727
FBgn0051438	755	750	596	164	9	18.22222222222222	591
FBgn0051446	750	750	731	19	2	9.5	731
FBgn0051457	750	750	747	3	2	1.5	747
FBgn0051459	784	750	690	128	11	11.636363636363637	656
FBgn0051460	752	750	749	5	3	1.6666666666666667	747
FBgn0051464	792	750	735	99	12	8.25	693
FBgn0051467	758	750	753	13	3	4.333333333333333	745
FBgn0051471	756	750	744	18	7	2.5714285714285716	738
FBgn0051472	759	750	719	49	11	4.454545454545454	710
FBgn0051475	764	750	757	21	8	2.625	743
FBgn0051477	756	750	737	25	6	4.166666666666667	731
FBgn0051480	751	750	750	2	2	1	749
FBgn0051481	762	750	757	17	4	4.25	745
FBgn0051482	778	750	774	32	5	6.4	746
FBgn0051491	780	750	693	117	10	11.7	663
FBgn0051495	783	750	759	57	6	9.5	726
FBgn0051496	820	750	814	76	4	19	744
FBgn0051497	756	750	737	25	7	3.5714285714285716	731
FBgn0051506	750	750	739	11	3	3.6666666666666665	739
FBgn0051514	773	750	768	28	6	4.666666666666667	745
FBgn0051515	758	750	709	57	9	6.333333333333333	701
FBgn0051516	755	750	629	131	5	26.2	624
FBgn0051522	795	750	791	49	8	6.125	746
FBgn0051523	750	750	115	635	2	317.5	115
FBgn0051524	750	750	546	204	2	102	546
FBgn0051525	756	750	756	6	1	6	750
FBgn0051528	762	750	298	476	3	158.66666666666666	286
FBgn0051547	774	750	433	365	5	73	409
FBgn0051548	801	750	785	67	8	8.375	734
FBgn0051550	669	635	612	91	7	13	578
FBgn0051551	750	750	126	624	2	312	126
FBgn0051559	753	750	734	22	5	4.4	731
FBgn0051560	757	750	525	239	12	19.916666666666668	518
FBgn0051561	753	750	704	52	3	17.333333333333332	701
FBgn0051575	751	750	742	10	4	2.5	741
FBgn0051579	702	686	666	52	10	5.2	650
FBgn0051588	772	750	681	113	9	12.555555555555555	659
FBgn0051591	754	750	728	30	3	10	724
FBgn0051609	755	750	751	9	4	2.25	746
FBgn0051619	802	750	731	123	12	10.25	679
FBgn0051626	751	750	728	24	7	3.4285714285714284	727
FBgn0051627	598	573	588	35	7	5	563
FBgn0051632	760	750	756	14	3	4.666666666666667	746
FBgn0051634	789	750	779	49	11	4.454545454545454	740
FBgn0051635	751	750	749	3	2	1.5	748
FBgn0051636	768	750	766	20	2	10	748
FBgn0051638	751	750	743	9	3	3	742
FBgn0051639	761	750	733	39	7	5.571428571428571	722
FBgn0051643	767	750	765	19	5	3.8	748
FBgn0051644	792	750	757	77	15	5.133333333333334	715
FBgn0051646	756	750	751	11	3	3.6666666666666665	745
FBgn0051647	791	750	768	64	7	9.142857142857142	727
FBgn0051658	750	750	719	31	6	5.166666666666667	719
FBgn0051663	753	750	732	24	8	3	729
FBgn0051665	764	750	760	18	2	9	746
FBgn0051669	752	750	735	19	4	4.75	733
FBgn0051673	846	750	841	101	7	14.428571428571429	745
FBgn0051675	622	610	618	16	8	2	606
FBgn0051676	826	750	814	88	10	8.8	738
FBgn0051678	777	750	777	27	4	6.75	750
FBgn0051680	542	542	143	399	2	199.5	143
FBgn0051681	524	505	486	57	5	11.4	467
FBgn0051682	759	750	757	11	2	5.5	748
FBgn0051690	753	750	742	14	3	4.666666666666667	739
FBgn0051694	753	750	704	52	7	7.428571428571429	701
FBgn0051698	750	750	619	131	2	65.5	619
FBgn0051700	787	750	768	56	12	4.666666666666667	731
FBgn0051703	545	545	55	490	3	163.33333333333334	55
FBgn0051706	786	750	786	36	4	9	750
FBgn0051708	753	750	749	7	4	1.75	746
FBgn0051710	762	750	752	22	4	5.5	740
FBgn0051716	766	750	761	21	4	5.25	745
FBgn0051717	752	750	752	2	1	2	750
FBgn0051718	754	750	742	16	4	4	738
FBgn0051719	799	750	781	67	17	3.9411764705882355	732
FBgn0051720	847	750	788	156	13	12	691
FBgn0051721	759	750	727	41	11	3.727272727272727	718
FBgn0051729	706	706	287	419	3	139.66666666666666	287
FBgn0051730	757	750	735	29	6	4.833333333333333	728
FBgn0051735	784	750	753	65	8	8.125	719
FBgn0051740	614	614	610	4	1	4	610
FBgn0051741	800	750	788	62	11	5.636363636363637	738
FBgn0051769	774	750	756	42	9	4.666666666666667	732
FBgn0051774	763	750	703	73	12	6.083333333333333	690
FBgn0051776	775	750	772	28	3	9.333333333333334	747
FBgn0051778	750	750	710	40	4	10	710
FBgn0051781	763	750	740	36	7	5.142857142857143	727
FBgn0051784	750	750	725	25	4	6.25	725
FBgn0051785	753	750	491	265	8	33.125	488
FBgn0051787	750	750	660	90	3	30	660
FBgn0051789	766	750	758	24	10	2.4	742
FBgn0051792	776	750	666	136	10	13.6	640
FBgn0051793	822	750	818	76	11	6.909090909090909	746
FBgn0051797	766	750	748	34	7	4.857142857142857	732
FBgn0051798	774	750	774	24	4	6	750
FBgn0051800	761	750	756	16	7	2.2857142857142856	745
FBgn0051803	750	750	744	6	2	3	744
FBgn0051804	757	750	723	41	9	4.555555555555555	716
FBgn0051807	754	750	702	56	11	5.090909090909091	698
FBgn0051810	751	750	247	505	5	101	246
FBgn0051812	792	750	758	76	11	6.909090909090909	716
FBgn0051813	750	750	735	15	6	2.5	735
FBgn0051814	760	750	734	36	8	4.5	724
FBgn0051816	756	750	748	14	8	1.75	742
FBgn0051820	752	750	737	17	4	4.25	735
FBgn0051823	517	516	502	16	5	3.2	501
FBgn0051824	810	750	807	63	8	7.875	747
FBgn0051832	753	750	504	252	4	63	501
FBgn0051840	771	750	771	21	5	4.2	750
FBgn0051845	769	750	754	34	5	6.8	735
FBgn0051848	751	750	611	141	4	35.25	610
FBgn0051862	767	750	757	27	6	4.5	740
FBgn0051865	600	565	599	36	5	7.2	564
FBgn0051870	806	750	746	116	9	12.88888888888889	690
FBgn0051871	796	750	787	55	9	6.111111111111111	741
FBgn0051876	780	750	759	51	7	7.285714285714286	729
FBgn0051882	757	750	715	49	9	5.444444444444445	708
FBgn0051885	785	750	770	50	8	6.25	735
FBgn0051889	792	750	766	68	9	7.555555555555555	724
FBgn0051890	750	750	741	9	2	4.5	741
FBgn0051892	778	750	778	28	2	14	750
FBgn0051901	791	750	748	84	17	4.9411764705882355	707
FBgn0051907	750	750	746	4	2	2	746
FBgn0051908	759	750	756	12	2	6	747
FBgn0051910	762	750	756	18	4	4.5	744
FBgn0051912	750	750	747	3	1	3	747
FBgn0051913	787	750	767	57	5	11.4	730
FBgn0051921	751	750	714	38	7	5.428571428571429	713
FBgn0051922	752	750	741	13	2	6.5	739
FBgn0051928	752	750	749	5	3	1.6666666666666667	747
FBgn0051933	793	750	786	50	5	10	743
FBgn0051935	751	750	716	36	6	6	715
FBgn0051940	795	750	788	52	8	6.5	743
FBgn0051942	750	750	727	23	8	2.875	727
FBgn0051946	760	750	730	40	6	6.666666666666667	720
FBgn0051949	777	750	607	197	7	28.142857142857142	580
FBgn0051950	752	750	750	4	2	2	748
FBgn0051952	754	750	727	31	10	3.1	723
FBgn0051955	758	750	734	32	7	4.571428571428571	726
FBgn0051960	753	750	749	7	3	2.3333333333333335	746
FBgn0051961	756	750	755	7	4	1.75	749
FBgn0051971	754	750	754	4	2	2	750
FBgn0051974	768	750	765	21	5	4.2	747
FBgn0051988	791	750	573	259	7	37	532
FBgn0051997	754	750	666	92	16	5.75	662
FBgn0051998	750	750	130	620	2	310	130
FBgn0051999	757	750	582	182	6	30.333333333333332	575
FBgn0052006	842	750	739	195	14	13.928571428571429	647
FBgn0052016	754	750	125	633	4	158.25	121
FBgn0052022	750	750	667	83	4	20.75	667
FBgn0052023	750	750	733	17	3	5.666666666666667	733
FBgn0052024	750	750	744	6	2	3	744
FBgn0052029	763	750	749	27	7	3.857142857142857	736
FBgn0052034	760	750	688	82	8	10.25	678
FBgn0052036	800	750	783	67	5	13.4	733
FBgn0052037	753	750	709	47	9	5.222222222222222	706
FBgn0052039	756	750	755	7	3	2.3333333333333335	749
FBgn0052040	750	750	748	2	2	1	748
FBgn0052056	787	750	781	43	7	6.142857142857143	744
FBgn0052057	773	750	765	31	7	4.428571428571429	742
FBgn0052058	751	750	733	19	3	6.333333333333333	732
FBgn0052061	832	750	825	89	13	6.846153846153846	743
FBgn0052062	752	750	750	4	3	1.3333333333333333	748
FBgn0052066	836	750	762	160	14	11.428571428571429	676
FBgn0052071	829	750	777	131	18	7.277777777777778	698
FBgn0052074	758	750	748	18	4	4.5	740
FBgn0052075	750	750	750	0	0	NA	750
FBgn0052079	758	750	719	47	8	5.875	711
FBgn0052082	718	707	673	56	7	8	662
FBgn0052085	774	750	697	101	11	9.181818181818182	673
FBgn0052091	783	750	753	63	9	7	720
FBgn0052093	573	542	573	31	6	5.166666666666667	542
FBgn0052095	756	750	127	635	6	105.83333333333333	121
FBgn0052100	756	750	734	28	7	4	728
FBgn0052105	757	750	739	25	5	5	732
FBgn0052111	767	750	730	54	7	7.714285714285714	713
FBgn0052112	731	720	682	60	6	10	671
FBgn0052113	767	750	748	36	5	7.2	731
FBgn0052117	750	750	700	50	8	6.25	700
FBgn0052119	754	750	740	18	6	3	736
FBgn0052121	773	750	767	29	3	9.666666666666666	744
FBgn0052123	753	750	747	9	5	1.8	744
FBgn0052126	755	742	674	94	8	11.75	661
FBgn0052129	750	750	737	13	2	6.5	737
FBgn0052133	778	750	763	43	11	3.909090909090909	735
FBgn0052137	757	750	750	14	5	2.8	743
FBgn0052150	763	750	727	49	10	4.9	714
FBgn0052153	751	750	567	185	5	37	566
FBgn0052160	752	750	741	13	5	2.6	739
FBgn0052163	750	750	742	8	2	4	742
FBgn0052174	767	750	761	23	4	5.75	744
FBgn0052176	767	750	755	29	8	3.625	738
FBgn0052182	796	750	781	61	10	6.1	735
FBgn0052183	759	750	747	21	4	5.25	738
FBgn0052188	750	750	198	552	3	184	198
FBgn0052192	773	750	289	507	5	101.4	266
FBgn0052196	783	750	680	136	10	13.6	647
FBgn0052198	773	750	733	63	12	5.25	710
FBgn0052200	808	750	574	292	8	36.5	516
FBgn0052202	762	750	525	249	5	49.8	513
FBgn0052204	754	750	750	8	5	1.6	746
FBgn0052206	754	750	706	52	5	10.4	702
FBgn0052207	792	750	783	51	9	5.666666666666667	741
FBgn0052220	828	750	808	98	15	6.533333333333333	730
FBgn0052221	750	750	727	23	3	7.666666666666667	727
FBgn0052224	795	750	769	71	8	8.875	724
FBgn0052226	760	750	754	16	4	4	744
FBgn0052227	721	711	630	101	6	16.833333333333332	620
FBgn0052228	778	750	688	118	9	13.11111111111111	660
FBgn0052237	761	750	744	28	6	4.666666666666667	733
FBgn0052238	753	750	712	44	8	5.5	709
FBgn0052240	754	750	708	50	5	10	704
FBgn0052241	752	750	751	3	2	1.5	749
FBgn0052243	794	750	740	98	15	6.533333333333333	696
FBgn0052246	764	750	749	29	8	3.625	735
FBgn0052248	759	750	758	10	3	3.3333333333333335	749
FBgn0052249	765	750	739	41	7	5.857142857142857	724
FBgn0052251	795	750	784	56	8	7	739
FBgn0052252	750	750	739	11	4	2.75	739
FBgn0052259	826	750	781	121	13	9.307692307692308	705
FBgn0052263	752	750	732	22	7	3.142857142857143	730
FBgn0052266	773	750	629	167	11	15.181818181818182	606
FBgn0052267	767	750	765	19	4	4.75	748
FBgn0052268	752	750	743	11	4	2.75	741
FBgn0052271	527	512	527	15	3	5	512
FBgn0052278	751	750	749	3	3	1	748
FBgn0052279	751	750	747	5	3	1.6666666666666667	746
FBgn0052280	750	750	750	0	0	NA	750
FBgn0052288	754	750	744	14	3	4.666666666666667	740
FBgn0052296	775	750	767	33	7	4.714285714285714	742
FBgn0052301	775	750	611	189	7	27	586
FBgn0052303	773	750	695	101	6	16.833333333333332	672
FBgn0052311	766	750	751	31	5	6.2	735
FBgn0052313	763	750	755	21	4	5.25	742
FBgn0052333	807	750	800	64	11	5.818181818181818	743
FBgn0052344	515	515	124	391	3	130.33333333333334	124
FBgn0052351	679	664	590	104	9	11.555555555555555	575
FBgn0052357	750	750	749	1	1	1	749
FBgn0052360	750	750	738	12	3	4	738
FBgn0052362	750	750	719	31	5	6.2	719
FBgn0052364	767	750	737	47	6	7.833333333333333	720
FBgn0052365	767	750	739	45	12	3.75	722
FBgn0052368	755	750	528	232	2	116	523
FBgn0052369	795	750	783	57	10	5.7	738
FBgn0052370	754	750	743	15	7	2.142857142857143	739
FBgn0052373	781	750	746	66	12	5.5	715
FBgn0052376	795	750	783	57	8	7.125	738
FBgn0052380	755	750	739	21	4	5.25	734
FBgn0052382	765	750	760	20	4	5	745
FBgn0052392	787	750	762	62	9	6.888888888888889	725
FBgn0052405	752	750	747	7	3	2.3333333333333335	745
FBgn0052406	750	750	746	4	1	4	746
FBgn0052407	804	750	787	71	10	7.1	733
FBgn0052413	758	750	743	23	6	3.8333333333333335	735
FBgn0052420	761	750	740	32	6	5.333333333333333	729
FBgn0052423	761	750	710	62	10	6.2	699
FBgn0052428	751	750	745	7	2	3.5	744
FBgn0052432	762	750	745	29	7	4.142857142857143	733
FBgn0052436	752	750	725	29	5	5.8	723
FBgn0052437	777	750	728	76	12	6.333333333333333	701
FBgn0052438	754	750	737	21	4	5.25	733
FBgn0052442	819	750	785	103	14	7.357142857142857	716
FBgn0052447	770	750	762	28	5	5.6	742
FBgn0052449	792	750	785	49	9	5.444444444444445	743
FBgn0052450	777	750	777	27	3	9	750
FBgn0052451	751	750	331	421	3	140.33333333333334	330
FBgn0052452	755	750	717	43	10	4.3	712
FBgn0052457	760	750	223	547	5	109.4	213
FBgn0052459	759	750	708	60	11	5.454545454545454	699
FBgn0052476	751	750	461	291	6	48.5	460
FBgn0052479	762	750	760	14	3	4.666666666666667	748
FBgn0052480	769	750	735	53	3	17.666666666666668	716
FBgn0052481	790	750	748	82	14	5.857142857142857	708
FBgn0052483	773	750	744	52	6	8.666666666666666	721
FBgn0052484	795	750	712	128	8	16	667
FBgn0052485	698	668	688	40	8	5	658
FBgn0052487	750	750	730	20	5	4	730
FBgn0052506	795	750	732	108	11	9.818181818181818	687
FBgn0052512	761	750	702	70	11	6.363636363636363	691
FBgn0052523	763	750	734	42	10	4.2	721
FBgn0052528	773	750	671	125	9	13.88888888888889	648
FBgn0052529	763	750	750	26	3	8.666666666666666	737
FBgn0052548	789	750	703	125	11	11.363636363636363	664
FBgn0052549	772	750	715	79	11	7.181818181818182	693
FBgn0052551	731	716	696	50	11	4.545454545454546	681
FBgn0052553	771	750	757	35	9	3.888888888888889	736
FBgn0052557	766	750	763	19	7	2.7142857142857144	747
FBgn0052563	792	731	757	96	8	12	696
FBgn0052564	751	750	715	37	5	7.4	714
FBgn0052568	777	750	714	90	9	10	687
FBgn0052569	766	750	757	25	6	4.166666666666667	741
FBgn0052570	752	750	626	128	6	21.333333333333332	624
FBgn0052571	761	750	719	53	7	7.571428571428571	708
FBgn0052574	718	670	699	67	6	11.166666666666666	651
FBgn0052576	756	750	753	9	4	2.25	747
FBgn0052579	777	750	770	34	4	8.5	743
FBgn0052581	768	750	722	64	6	10.666666666666666	704
FBgn0052582	759	750	727	41	6	6.833333333333333	718
FBgn0052590	758	750	744	22	7	3.142857142857143	736
FBgn0052591	763	750	735	41	11	3.727272727272727	722
FBgn0052594	751	750	358	394	8	49.25	357
FBgn0052600	772	750	594	200	11	18.181818181818183	572
FBgn0052602	755	750	723	37	8	4.625	718
FBgn0052603	752	750	651	103	10	10.3	649
FBgn0052626	790	750	741	89	12	7.416666666666667	701
FBgn0052631	765	750	722	58	9	6.444444444444445	707
FBgn0052633	760	750	743	27	7	3.857142857142857	733
FBgn0052636	701	667	650	85	13	6.538461538461538	616
FBgn0052638	794	750	783	55	6	9.166666666666666	739
FBgn0052642	780	750	779	31	4	7.75	749
FBgn0052643	765	750	712	68	9	7.555555555555555	697
FBgn0052645	755	750	749	11	4	2.75	744
FBgn0052647	761	750	718	54	13	4.153846153846154	707
FBgn0052655	750	750	735	15	4	3.75	735
FBgn0052666	766	750	643	139	7	19.857142857142858	627
FBgn0052668	756	750	712	50	5	10	706
FBgn0052675	756	750	747	15	8	1.875	741
FBgn0052676	750	750	740	10	1	10	740
FBgn0052679	760	750	747	23	5	4.6	737
FBgn0052681	755	750	744	16	5	3.2	739
FBgn0052683	750	750	727	23	3	7.666666666666667	727
FBgn0052685	757	750	557	207	11	18.818181818181817	550
FBgn0052686	750	750	747	3	1	3	747
FBgn0052687	750	750	681	69	8	8.625	681
FBgn0052693	787	750	783	41	5	8.2	746
FBgn0052694	750	750	739	11	3	3.6666666666666665	739
FBgn0052695	644	616	627	45	8	5.625	599
FBgn0052698	753	750	652	104	9	11.555555555555555	649
FBgn0052699	814	750	789	89	14	6.357142857142857	725
FBgn0052702	755	750	722	38	11	3.4545454545454546	717
FBgn0052703	790	750	721	109	15	7.266666666666667	681
FBgn0052704	681	675	628	59	11	5.363636363636363	622
FBgn0052712	757	750	717	47	10	4.7	710
FBgn0052713	771	750	687	105	20	5.25	666
FBgn0052718	795	750	769	71	8	8.875	724
FBgn0052719	768	750	719	67	6	11.166666666666666	701
FBgn0052726	763	750	757	19	7	2.7142857142857144	744
FBgn0052732	773	750	744	52	7	7.428571428571429	721
FBgn0052740	764	750	757	21	8	2.625	743
FBgn0052745	789	750	410	418	8	52.25	371
FBgn0052748	775	750	740	60	6	10	715
FBgn0052751	626	625	577	50	7	7.142857142857143	576
FBgn0052758	813	750	762	114	14	8.142857142857142	699
FBgn0052762	785	750	764	56	11	5.090909090909091	729
FBgn0052767	756	750	738	24	10	2.4	732
FBgn0052773	779	750	686	122	12	10.166666666666666	657
FBgn0052774	768	750	752	34	4	8.5	734
FBgn0052792	814	750	738	140	15	9.333333333333334	674
FBgn0052801	761	750	735	37	7	5.285714285714286	724
FBgn0052808	752	750	750	4	2	2	748
FBgn0052813	756	750	711	51	9	5.666666666666667	705
FBgn0052815	757	750	757	7	2	3.5	750
FBgn0052816	751	750	448	304	5	60.8	447
FBgn0052826	800	750	713	137	10	13.7	663
FBgn0052831	603	580	589	37	5	7.4	566
FBgn0052832	765	750	749	31	6	5.166666666666667	734
FBgn0052835	782	750	719	95	8	11.875	687
FBgn0052843	813	750	782	94	9	10.444444444444445	719
FBgn0052845	757	750	752	12	4	3	745
FBgn0052846	820	750	820	70	4	17.5	750
FBgn0052850	776	750	509	293	10	29.3	483
FBgn0052856	750	750	742	8	2	4	742
FBgn0052944	774	750	726	72	13	5.538461538461538	702
FBgn0052982	805	750	781	79	11	7.181818181818182	726
FBgn0052985	767	750	755	29	4	7.25	738
FBgn0052986	751	750	733	19	4	4.75	732
FBgn0053002	750	750	716	34	3	11.333333333333334	716
FBgn0053003	771	750	765	27	4	6.75	744
FBgn0053012	751	750	628	124	6	20.666666666666668	627
FBgn0053013	535	535	530	5	3	1.6666666666666667	530
FBgn0053017	751	750	744	8	4	2	743
FBgn0053062	750	750	122	628	1	628	122
FBgn0053080	776	750	745	57	14	4.071428571428571	719
FBgn0053093	769	750	760	28	5	5.6	741
FBgn0053100	754	750	742	16	5	3.2	738
FBgn0053107	753	750	751	5	3	1.6666666666666667	748
FBgn0053108	750	750	746	4	4	1	746
FBgn0053109	560	543	531	46	12	3.8333333333333335	514
FBgn0053110	752	750	608	146	3	48.666666666666664	606
FBgn0053113	750	750	746	4	1	4	746
FBgn0053116	756	750	726	36	11	3.272727272727273	720
FBgn0053120	768	750	725	61	12	5.083333333333333	707
FBgn0053121	787	750	775	49	10	4.9	738
FBgn0053124	753	750	739	17	5	3.4	736
FBgn0053125	750	750	722	28	3	9.333333333333334	722
FBgn0053126	750	750	708	42	5	8.4	708
FBgn0053129	766	750	757	25	5	5	741
FBgn0053136	761	750	726	46	9	5.111111111111111	715
FBgn0053137	756	743	672	97	6	16.166666666666668	659
FBgn0053138	767	750	760	24	6	4	743
FBgn0053143	766	750	762	20	6	3.3333333333333335	746
FBgn0053144	781	750	769	43	12	3.5833333333333335	738
FBgn0053147	768	750	760	26	10	2.6	742
FBgn0053156	760	750	739	31	8	3.875	729
FBgn0053158	750	750	574	176	2	88	574
FBgn0053160	832	750	801	113	9	12.555555555555555	719
FBgn0053169	765	750	346	434	9	48.22222222222222	331
FBgn0053177	755	750	738	22	7	3.142857142857143	733
FBgn0053178	659	633	630	55	13	4.230769230769231	604
FBgn0053179	780	750	777	33	9	3.6666666666666665	747
FBgn0053181	771	750	727	65	12	5.416666666666667	706
FBgn0053182	771	750	746	46	11	4.181818181818182	725
FBgn0053192	759	750	748	20	6	3.3333333333333335	739
FBgn0053193	763	750	757	19	7	2.7142857142857144	744
FBgn0053196	783	750	782	34	3	11.333333333333334	749
FBgn0053198	753	750	747	9	3	3	744
FBgn0053200	717	717	710	7	5	1.4	710
FBgn0053202	750	750	747	3	2	1.5	747
FBgn0053203	759	750	759	9	1	9	750
FBgn0053207	764	750	761	17	5	3.4	747
FBgn0053208	793	750	767	69	17	4.0588235294117645	724
FBgn0053223	764	750	702	76	8	9.5	688
FBgn0053225	758	750	678	88	9	9.777777777777779	670
FBgn0053233	764	750	724	54	4	13.5	710
FBgn0053236	807	750	787	77	9	8.555555555555555	730
FBgn0053257	751	750	622	130	7	18.571428571428573	621
FBgn0053258	762	750	755	19	3	6.333333333333333	743
FBgn0053260	753	750	739	17	6	2.8333333333333335	736
FBgn0053262	775	750	719	81	12	6.75	694
FBgn0053267	791	750	773	59	10	5.9	732
FBgn0053270	837	750	789	135	16	8.4375	702
FBgn0053271	792	750	761	73	10	7.3	719
FBgn0053272	754	750	449	309	4	77.25	445
FBgn0053281	753	750	745	11	4	2.75	742
FBgn0053282	806	750	776	86	13	6.615384615384615	720
FBgn0053284	754	750	705	53	8	6.625	701
FBgn0053286	769	750	756	32	8	4	737
FBgn0053288	756	750	752	10	2	5	746
FBgn0053289	786	750	699	123	20	6.15	663
FBgn0053290	794	750	706	132	7	18.857142857142858	662
FBgn0053294	760	750	161	609	5	121.8	151
FBgn0053299	686	686	680	6	1	6	680
FBgn0053300	588	588	586	2	2	1	586
FBgn0053301	819	750	774	114	12	9.5	705
FBgn0053303	767	750	764	20	4	5	747
FBgn0053306	692	673	683	28	6	4.666666666666667	664
FBgn0053309	764	750	763	15	3	5	749
FBgn0053315	802	750	658	196	3	65.33333333333333	606
FBgn0053325	768	750	760	26	5	5.2	742
FBgn0053329	779	750	757	51	9	5.666666666666667	728
FBgn0053333	768	750	508	278	6	46.333333333333336	490
FBgn0053339	754	750	751	7	3	2.3333333333333335	747
FBgn0053341	752	750	752	2	1	2	750
FBgn0053346	804	750	781	77	8	9.625	727
FBgn0053453	806	750	777	85	15	5.666666666666667	721
FBgn0053454	796	750	736	106	10	10.6	690
FBgn0053458	769	750	739	49	10	4.9	720
FBgn0053465	796	750	579	263	11	23.90909090909091	533
FBgn0053467	759	750	452	316	4	79	443
FBgn0053505	627	623	625	6	3	2	621
FBgn0053508	807	750	750	114	11	10.363636363636363	693
FBgn0053512	754	750	735	23	5	4.6	731
FBgn0053513	750	750	741	9	3	3	741
FBgn0053516	751	750	472	280	7	40	471
FBgn0053517	805	750	751	109	7	15.571428571428571	696
FBgn0053519	727	718	685	51	8	6.375	676
FBgn0053526	760	750	735	35	11	3.1818181818181817	725
FBgn0053530	750	750	749	1	1	1	749
FBgn0053531	750	750	744	6	1	6	744
FBgn0053534	789	750	784	44	5	8.8	745
FBgn0053536	798	750	764	82	12	6.833333333333333	716
FBgn0053542	778	750	764	42	10	4.2	736
FBgn0053543	590	590	583	7	3	2.3333333333333335	583
FBgn0053544	790	750	771	59	13	4.538461538461538	731
FBgn0053547	758	750	714	52	9	5.777777777777778	706
FBgn0053548	804	750	772	86	7	12.285714285714286	718
FBgn0053551	753	750	750	6	3	2	747
FBgn0053556	750	750	143	607	2	303.5	143
FBgn0053557	753	750	719	37	8	4.625	716
FBgn0053629	714	714	681	33	3	11	681
FBgn0053632	831	750	813	99	11	9	732
FBgn0053635	761	750	754	18	8	2.25	743
FBgn0053639	762	750	744	30	7	4.285714285714286	732
FBgn0053641	504	504	499	5	2	2.5	499
FBgn0053648	766	750	728	54	8	6.75	712
FBgn0053653	767	750	725	59	12	4.916666666666667	708
FBgn0053654	761	750	749	23	3	7.666666666666667	738
FBgn0053658	771	750	760	32	9	3.5555555555555554	739
FBgn0053673	773	750	762	34	4	8.5	739
FBgn0053679	811	750	796	76	8	9.5	735
FBgn0053687	760	750	695	75	12	6.25	685
FBgn0053688	666	649	637	46	8	5.75	620
FBgn0053696	764	750	757	21	5	4.2	743
FBgn0053700	761	750	744	28	4	7	733
FBgn0053704	762	750	727	47	7	6.714285714285714	715
FBgn0053721	643	627	640	19	4	4.75	624
FBgn0053723	766	750	727	55	8	6.875	711
FBgn0053725	772	750	733	61	10	6.1	711
FBgn0053764	761	750	695	77	8	9.625	684
FBgn0053766	762	750	657	117	10	11.7	645
FBgn0053772	750	750	748	2	2	1	748
FBgn0053773	764	750	752	26	5	5.2	738
FBgn0053774	733	705	702	59	12	4.916666666666667	674
FBgn0053775	807	750	769	95	17	5.588235294117647	712
FBgn0053777	767	750	750	34	8	4.25	733
FBgn0053792	755	750	751	9	3	3	746
FBgn0053795	788	750	729	97	14	6.928571428571429	691
FBgn0053796	679	622	493	243	9	27	436
FBgn0053912	786	750	742	80	9	8.88888888888889	706
FBgn0053922	763	750	708	68	7	9.714285714285714	695
FBgn0053923	757	750	697	67	10	6.7	690
FBgn0053927	768	750	709	77	13	5.923076923076923	691
FBgn0053929	751	750	412	340	6	56.666666666666664	411
FBgn0053958	804	750	774	84	14	6	720
FBgn0053969	764	750	755	23	8	2.875	741
FBgn0053978	781	750	292	520	7	74.28571428571429	261
FBgn0053983	758	750	752	14	4	3.5	744
FBgn0053986	694	658	674	56	8	7	638
FBgn0053988	756	750	753	9	4	2.25	747
FBgn0053993	827	750	813	91	9	10.11111111111111	736
FBgn0054005	752	750	743	11	4	2.75	741
FBgn0054007	785	750	760	60	8	7.5	725
FBgn0054008	765	750	750	30	7	4.285714285714286	735
FBgn0054012	760	750	748	22	3	7.333333333333333	738
FBgn0054015	765	750	670	110	7	15.714285714285714	655
FBgn0054024	765	750	728	52	4	13	713
FBgn0054025	762	750	762	12	2	6	750
FBgn0054026	754	750	718	40	7	5.714285714285714	714
FBgn0054028	765	750	716	64	13	4.923076923076923	701
FBgn0054029	768	750	678	108	8	13.5	660
FBgn0054033	757	750	743	21	6	3.5	736
FBgn0054034	793	750	776	60	8	7.5	733
FBgn0054038	773	750	771	25	5	5	748
FBgn0054040	757	747	749	18	5	3.6	739
FBgn0054043	751	750	727	25	8	3.125	726
FBgn0054045	759	750	547	221	4	55.25	538
FBgn0054046	752	750	627	127	6	21.166666666666668	625
FBgn0054047	751	750	746	6	3	2	745
FBgn0054049	762	750	721	53	13	4.076923076923077	709
FBgn0054052	761	750	707	65	15	4.333333333333333	696
FBgn0054054	769	750	741	47	9	5.222222222222222	722
FBgn0054056	770	750	761	29	6	4.833333333333333	741
FBgn0058002	752	750	336	418	7	59.714285714285715	334
FBgn0058005	777	750	661	143	17	8.411764705882353	634
FBgn0058006	790	750	773	57	9	6.333333333333333	733
FBgn0058100	774	750	556	242	7	34.57142857142857	532
FBgn0058160	750	750	67	683	2	341.5	67
FBgn0058172	760	750	754	16	6	2.6666666666666665	744
FBgn0060296	768	742	728	66	9	7.333333333333333	702
FBgn0061188	755	750	697	63	4	15.75	692
FBgn0061197	762	750	730	44	8	5.5	718
FBgn0061198	758	750	721	45	9	5	713
FBgn0061200	820	750	758	132	12	11	688
FBgn0061435	753	750	750	6	3	2	747
FBgn0061469	755	750	755	5	1	5	750
FBgn0061476	760	750	755	15	4	3.75	745
FBgn0061492	778	750	774	32	10	3.2	746
FBgn0061515	757	750	732	32	7	4.571428571428571	725
FBgn0062411	751	750	745	7	2	3.5	744
FBgn0062413	750	750	749	1	1	1	749
FBgn0062440	756	750	739	23	8	2.875	733
FBgn0062442	750	750	749	1	1	1	749
FBgn0062449	771	750	731	61	8	7.625	710
FBgn0062517	741	734	729	19	4	4.75	722
FBgn0062961	850	750	842	108	17	6.352941176470588	742
FBgn0063083	769	750	765	23	4	5.75	746
FBgn0063298	761	750	748	24	3	8	737
FBgn0063449	791	750	777	55	5	11	736
FBgn0063491	530	519	422	119	6	19.833333333333332	411
FBgn0063494	715	708	634	88	11	8	627
FBgn0063495	727	661	688	105	11	9.545454545454545	622
FBgn0063497	557	523	524	67	10	6.7	490
FBgn0063649	751	750	742	10	5	2	741
FBgn0063670	764	750	469	309	6	51.5	455
FBgn0064237	755	750	736	24	9	2.6666666666666665	731
FBgn0064766	752	750	752	2	2	1	750
FBgn0065032	750	750	117	633	2	316.5	117
FBgn0065035	750	750	338	412	1	412	338
FBgn0065046	750	750	559	191	6	31.833333333333332	559
FBgn0065081	580	580	574	6	3	2	574
FBgn0065098	754	750	737	21	4	5.25	733
FBgn0065104	752	750	745	9	6	1.5	743
FBgn0066084	750	750	749	1	1	1	749
FBgn0066101	767	750	762	22	4	5.5	745
FBgn0067052	774	750	749	49	5	9.8	725
FBgn0067102	789	750	772	56	11	5.090909090909091	733
FBgn0067311	579	545	566	47	9	5.222222222222222	532
FBgn0067312	777	750	701	103	14	7.357142857142857	674
FBgn0067317	750	750	727	23	5	4.6	727
FBgn0067407	760	750	740	30	6	5	730
FBgn0067783	819	750	743	145	10	14.5	674
FBgn0067905	778	750	770	36	13	2.769230769230769	742
FBgn0069354	754	750	714	44	8	5.5	710
FBgn0069913	766	750	740	42	7	6	724
FBgn0069923	757	750	405	359	11	32.63636363636363	398
FBgn0069973	761	750	594	178	13	13.692307692307692	583
FBgn0082585	786	750	783	39	8	4.875	747
FBgn0082598	750	750	336	414	2	207	336
FBgn0082831	756	750	744	18	5	3.6	738
FBgn0082922	756	750	739	23	6	3.8333333333333335	733
FBgn0083039	780	750	774	36	5	7.2	744
FBgn0083068	767	750	707	77	7	11	690
FBgn0083120	799	750	773	75	11	6.818181818181818	724
FBgn0083123	761	750	758	14	4	3.5	747
FBgn0083141	799	750	689	159	10	15.9	640
FBgn0083167	789	750	789	39	2	19.5	750
FBgn0083228	789	750	779	49	6	8.166666666666666	740
FBgn0083938	754	750	731	27	6	4.5	727
FBgn0083940	750	750	730	20	3	6.666666666666667	730
FBgn0083941	777	750	767	37	8	4.625	740
FBgn0083943	750	750	747	3	1	3	747
FBgn0083945	754	750	736	22	6	3.6666666666666665	732
FBgn0083946	781	750	720	92	12	7.666666666666667	689
FBgn0083949	757	750	733	31	6	5.166666666666667	726
FBgn0083950	800	750	785	65	10	6.5	735
FBgn0083951	774	750	705	93	12	7.75	681
FBgn0083952	753	750	753	3	1	3	750
FBgn0083956	750	750	371	379	2	189.5	371
FBgn0083962	757	750	747	17	3	5.666666666666667	740
FBgn0083963	777	750	733	71	8	8.875	706
FBgn0083965	760	750	730	40	8	5	720
FBgn0083968	751	750	724	28	3	9.333333333333334	723
FBgn0083969	760	750	752	18	4	4.5	742
FBgn0083970	649	649	649	0	0	NA	649
FBgn0083972	822	750	785	109	8	13.625	713
FBgn0083974	762	750	755	19	3	6.333333333333333	743
FBgn0083975	752	750	714	40	7	5.714285714285714	712
FBgn0083978	768	750	739	47	7	6.714285714285714	721
FBgn0083979	764	750	709	69	9	7.666666666666667	695
FBgn0083981	772	750	721	73	4	18.25	699
FBgn0083983	752	750	746	8	5	1.6	744
FBgn0083986	774	750	770	28	6	4.666666666666667	746
FBgn0083987	750	750	745	5	5	1	745
FBgn0083990	756	750	624	138	4	34.5	618
FBgn0083991	755	750	718	42	7	6	713
FBgn0083992	755	750	732	28	4	7	727
FBgn0083994	766	750	646	136	10	13.6	630
FBgn0084001	820	750	759	131	13	10.076923076923077	689
FBgn0085188	765	750	745	35	9	3.888888888888889	730
FBgn0085190	756	750	749	13	5	2.6	743
FBgn0085191	786	750	786	36	4	9	750
FBgn0085192	761	750	756	16	4	4	745
FBgn0085194	728	697	720	39	4	9.75	689
FBgn0085195	757	750	697	67	11	6.090909090909091	690
FBgn0085198	765	750	706	74	9	8.222222222222221	691
FBgn0085199	750	750	746	4	3	1.3333333333333333	746
FBgn0085201	767	750	760	24	7	3.4285714285714284	743
FBgn0085202	775	750	525	275	13	21.153846153846153	500
FBgn0085203	773	750	748	48	7	6.857142857142857	725
FBgn0085204	769	750	718	70	5	14	699
FBgn0085205	779	750	757	51	6	8.5	728
FBgn0085209	752	750	741	13	4	3.25	739
FBgn0085210	759	750	756	12	4	3	747
FBgn0085212	578	578	560	18	3	6	560
FBgn0085217	762	750	737	37	5	7.4	725
FBgn0085218	750	750	750	0	0	NA	750
FBgn0085220	750	750	747	3	1	3	747
FBgn0085222	765	750	749	31	5	6.2	734
FBgn0085224	601	600	589	13	4	3.25	588
FBgn0085225	765	750	752	28	6	4.666666666666667	737
FBgn0085228	786	750	780	42	6	7	744
FBgn0085229	751	750	108	644	5	128.8	107
FBgn0085230	815	750	798	82	10	8.2	733
FBgn0085232	750	750	740	10	4	2.5	740
FBgn0085233	771	750	754	38	11	3.4545454545454546	733
FBgn0085234	757	750	744	20	2	10	737
FBgn0085235	756	750	754	8	2	4	748
FBgn0085236	542	541	500	43	4	10.75	499
FBgn0085237	717	713	700	21	5	4.2	696
FBgn0085239	790	750	782	48	6	8	742
FBgn0085240	764	750	645	133	9	14.777777777777779	631
FBgn0085241	754	750	739	19	3	6.333333333333333	735
FBgn0085242	755	750	741	19	8	2.375	736
FBgn0085244	751	750	705	47	5	9.4	704
FBgn0085246	689	689	659	30	4	7.5	659
FBgn0085250	825	750	812	88	8	11	737
FBgn0085253	560	542	554	24	4	6	536
FBgn0085257	754	750	747	11	4	2.75	743
FBgn0085259	717	707	691	36	6	6	681
FBgn0085260	785	750	773	47	12	3.9166666666666665	738
FBgn0085261	798	750	746	100	12	8.333333333333334	698
FBgn0085263	762	750	757	17	3	5.666666666666667	745
FBgn0085265	759	750	757	11	7	1.5714285714285714	748
FBgn0085267	755	750	662	98	9	10.88888888888889	657
FBgn0085271	758	750	751	15	5	3	743
FBgn0085273	750	750	719	31	2	15.5	719
FBgn0085274	772	750	759	35	5	7	737
FBgn0085276	753	750	748	8	3	2.6666666666666665	745
FBgn0085277	753	750	747	9	3	3	744
FBgn0085280	838	750	834	92	7	13.142857142857142	746
FBgn0085285	760	750	760	10	1	10	750
FBgn0085288	764	750	742	36	8	4.5	728
FBgn0085289	760	750	748	22	5	4.4	738
FBgn0085290	695	694	684	12	2	6	683
FBgn0085292	751	750	680	72	5	14.4	679
FBgn0085294	757	750	743	21	9	2.3333333333333335	736
FBgn0085295	754	750	728	30	7	4.285714285714286	724
FBgn0085300	751	750	749	3	2	1.5	748
FBgn0085302	750	750	744	6	3	2	744
FBgn0085303	773	750	759	37	5	7.4	736
FBgn0085307	789	750	760	68	12	5.666666666666667	721
FBgn0085310	806	750	792	70	7	10	736
FBgn0085311	765	750	762	18	8	2.25	747
FBgn0085313	759	750	746	22	7	3.142857142857143	737
FBgn0085314	750	750	747	3	2	1.5	747
FBgn0085315	768	750	763	23	6	3.8333333333333335	745
FBgn0085316	753	750	739	17	5	3.4	736
FBgn0085317	764	750	762	16	6	2.6666666666666665	748
FBgn0085318	755	750	731	29	4	7.25	726
FBgn0085319	751	750	742	10	5	2	741
FBgn0085320	755	750	755	5	2	2.5	750
FBgn0085321	750	750	737	13	5	2.6	737
FBgn0085322	767	750	766	18	4	4.5	749
FBgn0085324	774	750	750	48	5	9.6	726
FBgn0085326	756	750	668	94	7	13.428571428571429	662
FBgn0085328	751	750	748	4	3	1.3333333333333333	747
FBgn0085329	794	750	761	77	13	5.923076923076923	717
FBgn0085330	750	750	743	7	2	3.5	743
FBgn0085332	751	750	483	269	6	44.833333333333336	482
FBgn0085334	814	750	728	150	13	11.538461538461538	664
FBgn0085336	750	750	750	0	0	NA	750
FBgn0085340	766	750	594	188	6	31.333333333333332	578
FBgn0085349	757	750	716	48	6	8	709
FBgn0085351	750	750	736	14	3	4.666666666666667	736
FBgn0085353	773	750	759	37	9	4.111111111111111	736
FBgn0085358	793	750	582	254	9	28.22222222222222	539
FBgn0085359	807	750	774	90	11	8.181818181818182	717
FBgn0085360	784	750	679	139	13	10.692307692307692	645
FBgn0085362	781	750	767	45	6	7.5	736
FBgn0085366	761	750	719	53	10	5.3	708
FBgn0085367	763	750	743	33	7	4.714285714285714	730
FBgn0085369	763	750	752	24	5	4.8	739
FBgn0085370	762	750	743	31	5	6.2	731
FBgn0085371	764	750	745	33	8	4.125	731
FBgn0085374	798	750	742	104	12	8.666666666666666	694
FBgn0085376	766	750	734	48	6	8	718
FBgn0085377	761	750	748	24	5	4.8	737
FBgn0085380	752	750	734	20	6	3.3333333333333335	732
FBgn0085382	768	750	760	26	9	2.888888888888889	742
FBgn0085383	777	750	776	28	4	7	749
FBgn0085384	755	750	742	18	3	6	737
FBgn0085385	753	750	735	21	6	3.5	732
FBgn0085386	788	750	621	205	5	41	583
FBgn0085387	755	750	742	18	4	4.5	737
FBgn0085390	766	750	761	21	6	3.5	745
FBgn0085391	765	750	751	29	7	4.142857142857143	736
FBgn0085395	762	750	760	14	5	2.8	748
FBgn0085396	759	750	755	13	6	2.1666666666666665	746
FBgn0085397	799	750	796	52	5	10.4	747
FBgn0085398	750	750	719	31	4	7.75	719
FBgn0085400	767	750	757	27	9	3	740
FBgn0085404	762	750	758	16	3	5.333333333333333	746
FBgn0085405	762	750	760	14	5	2.8	748
FBgn0085407	763	750	753	23	8	2.875	740
FBgn0085408	807	750	781	83	12	6.916666666666667	724
FBgn0085409	750	750	738	12	2	6	738
FBgn0085410	767	750	632	152	9	16.88888888888889	615
FBgn0085411	762	750	705	69	8	8.625	693
FBgn0085412	752	750	625	129	5	25.8	623
FBgn0085414	751	750	740	12	2	6	739
FBgn0085415	750	750	626	124	6	20.666666666666668	626
FBgn0085417	775	750	759	41	7	5.857142857142857	734
FBgn0085419	755	750	747	13	3	4.333333333333333	742
FBgn0085420	751	750	736	16	5	3.2	735
FBgn0085422	769	750	767	21	4	5.25	748
FBgn0085424	754	750	751	7	4	1.75	747
FBgn0085425	756	750	746	16	6	2.6666666666666665	740
FBgn0085426	751	750	685	67	14	4.785714285714286	684
FBgn0085427	751	750	736	16	3	5.333333333333333	735
FBgn0085428	751	750	738	14	3	4.666666666666667	737
FBgn0085430	750	750	748	2	1	2	748
FBgn0085431	714	714	657	57	3	19	657
FBgn0085432	757	750	693	71	11	6.454545454545454	686
FBgn0085434	772	750	772	22	4	5.5	750
FBgn0085436	775	750	761	39	7	5.571428571428571	736
FBgn0085437	775	750	751	49	8	6.125	726
FBgn0085440	607	602	558	54	13	4.153846153846154	553
FBgn0085443	810	750	778	92	9	10.222222222222221	718
FBgn0085444	755	750	754	6	2	3	749
FBgn0085446	765	750	740	40	7	5.714285714285714	725
FBgn0085447	750	750	744	6	4	1.5	744
FBgn0085450	793	750	744	92	12	7.666666666666667	701
FBgn0085455	750	750	742	8	2	4	742
FBgn0085456	750	750	733	17	3	5.666666666666667	733
FBgn0085457	758	750	756	10	4	2.5	748
FBgn0085461	758	750	738	28	9	3.111111111111111	730
FBgn0085465	770	750	765	25	4	6.25	745
FBgn0085468	792	750	782	52	6	8.666666666666666	740
FBgn0085474	810	738	762	120	10	12	690
FBgn0085476	784	750	773	45	8	5.625	739
FBgn0085477	561	509	430	183	9	20.333333333333332	378
FBgn0085478	752	750	748	6	4	1.5	746
FBgn0085480	795	750	795	45	4	11.25	750
FBgn0085481	761	750	757	15	4	3.75	746
FBgn0085482	756	750	493	269	10	26.9	487
FBgn0085484	785	750	739	81	10	8.1	704
FBgn0085486	751	750	749	3	2	1.5	748
FBgn0085488	765	750	710	70	12	5.833333333333333	695
FBgn0085491	751	750	743	9	6	1.5	742
FBgn0086074	694	679	687	22	6	3.6666666666666665	672
FBgn0086129	609	601	600	17	4	4.25	592
FBgn0086200	753	750	746	10	4	2.5	743
FBgn0086253	751	750	741	11	3	3.6666666666666665	740
FBgn0086265	613	567	605	54	7	7.714285714285714	559
FBgn0086266	761	750	669	103	6	17.166666666666668	658
FBgn0086346	755	750	734	26	4	6.5	729
FBgn0086347	750	750	744	6	3	2	744
FBgn0086350	750	750	725	25	3	8.333333333333334	725
FBgn0086355	694	675	684	29	5	5.8	665
FBgn0086356	752	750	735	19	5	3.8	733
FBgn0086358	757	750	744	20	9	2.2222222222222223	737
FBgn0086362	756	750	747	15	6	2.5	741
FBgn0086365	773	750	752	44	8	5.5	729
FBgn0086367	771	750	751	41	9	4.555555555555555	730
FBgn0086368	761	750	713	59	6	9.833333333333334	702
FBgn0086370	751	750	748	4	4	1	747
FBgn0086371	765	750	740	40	10	4	725
FBgn0086372	766	750	719	63	6	10.5	703
FBgn0086384	791	750	727	105	10	10.5	686
FBgn0086408	764	750	757	21	7	3	743
FBgn0086442	762	750	762	12	4	3	750
FBgn0086443	784	750	771	47	6	7.833333333333333	737
FBgn0086444	762	750	755	19	5	3.8	743
FBgn0086445	762	750	749	25	7	3.5714285714285716	737
FBgn0086446	788	750	775	51	7	7.285714285714286	737
FBgn0086447	767	750	742	42	9	4.666666666666667	725
FBgn0086448	755	750	714	46	9	5.111111111111111	709
FBgn0086450	778	750	702	104	15	6.933333333333334	674
FBgn0086472	779	750	779	29	1	29	750
FBgn0086532	753	750	692	64	7	9.142857142857142	689
FBgn0086558	589	585	438	155	8	19.375	434
FBgn0086604	752	750	674	80	8	10	672
FBgn0086608	836	750	668	254	12	21.166666666666668	582
FBgn0086655	781	750	775	37	6	6.166666666666667	744
FBgn0086656	754	750	751	7	2	3.5	747
FBgn0086657	766	750	755	27	5	5.4	739
FBgn0086659	754	750	728	30	9	3.3333333333333335	724
FBgn0086673	769	750	750	38	9	4.222222222222222	731
FBgn0086675	772	750	730	64	16	4	708
FBgn0086677	770	750	733	57	5	11.4	713
FBgn0086679	757	750	733	31	9	3.4444444444444446	726
FBgn0086680	752	750	719	35	4	8.75	717
FBgn0086681	752	750	712	42	5	8.4	710
FBgn0086683	773	750	466	330	10	33	443
FBgn0086686	806	750	696	166	14	11.857142857142858	640
FBgn0086687	770	750	761	29	8	3.625	741
FBgn0086690	758	750	668	98	11	8.909090909090908	660
FBgn0086691	757	750	726	38	7	5.428571428571429	719
FBgn0086693	767	750	762	22	4	5.5	745
FBgn0086695	750	750	682	68	2	34	682
FBgn0086698	779	750	743	65	8	8.125	714
FBgn0086704	773	750	749	47	11	4.2727272727272725	726
FBgn0086707	729	676	706	76	11	6.909090909090909	653
FBgn0086708	760	750	752	18	9	2	742
FBgn0086711	786	750	756	66	9	7.333333333333333	720
FBgn0086712	765	750	716	64	8	8	701
FBgn0086757	754	750	730	28	6	4.666666666666667	726
FBgn0086758	753	750	734	22	5	4.4	731
FBgn0086778	847	750	821	123	13	9.461538461538462	724
FBgn0086779	753	750	372	384	3	128	369
FBgn0086782	760	750	682	88	9	9.777777777777779	672
FBgn0086784	760	750	758	12	3	4	748
FBgn0086785	756	750	737	25	6	4.166666666666667	731
FBgn0086855	765	750	761	19	2	9.5	746
FBgn0086856	786	750	773	49	5	9.8	737
FBgn0086895	751	750	750	2	2	1	749
FBgn0086898	750	750	750	0	0	NA	750
FBgn0086904	754	750	752	6	4	1.5	748
FBgn0086906	760	750	747	23	4	5.75	737
FBgn0086907	788	750	779	47	6	7.833333333333333	741
FBgn0086909	761	750	751	21	6	3.5	740
FBgn0086912	778	750	765	41	10	4.1	737
FBgn0086913	754	750	478	280	8	35	474
FBgn0086916	751	750	739	13	8	1.625	738
FBgn0087002	811	750	804	68	9	7.555555555555555	743
FBgn0087005	579	575	569	14	5	2.8	565
FBgn0087007	755	750	754	6	4	1.5	749
FBgn0087008	781	750	682	130	18	7.222222222222222	651
FBgn0087013	750	750	47	703	2	351.5	47
FBgn0087021	751	750	741	11	5	2.2	740
FBgn0243511	837	750	818	106	9	11.777777777777779	731
FBgn0243513	754	750	754	4	1	4	750
FBgn0243514	764	750	702	76	9	8.444444444444445	688
FBgn0243516	752	750	751	3	3	1	749
FBgn0243586	770	750	769	21	3	7	749
FBgn0250732	784	750	784	34	2	17	750
FBgn0250746	808	750	772	94	14	6.714285714285714	714
FBgn0250753	762	750	739	35	8	4.375	727
FBgn0250754	764	750	722	56	8	7	708
FBgn0250755	776	750	773	29	4	7.25	747
FBgn0250757	752	750	752	2	2	1	750
FBgn0250786	769	750	765	23	6	3.8333333333333335	746
FBgn0250788	775	750	753	47	10	4.7	728
FBgn0250791	779	750	770	38	11	3.4545454545454546	741
FBgn0250815	755	750	753	7	2	3.5	748
FBgn0250816	750	750	152	598	5	119.6	152
FBgn0250817	773	750	727	69	11	6.2727272727272725	704
FBgn0250821	764	750	190	588	4	147	176
FBgn0250822	760	750	754	16	3	5.333333333333333	744
FBgn0250823	783	750	782	34	2	17	749
FBgn0250825	774	750	738	60	13	4.615384615384615	714
FBgn0250827	754	750	704	54	6	9	700
FBgn0250831	776	750	767	35	7	5	741
FBgn0250832	750	750	227	523	3	174.33333333333334	227
FBgn0250833	768	750	742	44	6	7.333333333333333	724
FBgn0250834	780	750	772	38	5	7.6	742
FBgn0250835	751	750	746	6	3	2	745
FBgn0250836	768	750	724	62	8	7.75	706
FBgn0250837	750	750	545	205	1	205	545
FBgn0250838	759	750	743	25	4	6.25	734
FBgn0250839	781	750	701	111	9	12.333333333333334	670
FBgn0250841	763	750	743	33	6	5.5	730
FBgn0250843	755	750	747	13	2	6.5	742
FBgn0250844	766	750	760	22	3	7.333333333333333	744
FBgn0250845	757	750	718	46	5	9.2	711
FBgn0250846	760	750	672	98	5	19.6	662
FBgn0250847	783	750	735	81	10	8.1	702
FBgn0250848	788	750	740	86	12	7.166666666666667	702
FBgn0250850	751	750	745	7	3	2.3333333333333335	744
FBgn0250868	751	750	738	14	3	4.666666666666667	737
FBgn0250869	753	750	753	3	2	1.5	750
FBgn0250871	585	545	519	106	7	15.142857142857142	479
FBgn0250874	826	750	822	80	4	20	746
FBgn0250906	753	750	750	6	3	2	747
FBgn0250908	752	750	661	93	6	15.5	659
FBgn0250910	763	750	750	26	5	5.2	737
FBgn0259098	756	750	730	32	10	3.2	724
FBgn0259099	775	750	755	45	8	5.625	730
FBgn0259108	750	750	736	14	1	14	736
FBgn0259110	781	750	767	45	11	4.090909090909091	736
FBgn0259111	754	750	660	98	8	12.25	656
FBgn0259112	750	750	750	0	0	NA	750
FBgn0259113	820	750	805	85	13	6.538461538461538	735
FBgn0259139	760	750	711	59	6	9.833333333333334	701
FBgn0259143	758	750	745	21	5	4.2	737
FBgn0259145	760	750	750	20	7	2.857142857142857	740
FBgn0259146	752	750	732	22	4	5.5	730
FBgn0259148	775	750	763	37	6	6.166666666666667	738
FBgn0259149	700	688	650	62	10	6.2	638
FBgn0259150	759	750	696	72	9	8	687
FBgn0259152	750	750	750	0	0	NA	750
FBgn0259162	784	750	766	52	8	6.5	732
FBgn0259163	772	750	757	37	6	6.166666666666667	735
FBgn0259164	750	750	695	55	3	18.333333333333332	695
FBgn0259166	668	630	634	72	14	5.142857142857143	596
FBgn0259167	779	750	755	53	8	6.625	726
FBgn0259168	751	750	705	47	5	9.4	704
FBgn0259173	768	750	664	122	11	11.090909090909092	646
FBgn0259174	750	750	734	16	2	8	734
FBgn0259175	756	750	696	66	6	11	690
FBgn0259176	762	750	736	38	10	3.8	724
FBgn0259178	771	750	756	36	7	5.142857142857143	735
FBgn0259183	755	750	699	61	9	6.777777777777778	694
FBgn0259185	788	750	776	50	13	3.8461538461538463	738
FBgn0259188	787	750	786	38	6	6.333333333333333	749
FBgn0259190	774	750	728	70	9	7.777777777777778	704
FBgn0259193	796	750	703	139	15	9.266666666666667	657
FBgn0259209	764	750	730	48	6	8	716
FBgn0259210	756	750	715	47	3	15.666666666666666	709
FBgn0259211	777	750	771	33	6	5.5	744
FBgn0259212	579	552	238	368	4	92	211
FBgn0259213	763	750	758	18	6	3	745
FBgn0259214	768	750	421	365	5	73	403
FBgn0259215	750	750	746	4	3	1.3333333333333333	746
FBgn0259219	773	750	447	349	5	69.8	424
FBgn0259221	811	750	792	80	7	11.428571428571429	731
FBgn0259222	764	750	755	23	4	5.75	741
FBgn0259223	792	750	763	71	11	6.454545454545454	721
FBgn0259224	769	750	766	22	7	3.142857142857143	747
FBgn0259226	762	750	743	31	8	3.875	731
FBgn0259227	764	750	759	19	6	3.1666666666666665	745
FBgn0259228	771	750	771	21	5	4.2	750
FBgn0259229	768	750	751	35	5	7	733
FBgn0259230	750	750	737	13	4	3.25	737
FBgn0259233	808	750	764	102	11	9.272727272727273	706
FBgn0259236	756	750	746	16	5	3.2	740
FBgn0259237	753	750	729	27	10	2.7	726
FBgn0259242	756	750	754	8	3	2.6666666666666665	748
FBgn0259243	753	750	753	3	3	1	750
FBgn0259244	791	750	722	110	10	11	681
FBgn0259245	788	750	771	55	7	7.857142857142857	733
FBgn0259246	752	725	736	43	8	5.375	709
FBgn0259481	752	750	750	4	4	1	748
FBgn0259483	756	750	755	7	2	3.5	749
FBgn0259677	754	750	735	23	7	3.2857142857142856	731
FBgn0259678	751	750	741	11	5	2.2	740
FBgn0259685	772	750	765	29	8	3.625	743
FBgn0259701	763	750	763	13	3	4.333333333333333	750
FBgn0259702	767	750	738	46	7	6.571428571428571	721
FBgn0259710	766	750	746	36	7	5.142857142857143	730
FBgn0259712	759	750	759	9	1	9	750
FBgn0259713	630	630	604	26	5	5.2	604
FBgn0259714	750	750	718	32	5	6.4	718
FBgn0259722	819	750	785	103	9	11.444444444444445	716
FBgn0259728	630	625	603	32	6	5.333333333333333	598
FBgn0259734	835	750	833	87	9	9.666666666666666	748
FBgn0259735	797	750	787	57	5	11.4	740
FBgn0259736	774	750	768	30	4	7.5	744
FBgn0259740	767	750	754	30	9	3.3333333333333335	737
FBgn0259742	754	750	747	11	3	3.6666666666666665	743
FBgn0259745	778	750	732	74	13	5.6923076923076925	704
FBgn0259749	779	750	755	53	10	5.3	726
FBgn0259785	761	750	752	20	4	5	741
FBgn0259789	776	750	488	314	10	31.4	462
FBgn0259791	764	750	763	15	3	5	749
FBgn0259794	761	750	700	72	11	6.545454545454546	689
FBgn0259795	771	750	723	69	13	5.3076923076923075	702
FBgn0259821	750	750	359	391	5	78.2	359
FBgn0259823	801	750	784	68	9	7.555555555555555	733
FBgn0259831	792	750	773	61	8	7.625	731
FBgn0259832	778	750	774	32	4	8	746
FBgn0259876	801	750	757	95	12	7.916666666666667	706
FBgn0259878	763	750	672	104	8	13	659
FBgn0259896	757	750	748	16	6	2.6666666666666665	741
FBgn0259916	526	525	477	50	7	7.142857142857143	476
FBgn0259922	752	750	748	6	5	1.2	746
FBgn0259926	768	750	689	97	10	9.7	671
FBgn0259935	766	750	742	40	6	6.666666666666667	726
FBgn0259936	679	670	662	26	7	3.7142857142857144	653
FBgn0259937	759	750	749	19	3	6.333333333333333	740
FBgn0259938	768	750	750	36	8	4.5	732
FBgn0259950	752	750	410	344	4	86	408
FBgn0259954	767	750	763	21	3	7	746
FBgn0259958	752	750	734	20	6	3.3333333333333335	732
FBgn0259959	781	750	752	60	10	6	721
FBgn0259962	751	750	732	20	3	6.666666666666667	731
FBgn0259964	789	750	681	147	8	18.375	642
FBgn0259965	750	750	292	458	2	229	292
FBgn0259966	770	750	713	77	9	8.555555555555555	693
FBgn0259967	655	641	621	48	6	8	607
FBgn0259969	759	750	749	19	5	3.8	740
FBgn0259970	750	750	731	19	3	6.333333333333333	731
FBgn0259971	773	750	390	406	6	67.66666666666667	367
FBgn0259972	750	750	740	10	2	5	740
FBgn0259973	781	750	771	41	5	8.2	740
FBgn0259974	760	750	704	66	7	9.428571428571429	694
FBgn0259977	754	750	754	4	3	1.3333333333333333	750
FBgn0259982	752	750	739	15	5	3	737
FBgn0259985	791	750	786	46	5	9.2	745
FBgn0259986	782	750	770	44	9	4.888888888888889	738
FBgn0259992	764	750	755	23	6	3.8333333333333335	741
FBgn0259994	782	750	733	81	12	6.75	701
FBgn0259996	756	750	737	25	7	3.5714285714285716	731
FBgn0259998	774	750	737	61	8	7.625	713
FBgn0260000	753	750	751	5	2	2.5	748
FBgn0260003	792	750	746	88	8	11	704
FBgn0260004	786	750	739	83	7	11.857142857142858	703
FBgn0260005	754	750	742	16	4	4	738
FBgn0260006	762	750	707	67	10	6.7	695
FBgn0260008	752	750	143	611	3	203.66666666666666	141
FBgn0260012	786	750	777	45	4	11.25	741
FBgn0260027	773	750	764	32	7	4.571428571428571	741
FBgn0260049	750	750	494	256	1	256	494
FBgn0260243	751	750	749	3	2	1.5	748
FBgn0260392	751	750	749	3	2	1.5	748
FBgn0260393	757	750	712	52	5	10.4	705
FBgn0260396	772	750	748	46	8	5.75	726
FBgn0260397	779	750	576	232	9	25.77777777777778	547
FBgn0260399	756	750	721	41	5	8.2	715
FBgn0260407	750	750	739	11	4	2.75	739
FBgn0260428	750	750	737	13	2	6.5	737
FBgn0260429	782	750	767	47	6	7.833333333333333	735
FBgn0260430	750	750	723	27	2	13.5	723
FBgn0260431	810	750	672	198	9	22	612
FBgn0260436	770	750	755	35	6	5.833333333333333	735
FBgn0260437	757	750	376	388	5	77.6	369
FBgn0260442	751	750	739	13	5	2.6	738
FBgn0260444	781	750	761	51	11	4.636363636363637	730
FBgn0260446	772	750	735	59	11	5.363636363636363	713
FBgn0260462	803	750	430	426	10	42.6	377
FBgn0260474	756	750	753	9	4	2.25	747
FBgn0260475	752	750	716	38	14	2.7142857142857144	714
FBgn0260482	775	750	752	48	11	4.363636363636363	727
FBgn0260486	591	590	551	41	7	5.857142857142857	550
FBgn0260487	750	750	738	12	2	6	738
FBgn0260499	584	570	581	17	5	3.4	567
FBgn0260632	784	750	733	85	9	9.444444444444445	699
FBgn0260639	767	750	750	34	7	4.857142857142857	733
FBgn0260642	753	750	731	25	3	8.333333333333334	728
FBgn0260643	766	750	765	17	3	5.666666666666667	749
FBgn0260645	544	528	538	22	4	5.5	522
FBgn0260648	761	750	750	22	9	2.4444444444444446	739
FBgn0260655	764	750	731	47	8	5.875	717
FBgn0260657	767	750	750	34	8	4.25	733
FBgn0260658	768	750	749	37	5	7.4	731
FBgn0260659	764	750	757	21	4	5.25	743
FBgn0260660	770	750	764	26	6	4.333333333333333	744
FBgn0260713	755	750	739	21	5	4.2	734
FBgn0260720	750	750	746	4	2	2	746
FBgn0260742	755	750	750	10	4	2.5	745
FBgn0260743	782	750	782	32	6	5.333333333333333	750
FBgn0260745	752	750	711	43	6	7.166666666666667	709
FBgn0260746	755	750	704	56	11	5.090909090909091	699
FBgn0260748	750	750	119	631	3	210.33333333333334	119
FBgn0260753	795	750	681	159	15	10.6	636
FBgn0260755	754	750	723	35	11	3.1818181818181817	719
FBgn0260766	774	750	741	57	12	4.75	717
FBgn0260768	750	750	513	237	7	33.857142857142854	513
FBgn0260771	769	750	759	29	8	3.625	740
FBgn0260777	761	750	740	32	7	4.571428571428571	729
FBgn0260779	750	750	748	2	2	1	748
FBgn0260789	765	750	759	21	4	5.25	744
FBgn0260795	757	750	753	11	6	1.8333333333333333	746
FBgn0260817	757	750	749	15	4	3.75	742
FBgn0260855	781	750	777	35	12	2.9166666666666665	746
FBgn0260856	751	750	745	7	4	1.75	744
FBgn0260858	750	750	748	2	2	1	748
FBgn0260861	751	750	734	18	4	4.5	733
FBgn0260866	807	750	785	79	12	6.583333333333333	728
FBgn0260873	767	750	653	131	6	21.833333333333332	636
FBgn0260874	573	538	558	50	9	5.555555555555555	523
FBgn0260932	779	750	777	31	6	5.166666666666667	748
FBgn0260935	765	750	743	37	9	4.111111111111111	728
FBgn0260938	724	724	722	2	1	2	722
FBgn0260940	765	750	734	46	11	4.181818181818182	719
FBgn0260941	756	750	726	36	8	4.5	720
FBgn0260942	769	750	735	53	10	5.3	716
FBgn0260943	795	750	789	51	5	10.2	744
FBgn0260944	752	750	736	18	5	3.6	734
FBgn0260955	671	660	669	13	5	2.6	658
FBgn0260959	757	750	690	74	10	7.4	683
FBgn0260960	799	750	735	113	12	9.416666666666666	686
FBgn0260962	817	750	759	125	16	7.8125	692
FBgn0260964	766	750	743	39	11	3.5454545454545454	727
FBgn0260965	760	750	736	34	6	5.666666666666667	726
FBgn0260968	750	750	641	109	4	27.25	641
FBgn0260969	763	750	753	23	6	3.8333333333333335	740
FBgn0260971	753	750	738	18	6	3	735
FBgn0260972	772	750	766	28	7	4	744
FBgn0260985	753	750	743	13	5	2.6	740
FBgn0260986	751	750	720	32	6	5.333333333333333	719
FBgn0260987	758	750	318	448	8	56	310
FBgn0260991	750	750	749	1	1	1	749
FBgn0261020	759	750	724	44	10	4.4	715
FBgn0261046	766	750	717	65	7	9.285714285714286	701
FBgn0261049	760	750	755	15	5	3	745
FBgn0261053	750	750	695	55	5	11	695
FBgn0261054	770	750	749	41	9	4.555555555555555	729
FBgn0261055	759	750	733	35	6	5.833333333333333	724
FBgn0261059	770	750	759	31	5	6.2	739
FBgn0261061	570	553	550	37	5	7.4	533
FBgn0261064	762	750	730	44	8	5.5	718
FBgn0261065	793	750	775	61	9	6.777777777777778	732
FBgn0261067	751	750	570	182	4	45.5	569
FBgn0261068	776	750	761	41	9	4.555555555555555	735
FBgn0261085	771	750	762	30	8	3.75	741
FBgn0261086	772	750	765	29	7	4.142857142857143	743
FBgn0261089	751	750	738	14	4	3.5	737
FBgn0261090	765	750	750	30	7	4.285714285714286	735
FBgn0261108	608	596	581	39	5	7.8	569
FBgn0261109	757	750	754	10	4	2.5	747
FBgn0261111	780	750	770	40	3	13.333333333333334	740
FBgn0261113	867	750	841	143	17	8.411764705882353	724
FBgn0261119	764	750	742	36	7	5.142857142857143	728
FBgn0261238	778	750	757	49	5	9.8	729
FBgn0261239	757	750	717	47	14	3.357142857142857	710
FBgn0261243	753	750	616	140	5	28	613
FBgn0261244	572	540	559	45	6	7.5	527
FBgn0261245	778	750	767	39	4	9.75	739
FBgn0261258	829	750	799	109	13	8.384615384615385	720
FBgn0261260	758	750	669	97	11	8.818181818181818	661
FBgn0261261	786	750	759	63	10	6.3	723
FBgn0261262	793	750	725	111	13	8.538461538461538	682
FBgn0261266	751	750	751	1	1	1	750
FBgn0261268	806	750	730	132	16	8.25	674
FBgn0261269	751	750	749	3	3	1	748
FBgn0261270	777	750	772	32	4	8	745
FBgn0261274	806	750	770	92	19	4.842105263157895	714
FBgn0261276	649	630	640	28	8	3.5	621
FBgn0261277	751	750	704	48	5	9.6	703
FBgn0261283	756	750	748	14	6	2.3333333333333335	742
FBgn0261284	767	750	752	32	5	6.4	735
FBgn0261285	789	750	719	109	9	12.11111111111111	680
FBgn0261286	760	750	754	16	7	2.2857142857142856	744
FBgn0261289	815	750	808	72	11	6.545454545454546	743
FBgn0261290	789	750	775	53	8	6.625	736
FBgn0261291	750	750	736	14	3	4.666666666666667	736
FBgn0261292	773	750	758	38	11	3.4545454545454546	735
FBgn0261293	687	686	543	145	6	24.166666666666668	542
FBgn0261294	788	750	775	51	11	4.636363636363637	737
FBgn0261341	760	750	732	38	5	7.6	722
FBgn0261363	791	750	759	73	10	7.3	718
FBgn0261373	750	750	750	0	0	NA	750
FBgn0261380	752	750	723	31	7	4.428571428571429	721
FBgn0261383	751	750	727	25	3	8.333333333333334	726
FBgn0261385	765	750	764	16	5	3.2	749
FBgn0261395	783	750	770	46	11	4.181818181818182	737
FBgn0261397	757	750	756	8	4	2	749
FBgn0261401	751	750	751	1	1	1	750
FBgn0261429	751	750	732	20	7	2.857142857142857	731
FBgn0261434	773	750	773	23	5	4.6	750
FBgn0261436	767	750	559	225	11	20.454545454545453	542
FBgn0261437	751	750	750	2	2	1	749
FBgn0261445	587	561	520	93	7	13.285714285714286	494
FBgn0261446	785	750	759	61	9	6.777777777777778	724
FBgn0261456	809	750	788	80	11	7.2727272727272725	729
FBgn0261461	771	750	736	56	10	5.6	715
FBgn0261477	769	750	676	112	10	11.2	657
FBgn0261479	751	750	751	1	1	1	750
FBgn0261501	754	750	739	19	2	9.5	735
FBgn0261502	750	750	544	206	1	206	544
FBgn0261503	758	750	405	361	4	90.25	397
FBgn0261506	579	573	547	38	6	6.333333333333333	541
FBgn0261509	768	750	756	30	7	4.285714285714286	738
FBgn0261514	750	750	599	151	3	50.333333333333336	599
FBgn0261523	720	695	689	56	4	14	664
FBgn0261524	752	750	735	19	7	2.7142857142857144	733
FBgn0261526	753	750	721	35	5	7	718
FBgn0261529	685	677	665	28	5	5.6	657
FBgn0261530	763	750	721	55	5	11	708
FBgn0261545	802	750	797	57	8	7.125	745
FBgn0261549	778	750	593	213	11	19.363636363636363	565
FBgn0261550	782	750	211	603	4	150.75	179
FBgn0261552	759	750	736	32	10	3.2	727
FBgn0261553	729	724	679	55	6	9.166666666666666	674
FBgn0261554	756	750	750	12	3	4	744
FBgn0261555	814	750	798	80	7	11.428571428571429	734
FBgn0261556	786	750	742	80	11	7.2727272727272725	706
FBgn0261560	761	750	755	17	6	2.8333333333333335	744
FBgn0261561	789	750	750	78	7	11.142857142857142	711
FBgn0261562	762	750	750	24	5	4.8	738
FBgn0261564	771	750	760	32	5	6.4	739
FBgn0261567	751	750	324	428	3	142.66666666666666	323
FBgn0261568	780	750	776	34	4	8.5	746
FBgn0261570	750	750	750	0	0	NA	750
FBgn0261571	756	750	756	6	4	1.5	750
FBgn0261573	750	750	741	9	2	4.5	741
FBgn0261574	761	750	745	27	6	4.5	734
FBgn0261581	765	750	107	673	3	224.33333333333334	92
FBgn0261582	791	750	766	66	9	7.333333333333333	725
FBgn0261583	752	750	452	302	5	60.4	450
FBgn0261584	765	750	732	48	13	3.6923076923076925	717
FBgn0261586	751	750	740	12	4	3	739
FBgn0261587	772	750	749	45	4	11.25	727
FBgn0261588	760	750	745	25	6	4.166666666666667	735
FBgn0261592	773	750	763	33	8	4.125	740
FBgn0261602	813	750	718	158	18	8.777777777777779	655
FBgn0261608	673	653	672	21	4	5.25	652
FBgn0261610	754	750	708	50	8	6.25	704
FBgn0261611	810	750	787	83	13	6.384615384615385	727
FBgn0261612	762	750	749	25	8	3.125	737
FBgn0261614	716	699	695	38	3	12.666666666666666	678
FBgn0261615	756	750	730	32	10	3.2	724
FBgn0261616	716	694	665	73	9	8.11111111111111	643
FBgn0261618	808	750	804	62	9	6.888888888888889	746
FBgn0261627	758	750	742	24	4	6	734
FBgn0261628	779	750	748	60	10	6	719
FBgn0261630	769	750	766	22	5	4.4	747
FBgn0261632	653	650	592	64	9	7.111111111111111	589
FBgn0261633	773	750	746	50	11	4.545454545454546	723
FBgn0261634	773	750	741	55	12	4.583333333333333	718
FBgn0261635	761	750	732	40	5	8	721
FBgn0261636	775	750	625	175	7	25	600
FBgn0261641	760	750	656	114	9	12.666666666666666	646
FBgn0261647	759	750	758	10	3	3.3333333333333335	749
FBgn0261648	763	750	762	14	3	4.666666666666667	749
FBgn0261649	774	750	766	32	5	6.4	742
FBgn0261671	769	750	755	33	10	3.3	736
FBgn0261673	762	750	700	74	12	6.166666666666667	688
FBgn0261674	753	750	750	6	3	2	747
FBgn0261675	795	750	789	51	8	6.375	744
FBgn0261700	775	750	757	43	8	5.375	732
FBgn0261702	751	750	268	484	8	60.5	267
FBgn0261703	779	750	436	372	6	62	407
FBgn0261705	750	750	654	96	2	48	654
FBgn0261707	774	750	752	46	6	7.666666666666667	728
FBgn0261709	762	750	760	14	5	2.8	748
FBgn0261710	751	750	747	5	2	2.5	746
FBgn0261714	750	750	750	0	0	NA	750
FBgn0261722	776	750	739	63	9	7	713
FBgn0261723	774	750	737	61	9	6.777777777777778	713
FBgn0261786	750	750	740	10	4	2.5	740
FBgn0261787	752	750	745	9	5	1.8	743
FBgn0261789	774	750	771	27	5	5.4	747
FBgn0261791	798	750	785	61	9	6.777777777777778	737
FBgn0261792	777	750	759	45	7	6.428571428571429	732
FBgn0261793	784	750	769	49	12	4.083333333333333	735
FBgn0261794	764	750	761	17	6	2.8333333333333335	747
FBgn0261797	750	750	745	5	2	2.5	745
FBgn0261799	780	750	745	65	8	8.125	715
FBgn0261800	855	750	844	116	11	10.545454545454545	739
FBgn0261801	760	750	759	11	3	3.6666666666666665	749
FBgn0261803	753	750	694	62	13	4.769230769230769	691
FBgn0261804	750	750	748	2	1	2	748
FBgn0261805	764	750	740	38	4	9.5	726
FBgn0261806	760	750	747	23	8	2.875	737
FBgn0261807	702	683	635	86	6	14.333333333333334	616
FBgn0261811	769	750	748	40	10	4	729
FBgn0261813	757	750	715	49	12	4.083333333333333	708
FBgn0261816	752	750	725	29	6	4.833333333333333	723
FBgn0261817	750	750	722	28	2	14	722
FBgn0261823	773	750	758	38	10	3.8	735
FBgn0261832	780	750	752	58	10	5.8	722
FBgn0261833	790	750	723	107	6	17.833333333333332	683
FBgn0261836	753	750	737	19	6	3.1666666666666665	734
FBgn0261850	753	750	562	194	6	32.333333333333336	559
FBgn0261854	750	750	734	16	4	4	734
FBgn0261857	877	750	847	157	10	15.7	720
FBgn0261860	753	750	725	31	7	4.428571428571429	722
FBgn0261861	751	750	745	7	4	1.75	744
FBgn0261862	539	526	459	93	9	10.333333333333334	446
FBgn0261871	758	750	756	10	5	2	748
FBgn0261872	765	750	751	29	4	7.25	736
FBgn0261873	773	750	735	61	9	6.777777777777778	712
FBgn0261881	772	750	737	57	10	5.7	715
FBgn0261885	771	750	725	67	9	7.444444444444445	704
FBgn0261924	761	750	741	31	5	6.2	730
FBgn0261927	779	750	742	66	6	11	713
FBgn0261929	751	750	718	34	7	4.857142857142857	717
FBgn0261930	756	750	723	39	7	5.571428571428571	717
FBgn0261931	754	750	744	14	6	2.3333333333333335	740
FBgn0261932	750	750	743	7	2	3.5	743
FBgn0261933	790	750	768	62	9	6.888888888888889	728
FBgn0261938	757	750	757	7	2	3.5	750
FBgn0261952	804	750	769	89	13	6.846153846153846	715
FBgn0261953	756	750	753	9	2	4.5	747
FBgn0261955	772	750	771	23	5	4.6	749
FBgn0261963	750	750	745	5	3	1.6666666666666667	745
FBgn0261976	750	750	747	3	1	3	747
FBgn0261983	751	750	746	6	3	2	745
FBgn0261984	752	750	740	14	2	7	738
FBgn0261986	757	750	714	50	9	5.555555555555555	707
FBgn0261987	799	750	792	56	16	3.5	743
FBgn0261988	778	750	769	37	5	7.4	741
FBgn0261989	765	750	580	200	10	20	565
FBgn0261990	812	750	800	74	10	7.4	738
FBgn0261994	750	750	747	3	1	3	747
FBgn0261999	762	750	708	66	4	16.5	696
FBgn0262000	751	750	708	44	5	8.8	707
FBgn0262001	756	750	666	96	9	10.666666666666666	660
FBgn0262003	740	714	714	52	9	5.777777777777778	688
FBgn0262005	792	750	778	56	5	11.2	736
FBgn0262006	764	750	745	33	6	5.5	731
FBgn0262007	781	750	768	44	9	4.888888888888889	737
FBgn0262008	772	750	757	37	7	5.285714285714286	735
FBgn0262009	763	750	742	34	8	4.25	729
FBgn0262018	753	750	657	99	7	14.142857142857142	654
FBgn0262020	793	750	779	57	12	4.75	736
FBgn0262021	786	750	755	67	15	4.466666666666667	719
FBgn0262022	764	750	697	81	12	6.75	683
FBgn0262025	750	750	728	22	3	7.333333333333333	728
FBgn0262028	762	750	753	21	3	7	741
FBgn0262030	756	750	726	36	7	5.142857142857143	720
FBgn0262033	775	750	758	42	5	8.4	733
FBgn0262057	794	750	716	122	10	12.2	672
FBgn0262081	755	750	749	11	5	2.2	744
FBgn0262097	763	750	745	31	5	6.2	732
FBgn0262098	754	750	750	8	3	2.6666666666666665	746
FBgn0262100	814	750	774	104	14	7.428571428571429	710
FBgn0262102	767	750	739	45	9	5	722
FBgn0262104	761	750	711	61	9	6.777777777777778	700
FBgn0262105	771	750	759	33	5	6.6	738
FBgn0262106	759	750	695	73	6	12.166666666666666	686
FBgn0262107	773	750	756	40	9	4.444444444444445	733
FBgn0262108	751	750	738	14	6	2.3333333333333335	737
FBgn0262111	768	750	768	18	5	3.6	750
FBgn0262112	773	750	738	58	11	5.2727272727272725	715
FBgn0262114	804	750	785	73	9	8.11111111111111	731
FBgn0262125	750	750	556	194	1	194	556
FBgn0262127	771	750	744	48	11	4.363636363636363	723
FBgn0262141	800	750	678	172	14	12.285714285714286	628
FBgn0262146	757	750	756	8	3	2.6666666666666665	749
FBgn0262148	629	614	619	25	6	4.166666666666667	604
FBgn0262149	755	750	748	12	4	3	743
FBgn0262150	763	750	704	72	5	14.4	691
FBgn0262160	755	750	718	42	8	5.25	713
FBgn0262166	750	750	734	16	2	8	734
FBgn0262167	753	750	701	55	2	27.5	698
FBgn0262169	763	750	757	19	6	3.1666666666666665	744
FBgn0262170	752	750	750	4	2	2	748
FBgn0262172	755	750	669	91	6	15.166666666666666	664
FBgn0262178	787	750	784	40	9	4.444444444444445	747
FBgn0262181	834	750	734	184	15	12.266666666666667	650
FBgn0262182	767	750	752	32	9	3.5555555555555554	735
FBgn0262215	762	750	683	91	9	10.11111111111111	671
FBgn0262223	751	750	740	12	5	2.4	739
FBgn0262256	750	750	685	65	4	16.25	685
FBgn0262263	765	750	760	20	5	4	745
FBgn0262266	811	750	755	117	15	7.8	694
FBgn0262293	772	750	184	610	2	305	162
FBgn0262302	760	750	735	35	8	4.375	725
FBgn0262314	821	750	621	271	16	16.9375	550
FBgn0262330	609	550	554	114	5	22.8	495
FBgn0262333	600	600	576	24	4	6	576
FBgn0262334	766	750	711	71	10	7.1	695
FBgn0262338	768	750	718	68	20	3.4	700
FBgn0262352	756	750	699	63	8	7.875	693
FBgn0262353	770	750	712	78	13	6	692
FBgn0262354	759	750	754	14	7	2	745
FBgn0262356	751	750	579	173	4	43.25	578
FBgn0262357	769	750	754	34	5	6.8	735
FBgn0262358	756	750	725	37	7	5.285714285714286	719
FBgn0262360	760	750	632	138	11	12.545454545454545	622
FBgn0262361	771	750	763	29	6	4.833333333333333	742
FBgn0262364	750	750	741	9	4	2.25	741
FBgn0262366	750	750	290	460	7	65.71428571428571	290
FBgn0262374	760	750	733	37	10	3.7	723
FBgn0262376	758	750	743	23	4	5.75	735
FBgn0262378	649	600	620	78	13	6	571
FBgn0262383	785	750	785	35	5	7	750
FBgn0262388	770	750	745	45	6	7.5	725
FBgn0262390	750	750	730	20	6	3.3333333333333335	730
FBgn0262396	795	750	743	97	9	10.777777777777779	698
FBgn0262400	755	750	727	33	6	5.5	722
FBgn0262401	750	750	745	5	1	5	745
FBgn0262415	755	750	748	12	3	4	743
FBgn0262428	758	750	740	26	3	8.666666666666666	732
FBgn0262433	759	750	713	55	10	5.5	704
FBgn0262437	752	750	727	27	7	3.857142857142857	725
FBgn0262440	757	750	724	40	7	5.714285714285714	717
FBgn0262445	781	750	727	85	10	8.5	696
FBgn0262446	788	750	738	88	12	7.333333333333333	700
FBgn0262467	753	750	724	32	6	5.333333333333333	721
FBgn0262473	777	750	734	70	9	7.777777777777778	707
FBgn0262475	756	750	749	13	6	2.1666666666666665	743
FBgn0262476	775	750	767	33	7	4.714285714285714	742
FBgn0262480	759	750	741	27	8	3.375	732
FBgn0262483	775	750	774	26	6	4.333333333333333	749
FBgn0262484	770	750	745	45	12	3.75	725
FBgn0262486	758	750	698	68	8	8.5	690
FBgn0262487	753	750	739	17	7	2.4285714285714284	736
FBgn0262508	783	750	770	46	9	5.111111111111111	737
FBgn0262512	827	750	820	84	11	7.636363636363637	743
FBgn0262515	755	750	744	16	4	4	739
FBgn0262516	797	750	774	70	18	3.888888888888889	727
FBgn0262517	750	750	750	0	0	NA	750
FBgn0262518	758	750	748	18	3	6	740
FBgn0262519	752	750	752	2	2	1	750
FBgn0262524	750	750	748	2	1	2	748
FBgn0262529	751	750	732	20	6	3.3333333333333335	731
FBgn0262534	782	750	773	41	10	4.1	741
FBgn0262535	764	750	739	39	6	6.5	725
FBgn0262541	790	750	764	66	9	7.333333333333333	724
FBgn0262544	770	750	747	43	7	6.142857142857143	727
FBgn0262546	751	750	698	54	2	27	697
FBgn0262547	752	750	707	47	7	6.714285714285714	705
FBgn0262559	784	750	761	57	11	5.181818181818182	727
FBgn0262562	771	750	747	45	8	5.625	726
FBgn0262564	773	750	760	36	8	4.5	737
FBgn0262567	777	750	762	42	6	7	735
FBgn0262568	757	750	733	31	7	4.428571428571429	726
FBgn0262569	755	750	714	46	5	9.2	709
FBgn0262571	760	750	747	23	9	2.5555555555555554	737
FBgn0262572	751	750	668	84	9	9.333333333333334	667
FBgn0262574	768	750	753	33	6	5.5	735
FBgn0262575	763	750	160	616	5	123.2	147
FBgn0262576	757	750	716	48	7	6.857142857142857	709
FBgn0262577	750	750	744	6	3	2	744
FBgn0262580	777	750	720	84	10	8.4	693
FBgn0262581	756	750	722	40	4	10	716
FBgn0262587	766	750	633	149	3	49.666666666666664	617
FBgn0262592	780	750	726	84	7	12	696
FBgn0262593	767	750	755	29	5	5.8	738
FBgn0262594	751	750	747	5	3	1.6666666666666667	746
FBgn0262598	769	750	741	47	10	4.7	722
FBgn0262599	794	750	789	49	7	7	745
FBgn0262601	761	750	758	14	4	3.5	747
FBgn0262604	792	750	727	107	12	8.916666666666666	685
FBgn0262605	750	750	719	31	6	5.166666666666667	719
FBgn0262606	763	750	376	400	14	28.571428571428573	363
FBgn0262607	752	750	701	53	11	4.818181818181818	699
FBgn0262608	769	750	751	37	9	4.111111111111111	732
FBgn0262609	745	719	700	71	6	11.833333333333334	674
FBgn0262611	773	750	731	65	11	5.909090909090909	708
FBgn0262612	775	750	767	33	4	8.25	742
FBgn0262616	757	750	619	145	12	12.083333333333334	612
FBgn0262619	772	750	763	31	6	5.166666666666667	741
FBgn0262622	752	750	738	16	3	5.333333333333333	736
FBgn0262623	772	750	772	22	6	3.6666666666666665	750
FBgn0262624	759	750	717	51	6	8.5	708
FBgn0262636	810	750	808	62	6	10.333333333333334	748
FBgn0262647	758	750	758	8	2	4	750
FBgn0262679	788	750	695	131	7	18.714285714285715	657
FBgn0262680	792	750	693	141	10	14.1	651
FBgn0262683	752	750	317	437	3	145.66666666666666	315
FBgn0262685	780	750	718	92	12	7.666666666666667	688
FBgn0262686	777	750	679	125	12	10.416666666666666	652
FBgn0262687	529	529	32	497	1	497	32
FBgn0262690	808	750	773	93	7	13.285714285714286	715
FBgn0262699	757	750	738	26	4	6.5	731
FBgn0262714	782	750	542	272	12	22.666666666666668	510
FBgn0262716	758	750	747	19	5	3.8	739
FBgn0262728	566	557	558	17	5	3.4	549
FBgn0262730	769	750	734	54	9	6	715
FBgn0262731	777	750	576	228	4	57	549
FBgn0262732	757	750	635	129	7	18.428571428571427	628
FBgn0262734	764	750	709	69	6	11.5	695
FBgn0262736	686	683	653	36	9	4	650
FBgn0262737	752	750	748	6	2	3	746
FBgn0262738	768	750	745	41	8	5.125	727
FBgn0262739	573	555	569	22	5	4.4	551
FBgn0262740	767	750	727	57	6	9.5	710
FBgn0262743	759	750	759	9	3	3	750
FBgn0262782	766	750	761	21	4	5.25	745
FBgn0262786	759	750	682	86	5	17.2	673
FBgn0262787	782	750	740	74	7	10.571428571428571	708
FBgn0262788	750	750	736	14	4	3.5	736
FBgn0262794	754	750	730	28	3	9.333333333333334	726
FBgn0262801	796	750	781	61	10	6.1	735
FBgn0262808	774	750	320	478	4	119.5	296
FBgn0262810	780	750	776	34	7	4.857142857142857	746
FBgn0262811	752	750	745	9	5	1.8	743
FBgn0262813	784	750	762	56	10	5.6	728
FBgn0262814	568	568	567	1	1	1	567
FBgn0262817	760	750	749	21	8	2.625	739
FBgn0262819	754	750	743	15	4	3.75	739
FBgn0262820	750	750	749	1	1	1	749
FBgn0262821	778	750	773	33	13	2.5384615384615383	745
FBgn0262822	768	750	731	55	5	11	713
FBgn0262827	764	750	688	90	9	10	674
FBgn0262838	764	750	737	41	12	3.4166666666666665	723
FBgn0262839	814	750	813	65	6	10.833333333333334	749
FBgn0262840	754	750	754	4	1	4	750
FBgn0262842	750	750	734	16	5	3.2	734
FBgn0262843	757	750	744	20	4	5	737
FBgn0262855	750	750	441	309	2	154.5	441
FBgn0262858	757	750	745	19	6	3.1666666666666665	738
FBgn0262867	763	750	723	53	11	4.818181818181818	710
FBgn0262869	756	750	756	6	3	2	750
FBgn0262871	783	750	766	50	9	5.555555555555555	733
FBgn0262872	754	750	754	4	1	4	750
FBgn0262875	766	750	744	38	5	7.6	728
FBgn0262876	750	750	743	7	2	3.5	743
FBgn0262877	781	750	769	43	4	10.75	738
FBgn0262880	800	750	799	51	4	12.75	749
FBgn0262881	770	750	702	88	9	9.777777777777779	682
FBgn0262882	756	750	710	52	8	6.5	704
FBgn0262883	750	750	731	19	5	3.8	731
FBgn0262885	803	750	594	262	11	23.818181818181817	541
FBgn0262887	773	750	598	198	10	19.8	575
FBgn0262888	752	750	720	34	8	4.25	718
FBgn0262889	757	750	727	37	8	4.625	720
FBgn0262890	760	750	724	46	11	4.181818181818182	714
FBgn0262891	756	750	755	7	5	1.4	749
FBgn0262892	750	750	747	3	2	1.5	747
FBgn0262893	769	750	767	21	4	5.25	748
FBgn0262895	752	750	723	31	3	10.333333333333334	721
FBgn0262896	751	750	718	34	7	4.857142857142857	717
FBgn0262899	810	750	783	87	10	8.7	723
FBgn0262902	756	750	716	46	2	23	710
FBgn0262903	755	750	745	15	4	3.75	740
FBgn0262904	790	750	767	63	6	10.5	727
FBgn0262937	754	750	754	4	2	2	750
FBgn0262944	776	750	648	154	10	15.4	622
FBgn0262947	839	750	796	132	15	8.8	707
FBgn0262951	756	750	741	21	4	5.25	735
FBgn0262955	750	750	743	7	3	2.3333333333333335	743
FBgn0262960	768	750	718	68	14	4.857142857142857	700
FBgn0262962	752	750	751	3	3	1	749
FBgn0262963	756	750	742	20	5	4	736
FBgn0262967	779	750	738	70	11	6.363636363636363	709
FBgn0262969	782	750	695	119	10	11.9	663
FBgn0262971	649	607	595	96	7	13.714285714285714	553
FBgn0262972	750	750	736	14	3	4.666666666666667	736
FBgn0262975	791	750	699	133	15	8.866666666666667	658
FBgn0262976	792	750	726	108	7	15.428571428571429	684
FBgn0262979	753	750	717	39	7	5.571428571428571	714
FBgn0262980	757	750	649	115	10	11.5	642
FBgn0262981	752	750	745	9	4	2.25	743
FBgn0262984	757	750	757	7	3	2.3333333333333335	750
FBgn0262986	752	750	723	31	6	5.166666666666667	721
FBgn0262987	762	750	760	14	4	3.5	748
FBgn0262988	750	750	746	4	2	2	746
FBgn0262989	780	750	771	39	11	3.5454545454545454	741
FBgn0262990	812	750	793	81	10	8.1	731
FBgn0262992	771	750	701	91	5	18.2	680
FBgn0262994	750	750	714	36	4	9	714
FBgn0262995	788	750	774	52	9	5.777777777777778	736
FBgn0262996	753	750	703	53	7	7.571428571428571	700
FBgn0262998	750	750	585	165	3	55	585
FBgn0262999	757	738	742	34	8	4.25	723
FBgn0263004	782	750	781	33	5	6.6	749
FBgn0263006	764	750	757	21	5	4.2	743
FBgn0263019	785	750	765	55	6	9.166666666666666	730
FBgn0263021	758	750	410	356	5	71.2	402
FBgn0263022	772	750	752	42	9	4.666666666666667	730
FBgn0263026	762	750	748	26	4	6.5	736
FBgn0263027	795	750	769	71	9	7.888888888888889	724
FBgn0263034	751	750	230	522	3	174	229
FBgn0263037	719	719	715	4	2	2	715
FBgn0263038	751	750	750	2	2	1	749
FBgn0263040	750	750	742	8	2	4	742
FBgn0263049	614	557	555	116	8	14.5	498
FBgn0263072	773	750	693	103	6	17.166666666666668	670
FBgn0263076	794	750	792	46	5	9.2	748
FBgn0263077	832	750	820	94	7	13.428571428571429	738
FBgn0263079	546	535	543	14	4	3.5	532
FBgn0263080	796	750	780	62	8	7.75	734
FBgn0263082	754	750	751	7	4	1.75	747
FBgn0263083	754	750	754	4	2	2	750
FBgn0263085	568	568	568	0	0	NA	568
FBgn0263086	789	750	757	71	10	7.1	718
FBgn0263088	763	750	736	40	12	3.3333333333333335	723
FBgn0263089	810	750	797	73	12	6.083333333333333	737
FBgn0263090	758	750	730	36	6	6	722
FBgn0263092	750	750	86	664	2	332	86
FBgn0263093	787	750	736	88	17	5.176470588235294	699
FBgn0263095	753	750	733	23	4	5.75	730
FBgn0263102	759	750	759	9	1	9	750
FBgn0263108	752	750	744	10	2	5	742
FBgn0263109	786	750	780	42	7	6	744
FBgn0263110	787	750	787	37	5	7.4	750
FBgn0263113	539	539	528	11	3	3.6666666666666665	528
FBgn0263114	751	750	748	4	2	2	747
FBgn0263116	762	750	756	18	5	3.6	744
FBgn0263117	754	750	742	16	3	5.333333333333333	738
FBgn0263118	753	750	721	35	2	17.5	718
FBgn0263120	833	750	740	176	11	16	657
FBgn0263130	756	750	748	14	4	3.5	742
FBgn0263131	758	750	745	21	6	3.5	737
FBgn0263132	772	750	733	61	11	5.545454545454546	711
FBgn0263133	554	547	503	58	8	7.25	496
FBgn0263143	750	750	750	0	0	NA	750
FBgn0263144	783	750	774	42	7	6	741
FBgn0263197	756	750	738	24	5	4.8	732
FBgn0263198	754	750	750	8	4	2	746
FBgn0263199	768	750	748	38	6	6.333333333333333	730
FBgn0263200	779	750	771	37	6	6.166666666666667	742
FBgn0263206	513	513	494	19	4	4.75	494
FBgn0263216	777	750	727	77	10	7.7	700
FBgn0263217	751	750	693	59	8	7.375	692
FBgn0263220	760	750	747	23	6	3.8333333333333335	737
FBgn0263233	751	750	746	6	4	1.5	745
FBgn0263234	755	750	697	63	6	10.5	692
FBgn0263235	683	654	655	57	9	6.333333333333333	626
FBgn0263236	752	750	727	27	4	6.75	725
FBgn0263237	773	750	764	32	7	4.571428571428571	741
FBgn0263239	779	750	776	32	4	8	747
FBgn0263240	757	750	747	17	5	3.4	740
FBgn0263241	828	750	783	123	19	6.473684210526316	705
FBgn0263246	762	750	754	20	6	3.3333333333333335	742
FBgn0263247	845	750	811	129	13	9.923076923076923	716
FBgn0263248	819	750	794	94	10	9.4	725
FBgn0263249	774	750	750	48	10	4.8	726
FBgn0263256	755	750	743	17	7	2.4285714285714284	738
FBgn0263257	753	750	689	67	9	7.444444444444445	686
FBgn0263258	767	750	754	30	7	4.285714285714286	737
FBgn0263270	755	750	597	163	4	40.75	592
FBgn0263289	754	750	704	54	9	6	700
FBgn0263320	794	750	785	53	10	5.3	741
FBgn0263321	750	750	726	24	6	4	726
FBgn0263322	769	750	763	25	6	4.166666666666667	744
FBgn0263323	751	750	693	59	3	19.666666666666668	692
FBgn0263325	755	750	735	25	8	3.125	730
FBgn0263326	781	750	669	143	6	23.833333333333332	638
FBgn0263327	883	750	868	148	10	14.8	735
FBgn0263328	791	750	777	55	4	13.75	736
FBgn0263330	770	750	730	60	9	6.666666666666667	710
FBgn0263331	754	750	745	13	5	2.6	741
FBgn0263332	760	750	736	34	3	11.333333333333334	726
FBgn0263333	810	750	770	100	10	10	710
FBgn0263334	826	750	742	160	17	9.411764705882353	666
FBgn0263335	766	750	759	23	6	3.8333333333333335	743
FBgn0263337	782	750	751	63	10	6.3	719
FBgn0263338	752	750	748	6	5	1.2	746
FBgn0263340	750	750	741	9	3	3	741
FBgn0263341	750	750	744	6	2	3	744
FBgn0263342	761	750	753	19	6	3.1666666666666665	742
FBgn0263343	555	544	514	52	11	4.7272727272727275	503
FBgn0263351	751	750	740	12	4	3	739
FBgn0263352	781	750	749	63	9	7	718
FBgn0263353	774	750	767	31	5	6.2	743
FBgn0263376	755	750	733	27	5	5.4	728
FBgn0263378	750	750	734	16	3	5.333333333333333	734
FBgn0263379	750	750	746	4	2	2	746
FBgn0263380	813	750	760	116	13	8.923076923076923	697
FBgn0263381	805	750	793	67	11	6.090909090909091	738
FBgn0263383	768	750	648	138	4	34.5	630
FBgn0263384	770	750	760	30	5	6	740
FBgn0263385	766	750	742	40	9	4.444444444444445	726
FBgn0263386	758	750	709	57	10	5.7	701
FBgn0263388	760	750	748	22	5	4.4	738
FBgn0263390	750	750	706	44	9	4.888888888888889	706
FBgn0263391	750	750	643	107	4	26.75	643
FBgn0263392	766	750	749	33	10	3.3	733
FBgn0263396	786	750	750	72	7	10.285714285714286	714
FBgn0263398	752	750	727	27	8	3.375	725
FBgn0263399	765	750	746	34	6	5.666666666666667	731
FBgn0263400	754	750	752	6	4	1.5	748
FBgn0263401	764	750	746	32	8	4	732
FBgn0263402	764	750	722	56	10	5.6	708
FBgn0263403	752	750	727	27	3	9	725
FBgn0263404	762	750	722	52	3	17.333333333333332	710
FBgn0263405	775	750	738	62	8	7.75	713
FBgn0263407	780	750	774	36	9	4	744
FBgn0263408	750	750	735	15	3	5	735
FBgn0263409	769	750	736	52	5	10.4	717
FBgn0263410	751	750	713	39	5	7.8	712
FBgn0263413	785	750	749	71	7	10.142857142857142	714
FBgn0263414	771	750	715	77	12	6.416666666666667	694
FBgn0263441	792	750	777	57	5	11.4	735
FBgn0263442	760	750	706	64	8	8	696
FBgn0263443	796	750	764	78	6	13	718
FBgn0263444	754	750	753	5	3	1.6666666666666667	749
FBgn0263446	799	750	760	88	14	6.285714285714286	711
FBgn0263447	752	750	751	3	3	1	749
FBgn0263448	759	750	753	15	8	1.875	744
FBgn0263449	801	750	793	59	8	7.375	742
FBgn0263452	786	750	778	44	7	6.285714285714286	742
FBgn0263453	758	750	740	26	5	5.2	732
FBgn0263454	764	750	761	17	3	5.666666666666667	747
FBgn0263455	783	750	734	82	5	16.4	701
FBgn0263456	818	750	784	102	14	7.285714285714286	716
FBgn0263457	750	750	746	4	1	4	746
FBgn0263459	762	750	722	52	9	5.777777777777778	710
FBgn0263490	750	750	734	16	4	4	734
FBgn0263492	755	750	749	11	6	1.8333333333333333	744
FBgn0263493	760	750	755	15	5	3	745
FBgn0263494	770	750	751	39	9	4.333333333333333	731
FBgn0263495	751	750	731	21	5	4.2	730
FBgn0263496	775	750	775	25	2	12.5	750
FBgn0263498	760	750	745	25	5	5	735
FBgn0263500	753	750	748	8	4	2	745
FBgn0263501	758	750	729	37	5	7.4	721
FBgn0263502	764	750	754	24	7	3.4285714285714284	740
FBgn0263503	754	750	683	75	6	12.5	679
FBgn0263505	771	750	722	70	9	7.777777777777778	701
FBgn0263506	790	750	778	52	9	5.777777777777778	738
FBgn0263507	766	750	763	19	6	3.1666666666666665	747
FBgn0263509	773	750	721	75	13	5.769230769230769	698
FBgn0263510	799	750	732	116	9	12.88888888888889	683
FBgn0263511	762	750	758	16	5	3.2	746
FBgn0263512	753	750	753	3	1	3	750
FBgn0263517	780	750	779	31	3	10.333333333333334	749
FBgn0263528	750	750	750	0	0	NA	750
FBgn0263539	793	750	776	60	8	7.5	733
FBgn0263543	754	750	740	18	8	2.25	736
FBgn0263548	787	750	780	44	10	4.4	743
FBgn0263552	758	750	758	8	1	8	750
FBgn0263556	750	750	747	3	1	3	747
FBgn0263562	750	750	742	8	2	4	742
FBgn0263572	754	750	426	332	3	110.66666666666667	422
FBgn0263581	754	750	714	44	6	7.333333333333333	710
FBgn0263582	779	750	766	42	6	7	737
FBgn0263584	757	750	706	58	8	7.25	699
FBgn0263585	827	750	803	101	9	11.222222222222221	726
FBgn0263586	764	750	735	43	8	5.375	721
FBgn0263587	778	750	765	41	5	8.2	737
FBgn0263588	755	750	704	56	8	7	699
FBgn0263589	750	750	679	71	15	4.733333333333333	679
FBgn0263590	759	750	752	16	3	5.333333333333333	743
FBgn0263595	770	750	743	47	11	4.2727272727272725	723
FBgn0263599	773	750	771	25	4	6.25	748
FBgn0263600	754	750	729	29	11	2.6363636363636362	725
FBgn0263601	776	750	738	64	14	4.571428571428571	712
FBgn0263602	584	575	572	21	6	3.5	563
FBgn0263603	754	750	465	293	6	48.833333333333336	461
FBgn0263605	769	750	764	24	3	8	745
FBgn0263611	772	750	743	51	10	5.1	721
FBgn0263612	758	750	732	34	5	6.8	724
FBgn0263613	769	750	767	21	3	7	748
FBgn0263615	835	750	823	97	10	9.7	738
FBgn0263616	828	750	819	87	8	10.875	741
FBgn0263617	542	529	520	35	8	4.375	507
FBgn0263618	755	750	698	62	4	15.5	693
FBgn0263619	750	750	570	180	2	90	570
FBgn0263621	640	632	626	22	7	3.142857142857143	618
FBgn0263623	750	750	747	3	3	1	747
FBgn0263624	760	750	749	21	3	7	739
FBgn0263625	760	750	759	11	2	5.5	749
FBgn0263627	611	611	608	3	1	3	608
FBgn0263649	755	750	733	27	7	3.857142857142857	728
FBgn0263650	771	750	757	35	8	4.375	736
FBgn0263652	753	750	749	7	5	1.4	746
FBgn0263655	759	750	712	56	6	9.333333333333334	703
FBgn0263657	766	750	738	44	9	4.888888888888889	722
FBgn0263658	755	750	711	49	3	16.333333333333332	706
FBgn0263659	777	750	729	75	7	10.714285714285714	702
FBgn0263660	771	750	767	25	3	8.333333333333334	746
FBgn0263661	750	750	717	33	4	8.25	717
FBgn0263662	750	750	710	40	3	13.333333333333334	710
FBgn0263663	758	750	748	18	4	4.5	740
FBgn0263664	760	750	739	31	3	10.333333333333334	729
FBgn0263667	772	750	749	45	7	6.428571428571429	727
FBgn0263697	752	750	742	12	4	3	740
FBgn0263706	757	750	718	46	7	6.571428571428571	711
FBgn0263707	796	750	540	302	8	37.75	494
FBgn0263708	754	750	712	46	7	6.571428571428571	708
FBgn0263709	759	750	759	9	3	3	750
FBgn0263743	758	750	743	23	4	5.75	735
FBgn0263745	750	750	31	719	2	359.5	31
FBgn0263746	751	750	732	20	3	6.666666666666667	731
FBgn0263764	767	750	730	54	7	7.714285714285714	713
FBgn0263765	751	750	718	34	4	8.5	717
FBgn0263766	752	750	730	24	8	3	728
FBgn0263769	755	750	712	48	8	6	707
FBgn0263772	751	750	717	35	8	4.375	716
FBgn0263773	823	750	821	75	6	12.5	748
FBgn0263774	758	750	702	64	7	9.142857142857142	694
FBgn0263776	776	750	729	73	13	5.615384615384615	703
FBgn0263780	763	750	527	249	10	24.9	514
FBgn0263782	779	750	775	33	6	5.5	746
FBgn0263802	777	750	734	70	13	5.384615384615385	707
FBgn0263830	750	750	200	550	1	550	200
FBgn0263831	754	750	746	12	5	2.4	742
FBgn0263832	758	750	758	8	4	2	750
FBgn0263838	759	750	723	45	9	5	714
FBgn0263839	787	750	784	40	6	6.666666666666667	747
FBgn0263841	757	750	749	15	4	3.75	742
FBgn0263843	751	750	737	15	4	3.75	736
FBgn0263845	773	750	661	135	9	15	638
FBgn0263846	757	750	727	37	5	7.4	720
FBgn0263850	542	504	521	59	9	6.555555555555555	483
FBgn0263852	750	750	748	2	1	2	748
FBgn0263864	757	750	695	69	9	7.666666666666667	688
FBgn0263866	750	750	684	66	5	13.2	684
FBgn0263868	787	750	756	68	12	5.666666666666667	719
FBgn0263871	750	750	734	16	6	2.6666666666666665	734
FBgn0263872	750	750	675	75	4	18.75	675
FBgn0263873	778	750	762	44	11	4	734
FBgn0263874	769	750	741	47	5	9.4	722
FBgn0263911	750	750	420	330	1	330	420
FBgn0263916	779	750	767	41	10	4.1	738
FBgn0263929	768	750	760	26	10	2.6	742
FBgn0263930	765	750	710	70	8	8.75	695
FBgn0263934	827	750	760	144	7	20.571428571428573	683
FBgn0263967	751	750	743	9	2	4.5	742
FBgn0263970	790	750	751	79	6	13.166666666666666	711
FBgn0263971	751	750	742	10	4	2.5	741
FBgn0263973	776	750	750	52	6	8.666666666666666	724
FBgn0263975	758	750	614	152	6	25.333333333333332	606
FBgn0263976	750	750	738	12	4	3	738
FBgn0263979	777	750	771	33	4	8.25	744
FBgn0263980	750	750	707	43	2	21.5	707
FBgn0263981	750	750	748	2	1	2	748
FBgn0263988	760	750	749	21	5	4.2	739
FBgn0263992	756	750	738	24	2	12	732
FBgn0263994	757	750	458	306	3	102	451
FBgn0263995	752	750	736	18	5	3.6	734
FBgn0263999	750	750	422	328	5	65.6	422
FBgn0264000	646	643	619	30	4	7.5	616
FBgn0264001	764	750	751	27	4	6.75	737
FBgn0264002	751	750	736	16	5	3.2	735
FBgn0264005	752	750	750	4	4	1	748
FBgn0264006	750	750	701	49	5	9.8	701
FBgn0264075	754	750	735	23	6	3.8333333333333335	731
FBgn0264078	753	750	744	12	4	3	741
FBgn0264081	783	750	739	77	10	7.7	706
FBgn0264083	769	750	677	111	15	7.4	658
FBgn0264084	767	750	760	24	6	4	743
FBgn0264085	751	750	744	8	3	2.6666666666666665	743
FBgn0264087	790	750	777	53	8	6.625	737
FBgn0264089	766	750	764	18	5	3.6	748
FBgn0264090	778	750	726	80	8	10	698
FBgn0264260	756	750	702	60	11	5.454545454545454	696
FBgn0264261	753	750	735	21	4	5.25	732
FBgn0264262	812	750	476	398	8	49.75	414
FBgn0264263	753	750	734	22	8	2.75	731
FBgn0264264	759	750	730	38	6	6.333333333333333	721
FBgn0264265	755	750	747	13	3	4.333333333333333	742
FBgn0264266	811	750	797	75	14	5.357142857142857	736
FBgn0264267	789	750	788	40	6	6.666666666666667	749
FBgn0264268	754	750	742	16	5	3.2	738
FBgn0264270	755	750	749	11	5	2.2	744
FBgn0264271	765	750	755	25	8	3.125	740
FBgn0264272	760	750	730	40	5	8	720
FBgn0264273	760	750	678	92	13	7.076923076923077	668
FBgn0264291	751	750	743	9	3	3	742
FBgn0264294	755	750	743	17	7	2.4285714285714284	738
FBgn0264296	762	722	701	101	12	8.416666666666666	661
FBgn0264307	763	750	719	57	6	9.5	706
FBgn0264308	774	750	768	30	6	5	744
FBgn0264325	757	750	711	53	7	7.571428571428571	704
FBgn0264326	772	750	727	67	13	5.153846153846154	705
FBgn0264327	751	750	744	8	2	4	743
FBgn0264337	774	750	768	30	5	6	744
FBgn0264338	761	750	747	25	7	3.5714285714285716	736
FBgn0264339	774	750	750	48	11	4.363636363636363	726
FBgn0264341	777	750	760	44	7	6.285714285714286	733
FBgn0264343	753	750	730	26	3	8.666666666666666	727
FBgn0264345	822	750	798	96	10	9.6	726
FBgn0264346	761	750	733	39	5	7.8	722
FBgn0264347	863	750	842	134	15	8.933333333333334	729
FBgn0264349	750	750	744	6	2	3	744
FBgn0264350	755	750	755	5	1	5	750
FBgn0264351	784	750	758	60	10	6	724
FBgn0264352	758	750	729	37	7	5.285714285714286	721
FBgn0264353	760	750	743	27	5	5.4	733
FBgn0264357	726	699	686	67	4	16.75	659
FBgn0264359	761	750	750	22	5	4.4	739
FBgn0264360	750	750	746	4	1	4	746
FBgn0264361	776	750	767	35	7	5	741
FBgn0264365	794	750	776	62	7	8.857142857142858	732
FBgn0264366	759	750	738	30	8	3.75	729
FBgn0264367	760	750	755	15	3	5	745
FBgn0264368	819	750	802	86	11	7.818181818181818	733
FBgn0264369	777	750	734	70	9	7.777777777777778	707
FBgn0264370	793	750	769	67	11	6.090909090909091	726
FBgn0264371	751	750	740	12	3	4	739
FBgn0264372	762	750	750	24	6	4	738
FBgn0264374	772	750	756	38	6	6.333333333333333	734
FBgn0264377	751	750	735	17	3	5.666666666666667	734
FBgn0264378	791	750	755	77	9	8.555555555555555	714
FBgn0264379	752	750	668	86	6	14.333333333333334	666
FBgn0264380	790	750	769	61	7	8.714285714285714	729
FBgn0264381	753	750	740	16	7	2.2857142857142856	737
FBgn0264382	752	750	660	94	11	8.545454545454545	658
FBgn0264384	757	750	732	32	5	6.4	725
FBgn0264385	815	750	782	98	13	7.538461538461538	717
FBgn0264386	758	750	758	8	2	4	750
FBgn0264389	795	750	779	61	11	5.545454545454546	734
FBgn0264391	751	750	510	242	3	80.66666666666667	509
FBgn0264392	757	750	740	24	8	3	733
FBgn0264394	776	750	660	142	10	14.2	634
FBgn0264428	789	750	783	45	4	11.25	744
FBgn0264429	765	750	754	26	7	3.7142857142857144	739
FBgn0264430	752	750	742	12	4	3	740
FBgn0264433	761	750	726	46	8	5.75	715
FBgn0264434	778	750	689	117	8	14.625	661
FBgn0264435	757	750	742	22	8	2.75	735
FBgn0264436	733	729	723	14	7	2	719
FBgn0264438	768	750	745	41	8	5.125	727
FBgn0264439	771	750	750	42	8	5.25	729
FBgn0264440	785	750	783	37	8	4.625	748
FBgn0264441	800	750	738	112	12	9.333333333333334	688
FBgn0264442	759	750	735	33	7	4.714285714285714	726
FBgn0264445	813	750	809	67	9	7.444444444444445	746
FBgn0264446	750	750	709	41	2	20.5	709
FBgn0264447	754	750	734	24	6	4	730
FBgn0264448	750	750	736	14	1	14	736
FBgn0264460	803	750	786	70	7	10	733
FBgn0264467	752	750	694	60	8	7.5	692
FBgn0264468	750	750	741	9	1	9	741
FBgn0264469	779	750	779	29	1	29	750
FBgn0264470	774	750	761	37	9	4.111111111111111	737
FBgn0264472	763	750	720	56	10	5.6	707
FBgn0264474	774	750	764	34	6	5.666666666666667	740
FBgn0264475	782	750	697	117	13	9	665
FBgn0264477	750	750	745	5	2	2.5	745
FBgn0264478	752	750	748	6	4	1.5	746
FBgn0264479	580	538	574	48	4	12	532
FBgn0264480	794	750	780	58	13	4.461538461538462	736
FBgn0264481	764	750	761	17	5	3.4	747
FBgn0264483	750	750	744	6	1	6	744
FBgn0264484	762	750	757	17	4	4.25	745
FBgn0264485	763	750	734	42	7	6	721
FBgn0264486	604	602	593	13	5	2.6	591
FBgn0264489	751	750	723	29	3	9.666666666666666	722
FBgn0264490	750	750	730	20	6	3.3333333333333335	730
FBgn0264491	751	750	749	3	2	1.5	748
FBgn0264493	778	750	762	44	9	4.888888888888889	734
FBgn0264494	751	750	743	9	4	2.25	742
FBgn0264495	795	750	775	65	13	5	730
FBgn0264496	759	750	744	24	7	3.4285714285714284	735
FBgn0264500	754	750	731	27	8	3.375	727
FBgn0264502	798	750	773	73	14	5.214285714285714	725
FBgn0264503	776	750	706	96	14	6.857142857142857	680
FBgn0264504	750	750	747	3	2	1.5	747
FBgn0264505	754	750	722	36	7	5.142857142857143	718
FBgn0264506	775	750	748	52	4	13	723
FBgn0264508	759	750	759	9	2	4.5	750
FBgn0264509	781	750	739	73	12	6.083333333333333	708
FBgn0264510	757	750	748	16	7	2.2857142857142856	741
FBgn0264512	561	538	556	28	6	4.666666666666667	533
FBgn0264514	805	750	796	64	8	8	741
FBgn0264515	759	750	751	17	5	3.4	742
FBgn0264516	756	750	727	35	7	5	721
FBgn0264518	795	750	760	80	7	11.428571428571429	715
FBgn0264539	777	750	770	34	4	8.5	743
FBgn0264540	804	750	719	139	14	9.928571428571429	665
FBgn0264542	775	750	768	32	7	4.571428571428571	743
FBgn0264543	750	750	746	4	2	2	746
FBgn0264546	755	750	746	14	9	1.5555555555555556	741
FBgn0264547	755	750	717	43	7	6.142857142857143	712
FBgn0264550	750	750	690	60	7	8.571428571428571	690
FBgn0264551	765	750	750	30	6	5	735
FBgn0264552	750	750	678	72	7	10.285714285714286	678
FBgn0264554	757	750	734	30	4	7.5	727
FBgn0264560	750	750	748	2	1	2	748
FBgn0264561	795	750	795	45	4	11.25	750
FBgn0264562	542	528	528	28	6	4.666666666666667	514
FBgn0264563	751	750	733	19	6	3.1666666666666665	732
FBgn0264566	759	750	753	15	8	1.875	744
FBgn0264567	769	750	762	26	3	8.666666666666666	743
FBgn0264573	780	750	681	129	8	16.125	651
FBgn0264574	752	750	720	34	6	5.666666666666667	718
FBgn0264598	768	750	756	30	8	3.75	738
FBgn0264599	750	750	744	6	2	3	744
FBgn0264600	849	750	841	107	11	9.727272727272727	742
FBgn0264601	751	750	718	34	6	5.666666666666667	717
FBgn0264602	827	750	802	102	9	11.333333333333334	725
FBgn0264604	541	539	450	93	4	23.25	448
FBgn0264606	760	750	730	40	4	10	720
FBgn0264607	760	750	475	295	9	32.77777777777778	465
FBgn0264616	813	750	404	472	12	39.333333333333336	341
FBgn0264617	750	750	702	48	3	16	702
FBgn0264674	750	750	744	6	2	3	744
FBgn0264676	775	750	749	51	8	6.375	724
FBgn0264677	754	750	707	51	7	7.285714285714286	703
FBgn0264679	774	750	740	58	9	6.444444444444445	716
FBgn0264691	516	503	490	39	7	5.571428571428571	477
FBgn0264694	750	750	740	10	5	2	740
FBgn0264695	752	750	735	19	5	3.8	733
FBgn0264696	755	750	753	7	3	2.3333333333333335	748
FBgn0264697	792	750	790	44	4	11	748
FBgn0264700	753	750	717	39	5	7.8	714
FBgn0264702	827	750	821	83	10	8.3	744
FBgn0264703	750	750	191	559	3	186.33333333333334	191
FBgn0264705	777	750	745	59	9	6.555555555555555	718
FBgn0264707	802	750	749	105	11	9.545454545454545	697
FBgn0264708	750	750	720	30	1	30	720
FBgn0264709	782	750	770	44	5	8.8	738
FBgn0264710	750	750	750	0	0	NA	750
FBgn0264712	793	750	788	48	8	6	745
FBgn0264713	720	685	702	53	10	5.3	667
FBgn0264714	774	750	754	44	8	5.5	730
FBgn0264715	751	750	730	22	6	3.6666666666666665	729
FBgn0264716	817	750	809	75	8	9.375	742
FBgn0264719	750	750	597	153	7	21.857142857142858	597
FBgn0264720	780	750	665	145	11	13.181818181818182	635
FBgn0264721	757	750	757	7	3	2.3333333333333335	750
FBgn0264722	766	750	761	21	6	3.5	745
FBgn0264724	752	750	619	135	3	45	617
FBgn0264725	750	750	703	47	5	9.4	703
FBgn0264726	806	750	788	74	6	12.333333333333334	732
FBgn0264738	774	750	755	43	7	6.142857142857143	731
FBgn0264751	761	750	755	17	7	2.4285714285714284	744
FBgn0264753	752	750	740	14	2	7	738
FBgn0264775	751	750	672	80	7	11.428571428571429	671
FBgn0264785	775	750	760	40	4	10	735
FBgn0264786	775	750	710	90	3	30	685
FBgn0264787	762	750	693	81	9	9	681
FBgn0264788	750	750	692	58	2	29	692
FBgn0264789	797	750	788	56	8	7	741
FBgn0264790	780	750	775	35	7	5	745
FBgn0264791	755	750	755	5	2	2.5	750
FBgn0264792	750	750	717	33	6	5.5	717
FBgn0264793	759	750	714	54	12	4.5	705
FBgn0264794	730	729	726	5	3	1.6666666666666667	725
FBgn0264810	775	750	762	38	6	6.333333333333333	737
FBgn0264815	754	750	718	40	5	8	714
FBgn0264816	778	750	752	54	10	5.4	724
FBgn0264818	770	750	720	70	7	10	700
FBgn0264819	750	750	679	71	4	17.75	679
FBgn0264821	759	750	724	44	3	14.666666666666666	715
FBgn0264824	756	750	753	9	2	4.5	747
FBgn0264825	752	750	709	45	3	15	707
FBgn0264828	753	750	749	7	3	2.3333333333333335	746
FBgn0264832	778	750	770	36	6	6	742
FBgn0264837	527	520	510	24	6	4	503
FBgn0264838	750	750	746	4	2	2	746
FBgn0264839	770	750	768	22	6	3.6666666666666665	748
FBgn0264840	761	750	746	26	6	4.333333333333333	735
FBgn0264841	755	750	743	17	5	3.4	738
FBgn0264844	763	750	732	44	8	5.5	719
FBgn0264845	719	710	121	607	3	202.33333333333334	112
FBgn0264848	754	750	750	8	6	1.3333333333333333	746
FBgn0264857	750	750	744	6	1	6	744
FBgn0264863	713	705	568	153	9	17	560
FBgn0264864	761	750	755	17	5	3.4	744
FBgn0264865	786	750	771	51	11	4.636363636363637	735
FBgn0264866	801	750	797	55	10	5.5	746
FBgn0264867	759	750	755	13	7	1.8571428571428572	746
FBgn0264868	759	750	757	11	2	5.5	748
FBgn0264869	756	750	748	14	3	4.666666666666667	742
FBgn0264870	785	750	778	42	7	6	743
FBgn0264871	751	750	706	46	4	11.5	705
FBgn0264872	761	750	747	25	6	4.166666666666667	736
FBgn0264873	772	750	755	39	6	6.5	733
FBgn0264874	750	750	729	21	3	7	729
FBgn0264875	662	649	614	61	4	15.25	601
FBgn0264876	766	750	759	23	8	2.875	743
FBgn0264877	764	750	718	60	7	8.571428571428571	704
FBgn0264878	836	750	814	108	7	15.428571428571429	728
FBgn0264880	763	750	762	14	4	3.5	749
FBgn0264883	795	750	778	62	5	12.4	733
FBgn0264884	750	750	744	6	5	1.2	744
FBgn0264885	750	750	645	105	11	9.545454545454545	645
FBgn0264886	754	750	627	131	9	14.555555555555555	623
FBgn0264887	785	750	711	109	15	7.266666666666667	676
FBgn0264888	774	750	759	39	3	13	735
FBgn0264889	780	750	769	41	5	8.2	739
FBgn0264890	763	750	731	45	8	5.625	718
FBgn0264891	790	750	767	63	7	9	727
FBgn0264892	750	750	744	6	3	2	744
FBgn0264893	752	750	723	31	7	4.428571428571429	721
FBgn0264894	758	750	742	24	6	4	734
FBgn0264896	761	750	744	28	3	9.333333333333334	733
FBgn0264898	756	750	746	16	6	2.6666666666666665	740
FBgn0264899	822	750	816	78	5	15.6	744
FBgn0264902	751	750	730	22	6	3.6666666666666665	729
FBgn0264903	768	750	726	60	12	5	708
FBgn0264905	750	750	749	1	1	1	749
FBgn0264907	832	750	815	99	11	9	733
FBgn0264912	772	750	721	73	6	12.166666666666666	699
FBgn0264915	750	750	740	10	2	5	740
FBgn0264916	789	750	765	63	6	10.5	726
FBgn0264922	798	750	753	93	15	6.2	705
FBgn0264939	750	750	750	0	0	NA	750
FBgn0264940	764	750	758	20	8	2.5	744
FBgn0264941	750	750	725	25	4	6.25	725
FBgn0264942	782	750	688	126	11	11.454545454545455	656
FBgn0264943	763	750	740	36	6	6	727
FBgn0264944	781	750	778	34	8	4.25	747
FBgn0264945	787	750	771	53	8	6.625	734
FBgn0264946	761	750	732	40	5	8	721
FBgn0264947	750	750	743	7	3	2.3333333333333335	743
FBgn0264950	776	750	776	26	2	13	750
FBgn0264952	750	750	744	6	1	6	744
FBgn0264953	769	750	713	75	7	10.714285714285714	694
FBgn0264955	793	750	756	80	9	8.88888888888889	713
FBgn0264956	802	750	679	175	8	21.875	627
FBgn0264959	759	750	497	271	11	24.636363636363637	488
FBgn0264960	831	750	777	135	17	7.9411764705882355	696
FBgn0264961	807	750	637	227	14	16.214285714285715	580
FBgn0264962	789	750	777	51	11	4.636363636363637	738
FBgn0264975	763	750	725	51	8	6.375	712
FBgn0264978	810	750	805	65	7	9.285714285714286	745
FBgn0264979	756	750	715	47	8	5.875	709
FBgn0264985	755	750	737	23	8	2.875	732
FBgn0264986	750	750	747	3	1	3	747
FBgn0264988	771	750	755	37	10	3.7	734
FBgn0264993	752	750	721	33	5	6.6	719
FBgn0264994	762	750	746	28	7	4	734
FBgn0264995	750	750	712	38	7	5.428571428571429	712
FBgn0264996	750	750	750	0	0	NA	750
FBgn0264997	761	750	761	11	2	5.5	750
FBgn0264998	778	750	745	61	7	8.714285714285714	717
FBgn0264999	756	750	719	43	8	5.375	713
FBgn0265002	760	750	730	40	10	4	720
FBgn0265003	762	750	482	292	7	41.714285714285715	470
FBgn0265017	750	750	643	107	3	35.666666666666664	643
FBgn0265039	781	750	759	53	7	7.571428571428571	728
FBgn0265042	762	750	748	26	9	2.888888888888889	736
FBgn0265043	750	750	750	0	0	NA	750
FBgn0265044	754	750	643	115	16	7.1875	639
FBgn0265048	528	514	521	21	4	5.25	507
FBgn0265050	751	750	742	10	3	3.3333333333333335	741
FBgn0265051	767	750	732	52	8	6.5	715
FBgn0265052	536	532	524	16	7	2.2857142857142856	520
FBgn0265053	762	750	758	16	5	3.2	746
FBgn0265058	782	750	778	36	7	5.142857142857143	746
FBgn0265059	762	750	630	144	5	28.8	618
FBgn0265061	752	750	504	250	11	22.727272727272727	502
FBgn0265062	761	750	751	21	6	3.5	740
FBgn0265063	777	750	751	53	9	5.888888888888889	724
FBgn0265064	753	750	724	32	6	5.333333333333333	721
FBgn0265067	750	750	743	7	2	3.5	743
FBgn0265070	751	750	641	111	4	27.75	640
FBgn0265071	759	750	732	36	4	9	723
FBgn0265072	755	750	740	20	8	2.5	735
FBgn0265076	766	750	742	40	6	6.666666666666667	726
FBgn0265078	774	750	770	28	8	3.5	746
FBgn0265079	773	750	771	25	4	6.25	748
FBgn0265080	752	750	740	14	7	2	738
FBgn0265081	774	750	766	32	5	6.4	742
FBgn0265082	659	625	360	333	8	41.625	326
FBgn0265085	754	750	732	26	6	4.333333333333333	728
FBgn0265086	760	750	704	66	7	9.428571428571429	694
FBgn0265087	759	750	735	33	6	5.5	726
FBgn0265088	825	750	799	101	14	7.214285714285714	724
FBgn0265089	753	750	739	17	4	4.25	736
FBgn0265095	591	590	591	1	1	1	590
FBgn0265097	759	750	744	24	8	3	735
FBgn0265098	751	750	718	34	8	4.25	717
FBgn0265099	754	750	712	46	9	5.111111111111111	708
FBgn0265101	754	750	708	50	6	8.333333333333334	704
FBgn0265102	752	750	734	20	8	2.5	732
FBgn0265103	776	750	769	33	7	4.714285714285714	743
FBgn0265104	750	750	740	10	2	5	740
FBgn0265105	753	750	753	3	2	1.5	750
FBgn0265106	766	750	745	37	5	7.4	729
FBgn0265107	790	750	784	46	6	7.666666666666667	744
FBgn0265137	783	750	731	85	10	8.5	698
FBgn0265139	750	750	719	31	4	7.75	719
FBgn0265142	756	750	734	28	3	9.333333333333334	728
FBgn0265143	756	750	756	6	1	6	750
FBgn0265145	774	750	768	30	8	3.75	744
FBgn0265147	764	750	746	32	4	8	732
FBgn0265148	755	750	529	231	6	38.5	524
FBgn0265149	752	750	747	7	3	2.3333333333333335	745
FBgn0265150	751	750	615	137	5	27.4	614
FBgn0265151	751	750	285	467	2	233.5	284
FBgn0265152	753	750	749	7	3	2.3333333333333335	746
FBgn0265153	784	750	783	35	7	5	749
FBgn0265155	812	750	786	88	10	8.8	724
FBgn0265156	771	750	766	26	6	4.333333333333333	745
FBgn0265157	758	750	719	47	8	5.875	711
FBgn0265160	777	750	776	28	3	9.333333333333334	749
FBgn0265161	762	750	725	49	9	5.444444444444445	713
FBgn0265162	791	750	757	75	13	5.769230769230769	716
FBgn0265163	758	750	710	56	4	14	702
FBgn0265165	753	750	733	23	4	5.75	730
FBgn0265166	750	750	694	56	3	18.666666666666668	694
FBgn0265167	751	750	677	75	5	15	676
FBgn0265169	750	750	729	21	5	4.2	729
FBgn0265174	750	750	749	1	1	1	749
FBgn0265177	759	750	756	12	3	4	747
FBgn0265182	789	750	780	48	7	6.857142857142857	741
FBgn0265187	754	750	733	25	7	3.5714285714285716	729
FBgn0265192	750	750	733	17	6	2.8333333333333335	733
FBgn0265193	766	750	752	30	5	6	736
FBgn0265196	754	750	737	21	5	4.2	733
FBgn0265197	753	750	729	27	4	6.75	726
FBgn0265198	771	750	730	62	8	7.75	709
FBgn0265200	755	750	753	7	3	2.3333333333333335	748
FBgn0265202	758	750	750	16	3	5.333333333333333	742
FBgn0265203	763	750	729	47	10	4.7	716
FBgn0265204	767	750	761	23	8	2.875	744
FBgn0265205	752	750	683	71	4	17.75	681
FBgn0265253	780	750	760	50	9	5.555555555555555	730
FBgn0265255	757	750	750	14	4	3.5	743
FBgn0265256	750	750	735	15	7	2.142857142857143	735
FBgn0265257	752	750	726	28	8	3.5	724
FBgn0265262	784	750	784	34	6	5.666666666666667	750
FBgn0265264	664	664	545	119	12	9.916666666666666	545
FBgn0265265	752	750	656	98	7	14	654
FBgn0265266	759	750	749	19	6	3.1666666666666665	740
FBgn0265267	752	750	738	16	4	4	736
FBgn0265268	799	750	758	90	11	8.181818181818182	709
FBgn0265269	776	750	756	46	5	9.2	730
FBgn0265270	753	750	722	34	10	3.4	719
FBgn0265271	759	750	710	58	6	9.666666666666666	701
FBgn0265274	754	750	727	31	4	7.75	723
FBgn0265276	768	750	746	40	5	8	728
FBgn0265295	751	750	741	11	5	2.2	740
FBgn0265296	773	750	736	60	5	12	713
FBgn0265297	764	750	755	23	6	3.8333333333333335	741
FBgn0265298	750	750	746	4	2	2	746
FBgn0265299	767	750	751	33	9	3.6666666666666665	734
FBgn0265301	815	750	791	89	8	11.125	726
FBgn0265302	750	750	734	16	5	3.2	734
FBgn0265304	758	750	747	19	7	2.7142857142857144	739
FBgn0265305	783	750	776	40	7	5.714285714285714	743
FBgn0265306	838	750	811	115	11	10.454545454545455	723
FBgn0265308	768	750	733	53	9	5.888888888888889	715
FBgn0265309	804	750	798	60	10	6	744
FBgn0265310	782	750	782	32	3	10.666666666666666	750
FBgn0265311	757	750	675	89	8	11.125	668
FBgn0265312	763	750	754	22	5	4.4	741
FBgn0265314	750	750	748	2	1	2	748
FBgn0265315	758	750	720	46	8	5.75	712
FBgn0265316	782	750	777	37	10	3.7	745
FBgn0265317	763	750	735	41	8	5.125	722
FBgn0265318	766	750	759	23	6	3.8333333333333335	743
FBgn0265338	760	750	752	18	4	4.5	742
FBgn0265339	762	750	732	42	5	8.4	720
FBgn0265340	750	750	750	0	0	NA	750
FBgn0265341	750	750	727	23	3	7.666666666666667	727
FBgn0265345	753	750	753	3	2	1.5	750
FBgn0265348	781	750	727	85	19	4.473684210526316	696
FBgn0265349	774	750	725	73	11	6.636363636363637	701
FBgn0265351	610	562	566	92	9	10.222222222222221	518
FBgn0265356	764	750	758	20	3	6.666666666666667	744
FBgn0265363	761	750	759	13	2	6.5	748
FBgn0265364	757	750	732	32	7	4.571428571428571	725
FBgn0265365	771	750	737	55	11	5	716
FBgn0265366	752	750	495	259	3	86.33333333333333	493
FBgn0265367	750	750	710	40	5	8	710
FBgn0265368	767	750	737	47	5	9.4	720
FBgn0265369	766	750	740	42	8	5.25	724
FBgn0265371	838	750	830	96	12	8	742
FBgn0265372	781	750	754	58	9	6.444444444444445	723
FBgn0265373	775	750	736	64	15	4.266666666666667	711
FBgn0265375	758	750	751	15	4	3.75	743
FBgn0265376	813	750	720	156	16	9.75	657
FBgn0265379	755	750	749	11	3	3.6666666666666665	744
FBgn0265380	796	750	781	61	10	6.1	735
FBgn0265381	755	750	734	26	5	5.2	729
FBgn0265382	768	750	744	42	6	7	726
FBgn0265414	803	750	776	80	9	8.88888888888889	723
FBgn0265419	756	750	726	36	6	6	720
FBgn0265422	750	750	697	53	4	13.25	697
FBgn0265423	767	750	705	79	6	13.166666666666666	688
FBgn0265425	756	750	739	23	5	4.6	733
FBgn0265427	817	750	803	81	5	16.2	736
FBgn0265428	764	750	755	23	7	3.2857142857142856	741
FBgn0265443	818	750	630	256	13	19.692307692307693	562
FBgn0265444	751	750	723	29	6	4.833333333333333	722
FBgn0265445	761	750	708	64	11	5.818181818181818	697
FBgn0265446	783	750	752	64	11	5.818181818181818	719
FBgn0265448	785	750	775	45	10	4.5	740
FBgn0265449	768	750	692	94	8	11.75	674
FBgn0265451	750	750	750	0	0	NA	750
FBgn0265454	760	750	695	75	8	9.375	685
FBgn0265455	777	750	752	52	9	5.777777777777778	725
FBgn0265458	750	750	739	11	2	5.5	739
FBgn0265464	759	750	750	18	6	3	741
FBgn0265468	764	750	744	34	13	2.6153846153846154	730
FBgn0265469	793	750	739	97	8	12.125	696
FBgn0265470	762	750	705	69	6	11.5	693
FBgn0265487	752	750	746	8	2	4	744
FBgn0265496	811	750	796	76	10	7.6	735
FBgn0265498	759	750	710	58	7	8.285714285714286	701
FBgn0265499	752	750	735	19	4	4.75	733
FBgn0265500	750	750	749	1	1	1	749
FBgn0265508	768	750	766	20	5	4	748
FBgn0265509	750	750	740	10	5	2	740
FBgn0265510	778	750	771	35	8	4.375	743
FBgn0265511	787	750	775	49	10	4.9	738
FBgn0265523	781	750	734	78	16	4.875	703
FBgn0265524	786	750	749	73	10	7.3	713
FBgn0265525	772	750	732	62	12	5.166666666666667	710
FBgn0265526	755	750	736	24	6	4	731
FBgn0265527	788	750	785	41	7	5.857142857142857	747
FBgn0265529	753	750	740	16	6	2.6666666666666665	737
FBgn0265530	779	750	734	74	10	7.4	705
FBgn0265531	761	750	757	15	5	3	746
FBgn0265532	762	750	746	28	4	7	734
FBgn0265534	779	750	696	112	9	12.444444444444445	667
FBgn0265537	750	750	732	18	3	6	732
FBgn0265538	755	750	118	642	2	321	113
FBgn0265539	765	750	739	41	5	8.2	724
FBgn0265540	777	750	775	29	6	4.833333333333333	748
FBgn0265543	752	750	670	84	4	21	668
FBgn0265544	788	750	672	154	11	14	634
FBgn0265545	770	750	760	30	13	2.3076923076923075	740
FBgn0265549	753	750	718	38	9	4.222222222222222	715
FBgn0265550	755	750	755	5	2	2.5	750
FBgn0265551	787	750	778	46	7	6.571428571428571	741
FBgn0265574	750	750	739	11	3	3.6666666666666665	739
FBgn0265575	772	750	732	62	11	5.636363636363637	710
FBgn0265577	574	561	497	90	9	10	484
FBgn0265578	756	750	746	16	5	3.2	740
FBgn0265579	764	750	748	30	6	5	734
FBgn0265580	762	750	739	35	4	8.75	727
FBgn0265582	780	750	671	139	7	19.857142857142858	641
FBgn0265583	752	750	736	18	4	4.5	734
FBgn0265584	752	750	714	40	7	5.714285714285714	712
FBgn0265585	759	750	712	56	5	11.2	703
FBgn0265588	769	750	766	22	6	3.6666666666666665	747
FBgn0265589	750	750	747	3	1	3	747
FBgn0265590	750	750	732	18	4	4.5	732
FBgn0265591	766	750	758	24	3	8	742
FBgn0265592	772	750	750	44	11	4	728
FBgn0265593	752	750	689	65	6	10.833333333333334	687
FBgn0265594	761	750	745	27	5	5.4	734
FBgn0265595	765	750	688	92	7	13.142857142857142	673
FBgn0265596	792	750	753	81	14	5.785714285714286	711
FBgn0265597	763	750	712	64	6	10.666666666666666	699
FBgn0265605	753	750	736	20	7	2.857142857142857	733
FBgn0265606	751	750	746	6	4	1.5	745
FBgn0265608	790	750	787	43	4	10.75	747
FBgn0265609	672	667	606	71	6	11.833333333333334	601
FBgn0265611	839	750	817	111	13	8.538461538461538	728
FBgn0265612	761	750	741	31	7	4.428571428571429	730
FBgn0265613	830	750	739	171	13	13.153846153846153	659
FBgn0265614	777	750	740	64	8	8	713
FBgn0265623	765	750	762	18	3	6	747
FBgn0265625	767	750	749	35	7	5	732
FBgn0265630	759	750	745	23	5	4.6	736
FBgn0265631	767	750	753	31	9	3.4444444444444446	736
FBgn0265632	767	750	752	32	6	5.333333333333333	735
FBgn0265635	762	750	753	21	5	4.2	741
FBgn0265636	773	750	770	26	5	5.2	747
FBgn0265637	762	750	645	129	5	25.8	633
FBgn0265638	762	750	695	79	6	13.166666666666666	683
FBgn0265639	780	750	729	81	9	9	699
FBgn0265640	759	750	676	92	8	11.5	667
FBgn0265641	784	750	761	57	11	5.181818181818182	727
FBgn0265642	758	750	732	34	11	3.090909090909091	724
FBgn0265643	757	750	749	15	5	3	742
FBgn0265645	754	750	717	41	11	3.727272727272727	713
FBgn0265646	752	750	745	9	5	1.8	743
FBgn0265648	587	586	576	12	4	3	575
FBgn0265649	756	750	729	33	4	8.25	723
FBgn0265651	766	750	704	78	7	11.142857142857142	688
FBgn0265657	772	750	721	73	7	10.428571428571429	699
FBgn0265658	762	750	751	23	5	4.6	739
FBgn0265660	753	750	735	21	6	3.5	732
FBgn0265661	762	750	744	30	11	2.727272727272727	732
FBgn0265662	777	750	760	44	9	4.888888888888889	733
FBgn0265663	750	750	684	66	8	8.25	684
FBgn0265664	783	750	673	143	15	9.533333333333333	640
FBgn0265665	757	750	750	14	5	2.8	743
FBgn0265666	782	750	779	35	3	11.666666666666666	747
FBgn0265670	759	750	745	23	4	5.75	736
FBgn0265671	760	750	734	36	6	6	724
FBgn0265672	776	750	768	34	6	5.666666666666667	742
FBgn0265673	756	750	741	21	4	5.25	735
FBgn0265674	769	750	749	39	7	5.571428571428571	730
FBgn0265675	750	750	714	36	5	7.2	714
FBgn0265676	755	750	399	361	7	51.57142857142857	394
FBgn0265678	750	750	732	18	2	9	732
FBgn0265679	751	750	743	9	3	3	742
FBgn0265680	772	750	758	36	5	7.2	736
FBgn0265682	785	750	727	93	6	15.5	692
FBgn0265683	755	750	703	57	13	4.384615384615385	698
FBgn0265684	800	750	770	80	9	8.88888888888889	720
FBgn0265687	754	750	631	127	8	15.875	627
FBgn0265688	765	750	710	70	8	8.75	695
FBgn0265690	750	750	735	15	4	3.75	735
FBgn0265691	766	750	729	53	6	8.833333333333334	713
FBgn0265692	750	750	743	7	2	3.5	743
FBgn0265693	751	750	689	63	4	15.75	688
FBgn0265694	751	750	745	7	2	3.5	744
FBgn0265695	755	750	681	79	4	19.75	676
FBgn0265696	751	750	663	89	3	29.666666666666668	662
FBgn0265697	803	750	740	116	9	12.88888888888889	687
FBgn0265699	750	750	750	0	0	NA	750
FBgn0265700	828	750	806	100	12	8.333333333333334	728
FBgn0265701	783	750	682	134	12	11.166666666666666	649
FBgn0265702	764	750	750	28	10	2.8	736
FBgn0265704	780	750	763	47	6	7.833333333333333	733
FBgn0265705	769	750	729	59	9	6.555555555555555	710
FBgn0265706	776	750	763	39	7	5.571428571428571	737
FBgn0265707	773	750	771	25	6	4.166666666666667	748
FBgn0265708	765	750	752	28	9	3.111111111111111	737
FBgn0265710	815	750	772	108	10	10.8	707
FBgn0265712	764	750	740	38	8	4.75	726
FBgn0265713	760	750	685	85	5	17	675
FBgn0265715	773	750	741	55	11	5	718
FBgn0265716	751	750	741	11	5	2.2	740
FBgn0265718	755	750	727	33	8	4.125	722
FBgn0265719	778	750	707	99	11	9	679
FBgn0265720	765	750	747	33	7	4.714285714285714	732
FBgn0265721	756	750	731	31	5	6.2	725
FBgn0265722	761	750	746	26	7	3.7142857142857144	735
FBgn0265723	754	750	729	29	3	9.666666666666666	725
FBgn0265724	752	750	652	102	3	34	650
FBgn0265725	759	750	755	13	2	6.5	746
FBgn0265726	804	750	743	115	11	10.454545454545455	689
FBgn0265728	765	750	753	27	5	5.4	738
FBgn0265729	775	750	770	30	3	10	745
FBgn0265730	752	750	701	53	4	13.25	699
FBgn0265731	778	750	750	56	9	6.222222222222222	722
FBgn0265732	807	750	791	73	7	10.428571428571429	734
FBgn0265733	797	750	781	63	12	5.25	734
FBgn0265735	763	750	744	32	8	4	731
FBgn0265736	672	666	546	132	7	18.857142857142858	540
FBgn0265737	790	750	778	52	7	7.428571428571429	738
FBgn0265738	754	750	750	8	3	2.6666666666666665	746
FBgn0265739	750	750	742	8	4	2	742
FBgn0265740	774	750	700	98	8	12.25	676
FBgn0265741	764	750	760	18	2	9	746
FBgn0265742	750	750	748	2	2	1	748
FBgn0265743	806	750	782	80	14	5.714285714285714	726
FBgn0265744	768	750	753	33	6	5.5	735
FBgn0265745	751	750	731	21	4	5.25	730
FBgn0265746	773	750	734	62	8	7.75	711
FBgn0265747	778	750	778	28	5	5.6	750
FBgn0265749	775	750	756	44	7	6.285714285714286	731
FBgn0265751	763	750	745	31	4	7.75	732
FBgn0265752	760	750	747	23	5	4.6	737
FBgn0265753	767	750	722	62	7	8.857142857142858	705
FBgn0265754	773	750	760	36	9	4	737
FBgn0265755	754	750	749	9	5	1.8	745
FBgn0265756	757	750	742	22	4	5.5	735
FBgn0265758	816	750	801	81	9	9	735
FBgn0265759	791	750	777	55	7	7.857142857142857	736
FBgn0265760	757	750	635	129	10	12.9	628
FBgn0265761	785	750	626	194	7	27.714285714285715	591
FBgn0265762	756	750	738	24	6	4	732
FBgn0265763	752	750	740	14	5	2.8	738
FBgn0265764	753	750	741	15	3	5	738
FBgn0265765	758	750	756	10	4	2.5	748
FBgn0265766	750	750	726	24	1	24	726
FBgn0265767	765	750	652	128	9	14.222222222222221	637
FBgn0265778	760	750	728	42	6	7	718
FBgn0265784	764	750	738	40	9	4.444444444444445	724
FBgn0265785	783	750	768	48	6	8	735
FBgn0265786	757	750	728	36	6	6	721
FBgn0265788	757	750	753	11	7	1.5714285714285714	746
FBgn0265789	750	750	725	25	2	12.5	725
FBgn0265790	765	750	755	25	7	3.5714285714285716	740
FBgn0265791	761	750	750	22	6	3.6666666666666665	739
FBgn0265792	800	750	767	83	8	10.375	717
FBgn0265794	770	750	753	37	7	5.285714285714286	733
FBgn0265795	781	750	763	49	11	4.454545454545454	732
FBgn0265796	750	750	722	28	4	7	722
FBgn0265797	762	750	730	44	10	4.4	718
FBgn0265798	786	750	745	77	16	4.8125	709
FBgn0265799	779	750	734	74	17	4.352941176470588	705
FBgn0265800	753	750	753	3	3	1	750
FBgn0265801	760	750	739	31	8	3.875	729
FBgn0265802	755	750	560	200	12	16.666666666666668	555
FBgn0265803	756	750	738	24	5	4.8	732
FBgn0265805	753	750	751	5	4	1.25	748
FBgn0265807	751	750	678	74	6	12.333333333333334	677
FBgn0265808	810	750	781	89	13	6.846153846153846	721
FBgn0265810	595	531	592	67	7	9.571428571428571	528
FBgn0265811	754	750	738	20	6	3.3333333333333335	734
FBgn0265812	755	750	748	12	5	2.4	743
FBgn0265813	759	750	752	16	8	2	743
FBgn0265814	750	750	721	29	5	5.8	721
FBgn0265815	759	750	724	44	5	8.8	715
FBgn0265817	769	750	756	32	7	4.571428571428571	737
FBgn0265818	771	750	744	48	8	6	723
FBgn0265819	517	509	516	9	4	2.25	508
FBgn0265820	773	750	772	24	5	4.8	749
FBgn0265821	751	750	731	21	8	2.625	730
FBgn0265823	794	750	759	79	10	7.9	715
FBgn0265824	750	750	733	17	5	3.4	733
FBgn0265826	760	750	721	49	4	12.25	711
FBgn0265827	753	750	728	28	4	7	725
FBgn0265828	756	750	753	9	3	3	747
FBgn0265829	761	750	753	19	7	2.7142857142857144	742
FBgn0265831	814	750	770	108	14	7.714285714285714	706
FBgn0265832	809	750	784	84	13	6.461538461538462	725
FBgn0265833	765	750	749	31	9	3.4444444444444446	734
FBgn0265834	760	750	700	70	8	8.75	690
FBgn0265837	783	750	778	38	7	5.428571428571429	745
FBgn0265838	751	750	748	4	3	1.3333333333333333	747
FBgn0265839	750	750	696	54	6	9	696
FBgn0265840	801	750	796	56	4	14	745
FBgn0265841	759	750	745	23	3	7.666666666666667	736
FBgn0265842	752	750	653	101	4	25.25	651
FBgn0265843	755	750	711	49	8	6.125	706
FBgn0265844	754	750	740	18	5	3.6	736
FBgn0265845	760	750	759	11	3	3.6666666666666665	749
FBgn0265846	767	750	754	30	8	3.75	737
FBgn0265849	758	750	758	8	2	4	750
FBgn0265850	752	750	746	8	4	2	744
FBgn0265851	765	750	708	72	11	6.545454545454546	693
FBgn0265853	757	750	714	50	11	4.545454545454546	707
FBgn0265854	751	750	588	164	5	32.8	587
FBgn0265855	751	750	745	7	4	1.75	744
FBgn0265857	752	750	664	90	7	12.857142857142858	662
FBgn0265858	607	599	591	24	6	4	583
FBgn0265859	763	750	722	54	8	6.75	709
FBgn0265861	756	750	702	60	5	12	696
FBgn0265862	763	750	714	62	7	8.857142857142858	701
FBgn0265863	766	750	714	68	8	8.5	698
FBgn0265864	762	750	761	13	2	6.5	749
FBgn0265865	773	750	704	92	15	6.133333333333334	681
FBgn0265866	753	750	692	64	8	8	689
FBgn0265869	753	750	659	97	10	9.7	656
FBgn0265870	770	750	763	27	5	5.4	743
FBgn0265873	759	750	726	42	7	6	717
FBgn0265874	751	750	691	61	8	7.625	690
FBgn0265875	614	611	517	100	8	12.5	514
FBgn0265876	750	750	732	18	1	18	732
FBgn0265878	755	750	729	31	10	3.1	724
FBgn0265879	757	750	756	8	5	1.6	749
FBgn0265880	782	750	709	105	10	10.5	677
FBgn0265882	753	750	715	41	6	6.833333333333333	712
FBgn0265883	754	750	694	64	9	7.111111111111111	690
FBgn0265884	750	750	667	83	3	27.666666666666668	667
FBgn0265885	775	750	751	49	8	6.125	726
FBgn0265886	750	750	700	50	2	25	700
FBgn0265887	808	750	795	71	11	6.454545454545454	737
FBgn0265889	799	750	778	70	11	6.363636363636363	729
FBgn0265890	764	750	734	44	7	6.285714285714286	720
FBgn0265891	803	750	782	74	8	9.25	729
FBgn0265892	768	750	742	44	9	4.888888888888889	724
FBgn0265893	691	687	675	20	4	5	671
FBgn0265894	759	750	687	81	8	10.125	678
FBgn0265895	757	750	754	10	3	3.3333333333333335	747
FBgn0265897	779	750	772	36	8	4.5	743
FBgn0265898	763	750	736	40	9	4.444444444444445	723
FBgn0265900	763	750	726	50	3	16.666666666666668	713
FBgn0265901	754	750	748	10	6	1.6666666666666667	744
FBgn0265902	768	750	763	23	5	4.6	745
FBgn0265903	757	750	747	17	5	3.4	740
FBgn0265904	772	750	767	27	7	3.857142857142857	745
FBgn0265905	754	750	710	48	3	16	706
FBgn0265908	768	750	760	26	7	3.7142857142857144	742
FBgn0265911	763	750	757	19	5	3.8	744
FBgn0265912	776	750	735	67	12	5.583333333333333	709
FBgn0265913	751	750	735	17	6	2.8333333333333335	734
FBgn0265914	773	750	739	57	10	5.7	716
FBgn0265915	765	750	707	73	4	18.25	692
FBgn0265916	758	750	743	23	3	7.666666666666667	735
FBgn0265917	764	750	741	37	5	7.4	727
FBgn0265918	773	750	701	95	8	11.875	678
FBgn0265919	753	750	671	85	10	8.5	668
FBgn0265921	777	750	777	27	2	13.5	750
FBgn0265922	784	750	718	100	12	8.333333333333334	684
FBgn0265924	794	750	759	79	9	8.777777777777779	715
FBgn0265926	764	750	740	38	10	3.8	726
FBgn0265927	800	750	727	123	17	7.235294117647059	677
FBgn0265928	771	750	763	29	6	4.833333333333333	742
FBgn0265930	764	750	724	54	8	6.75	710
FBgn0265931	780	750	755	55	17	3.235294117647059	725
FBgn0265933	779	750	714	94	7	13.428571428571429	685
FBgn0265934	803	750	773	83	12	6.916666666666667	720
FBgn0265937	771	750	762	30	6	5	741
FBgn0265938	781	750	741	71	6	11.833333333333334	710
FBgn0265939	753	750	742	14	7	2	739
FBgn0265942	762	750	753	21	5	4.2	741
FBgn0265943	750	750	741	9	2	4.5	741
FBgn0265944	760	750	759	11	5	2.2	749
FBgn0265945	763	750	758	18	5	3.6	745
FBgn0265946	753	750	736	20	5	4	733
FBgn0265947	536	523	533	16	4	4	520
FBgn0265948	783	750	782	34	5	6.8	749
FBgn0265949	778	750	771	35	3	11.666666666666666	743
FBgn0265950	766	750	760	22	3	7.333333333333333	744
FBgn0265951	778	750	763	43	10	4.3	735
FBgn0265952	772	750	750	44	6	7.333333333333333	728
FBgn0265954	768	750	739	47	7	6.714285714285714	721
FBgn0265955	779	750	763	45	7	6.428571428571429	734
FBgn0265956	759	750	734	34	7	4.857142857142857	725
FBgn0265957	790	750	768	62	12	5.166666666666667	728
FBgn0265958	775	750	766	34	7	4.857142857142857	741
FBgn0265959	754	750	724	34	5	6.8	720
FBgn0265961	763	750	758	18	4	4.5	745
FBgn0265962	524	513	478	57	9	6.333333333333333	467
FBgn0265963	773	750	760	36	7	5.142857142857143	737
FBgn0265964	763	750	753	23	9	2.5555555555555554	740
FBgn0265965	765	750	747	33	5	6.6	732
FBgn0265967	754	750	748	10	4	2.5	744
FBgn0265974	752	750	733	21	5	4.2	731
FBgn0265976	750	750	742	8	2	4	742
FBgn0265977	758	750	752	14	3	4.666666666666667	744
FBgn0265979	750	750	719	31	3	10.333333333333334	719
FBgn0265980	750	750	749	1	1	1	749
FBgn0265981	752	750	709	45	4	11.25	707
FBgn0265982	813	750	782	94	7	13.428571428571429	719
FBgn0265983	750	750	750	0	0	NA	750
FBgn0265986	812	750	780	94	10	9.4	718
FBgn0265991	750	750	711	39	3	13	711
FBgn0265992	759	750	754	14	6	2.3333333333333335	745
FBgn0265993	750	750	747	3	2	1.5	747
FBgn0265994	750	750	734	16	2	8	734
FBgn0265995	769	750	769	19	3	6.333333333333333	750
FBgn0265996	786	750	784	38	5	7.6	748
FBgn0265997	783	750	779	37	5	7.4	746
FBgn0265998	759	750	759	9	1	9	750
FBgn0266000	774	750	759	39	7	5.571428571428571	735
FBgn0266001	753	750	698	58	8	7.25	695
FBgn0266002	766	750	755	27	4	6.75	739
FBgn0266003	770	750	753	37	8	4.625	733
FBgn0266004	770	750	610	180	8	22.5	590
FBgn0266007	853	750	841	115	11	10.454545454545455	738
FBgn0266008	756	750	745	17	6	2.8333333333333335	739
FBgn0266009	778	750	760	46	7	6.571428571428571	732
FBgn0266010	788	750	766	60	10	6	728
FBgn0266011	753	750	749	7	4	1.75	746
FBgn0266019	753	750	711	45	8	5.625	708
FBgn0266020	795	750	595	245	8	30.625	550
FBgn0266021	753	750	730	26	8	3.25	727
FBgn0266022	753	750	705	51	7	7.285714285714286	702
FBgn0266023	751	750	748	4	3	1.3333333333333333	747
FBgn0266024	756	750	744	18	5	3.6	738
FBgn0266025	785	750	745	75	11	6.818181818181818	710
FBgn0266026	752	750	511	243	4	60.75	509
FBgn0266027	758	750	733	33	6	5.5	725
FBgn0266028	750	750	750	0	0	NA	750
FBgn0266029	752	750	681	73	6	12.166666666666666	679
FBgn0266030	764	750	753	25	8	3.125	739
FBgn0266032	778	750	772	34	8	4.25	744
FBgn0266033	750	750	745	5	2	2.5	745
FBgn0266034	773	750	742	54	13	4.153846153846154	719
FBgn0266036	762	750	762	12	1	12	750
FBgn0266037	753	750	753	3	1	3	750
FBgn0266039	776	750	730	72	6	12	704
FBgn0266040	754	750	717	41	10	4.1	713
FBgn0266041	751	750	748	4	3	1.3333333333333333	747
FBgn0266042	752	750	735	19	4	4.75	733
FBgn0266043	799	750	758	90	6	15	709
FBgn0266045	770	750	730	60	10	6	710
FBgn0266046	750	750	745	5	1	5	745
FBgn0266048	752	750	746	8	2	4	744
FBgn0266049	754	750	733	25	8	3.125	729
FBgn0266051	711	702	681	39	9	4.333333333333333	672
FBgn0266053	770	750	734	56	8	7	714
FBgn0266064	755	750	703	57	12	4.75	698
FBgn0266065	817	750	790	94	6	15.666666666666666	723
FBgn0266066	758	750	746	20	5	4	738
FBgn0266067	755	750	748	12	3	4	743
FBgn0266068	754	750	735	23	8	2.875	731
FBgn0266070	807	750	752	112	8	14	695
FBgn0266071	750	750	733	17	1	17	733
FBgn0266072	750	750	734	16	5	3.2	734
FBgn0266073	753	750	714	42	6	7	711
FBgn0266074	768	750	763	23	7	3.2857142857142856	745
FBgn0266084	768	750	741	45	6	7.5	723
FBgn0266086	763	750	696	80	6	13.333333333333334	683
FBgn0266087	750	750	747	3	1	3	747
FBgn0266088	752	750	733	21	3	7	731
FBgn0266094	537	503	454	117	9	13	420
FBgn0266095	750	750	750	0	0	NA	750
FBgn0266096	783	750	779	37	8	4.625	746
FBgn0266097	778	750	737	69	10	6.9	709
FBgn0266099	765	750	755	25	5	5	740
FBgn0266100	783	750	695	121	12	10.083333333333334	662
FBgn0266102	755	750	713	47	9	5.222222222222222	708
FBgn0266111	781	750	754	58	8	7.25	723
FBgn0266115	775	750	760	40	6	6.666666666666667	735
FBgn0266124	750	750	713	37	3	12.333333333333334	713
FBgn0266137	768	750	747	39	6	6.5	729
FBgn0266139	751	750	751	1	1	1	750
FBgn0266141	750	750	744	6	3	2	744
FBgn0266142	758	750	737	29	3	9.666666666666666	729
FBgn0266144	751	750	678	74	4	18.5	677
FBgn0266145	752	750	733	21	6	3.5	731
FBgn0266146	750	750	733	17	2	8.5	733
FBgn0266147	771	750	764	28	5	5.6	743
FBgn0266148	750	750	671	79	3	26.333333333333332	671
FBgn0266149	762	750	753	21	3	7	741
FBgn0266150	753	750	738	18	5	3.6	735
FBgn0266151	752	750	687	67	5	13.4	685
FBgn0266153	784	750	763	55	10	5.5	729
FBgn0266155	753	750	706	50	4	12.5	703
FBgn0266156	762	750	745	29	3	9.666666666666666	733
FBgn0266157	757	750	746	18	3	6	739
FBgn0266158	751	750	735	17	4	4.25	734
FBgn0266159	787	750	721	103	12	8.583333333333334	684
FBgn0266160	775	750	773	27	5	5.4	748
FBgn0266161	758	750	748	18	4	4.5	740
FBgn0266163	758	750	757	9	2	4.5	749
FBgn0266164	754	750	743	15	5	3	739
FBgn0266165	753	750	745	11	5	2.2	742
FBgn0266166	752	750	727	27	10	2.7	725
FBgn0266167	798	750	792	54	6	9	744
FBgn0266169	753	750	697	59	10	5.9	694
FBgn0266179	786	750	777	45	7	6.428571428571429	741
FBgn0266180	817	750	770	114	14	8.142857142857142	703
FBgn0266182	764	750	751	27	6	4.5	737
FBgn0266183	763	750	759	17	6	2.8333333333333335	746
FBgn0266186	751	750	609	143	6	23.833333333333332	608
FBgn0266196	785	722	759	89	8	11.125	696
FBgn0266197	765	750	760	20	4	5	745
FBgn0266198	785	750	761	59	9	6.555555555555555	726
FBgn0266201	750	750	739	11	2	5.5	739
FBgn0266202	750	750	739	11	4	2.75	739
FBgn0266204	763	750	735	41	5	8.2	722
FBgn0266207	762	750	760	14	6	2.3333333333333335	748
FBgn0266208	750	750	748	2	2	1	748
FBgn0266209	762	750	760	14	3	4.666666666666667	748
FBgn0266210	752	750	747	7	3	2.3333333333333335	745
FBgn0266211	725	713	593	144	6	24	581
FBgn0266212	772	750	758	36	8	4.5	736
FBgn0266214	781	750	688	124	11	11.272727272727273	657
FBgn0266215	761	750	760	12	2	6	749
FBgn0266216	755	750	750	10	6	1.6666666666666667	745
FBgn0266217	760	750	746	24	6	4	736
FBgn0266218	799	750	774	74	7	10.571428571428571	725
FBgn0266220	755	750	748	12	6	2	743
FBgn0266221	752	750	726	28	3	9.333333333333334	724
FBgn0266222	751	750	140	612	4	153	139
FBgn0266223	571	562	564	16	4	4	555
FBgn0266225	761	750	721	51	7	7.285714285714286	710
FBgn0266226	762	750	722	52	5	10.4	710
FBgn0266228	605	553	564	93	10	9.3	512
FBgn0266229	752	750	721	33	5	6.6	719
FBgn0266230	763	750	749	27	6	4.5	736
FBgn0266231	752	750	749	5	3	1.6666666666666667	747
FBgn0266232	783	750	716	100	14	7.142857142857143	683
FBgn0266233	752	750	710	44	5	8.8	708
FBgn0266234	761	750	761	11	1	11	750
FBgn0266235	652	643	608	53	5	10.6	599
FBgn0266236	750	750	750	0	0	NA	750
FBgn0266237	751	750	742	10	6	1.6666666666666667	741
FBgn0266238	751	750	740	12	4	3	739
FBgn0266239	839	750	807	121	9	13.444444444444445	718
FBgn0266240	796	750	776	66	8	8.25	730
FBgn0266242	757	750	692	72	9	8	685
FBgn0266243	774	750	753	45	10	4.5	729
FBgn0266244	766	750	761	21	4	5.25	745
FBgn0266245	768	750	735	51	8	6.375	717
FBgn0266246	763	750	713	63	6	10.5	700
FBgn0266247	784	750	780	38	6	6.333333333333333	746
FBgn0266248	757	750	693	71	8	8.875	686
FBgn0266250	757	750	643	121	6	20.166666666666668	636
FBgn0266251	768	750	752	34	8	4.25	734
FBgn0266252	750	750	745	5	3	1.6666666666666667	745
FBgn0266254	750	750	747	3	2	1.5	747
FBgn0266255	773	750	754	42	5	8.4	731
FBgn0266256	750	750	713	37	4	9.25	713
FBgn0266257	758	750	750	16	7	2.2857142857142856	742
FBgn0266259	773	750	769	27	3	9	746
FBgn0266260	781	750	775	37	6	6.166666666666667	744
FBgn0266263	766	750	659	123	14	8.785714285714286	643
FBgn0266264	750	750	743	7	1	7	743
FBgn0266268	777	750	773	31	4	7.75	746
FBgn0266276	770	750	766	24	3	8	746
FBgn0266278	751	750	688	64	8	8	687
FBgn0266279	771	750	692	100	13	7.6923076923076925	671
FBgn0266280	635	614	622	34	5	6.8	601
FBgn0266281	753	750	725	31	3	10.333333333333334	722
FBgn0266282	775	750	716	84	12	7	691
FBgn0266302	754	750	724	34	6	5.666666666666667	720
FBgn0266303	751	750	751	1	1	1	750
FBgn0266305	796	750	789	53	7	7.571428571428571	743
FBgn0266307	751	750	547	205	5	41	546
FBgn0266309	774	750	770	28	8	3.5	746
FBgn0266310	792	750	776	58	6	9.666666666666666	734
FBgn0266311	759	750	755	13	4	3.25	746
FBgn0266312	758	750	722	44	8	5.5	714
FBgn0266313	771	750	727	65	11	5.909090909090909	706
FBgn0266315	769	750	766	22	4	5.5	747
FBgn0266316	751	750	746	6	3	2	745
FBgn0266317	754	750	753	5	3	1.6666666666666667	749
FBgn0266318	784	750	741	77	12	6.416666666666667	707
FBgn0266319	777	750	735	69	10	6.9	708
FBgn0266320	750	750	749	1	1	1	749
FBgn0266321	796	750	763	79	15	5.266666666666667	717
FBgn0266322	791	750	786	46	9	5.111111111111111	745
FBgn0266323	751	750	671	81	10	8.1	670
FBgn0266324	772	750	756	38	4	9.5	734
FBgn0266325	752	750	714	40	6	6.666666666666667	712
FBgn0266326	750	750	746	4	2	2	746
FBgn0266327	771	750	738	54	10	5.4	717
FBgn0266328	774	750	735	63	13	4.846153846153846	711
FBgn0266329	750	750	341	409	2	204.5	341
FBgn0266330	673	636	624	86	17	5.0588235294117645	587
FBgn0266331	779	750	749	59	8	7.375	720
FBgn0266346	757	750	712	52	15	3.466666666666667	705
FBgn0266347	791	750	695	137	14	9.785714285714286	654
FBgn0266348	790	750	770	60	9	6.666666666666667	730
FBgn0266349	768	750	764	22	4	5.5	746
FBgn0266351	740	737	682	61	7	8.714285714285714	679
FBgn0266352	770	750	725	65	9	7.222222222222222	705
FBgn0266354	656	638	408	266	7	38	390
FBgn0266355	772	750	741	53	6	8.833333333333334	719
FBgn0266356	758	750	749	17	5	3.4	741
FBgn0266358	798	750	784	62	13	4.769230769230769	736
FBgn0266359	750	750	744	6	3	2	744
FBgn0266360	753	750	753	3	2	1.5	750
FBgn0266363	750	750	80	670	2	335	80
FBgn0266371	779	750	753	55	5	11	724
FBgn0266372	773	750	768	28	6	4.666666666666667	745
FBgn0266377	750	750	739	11	4	2.75	739
FBgn0266379	756	750	754	8	5	1.6	748
FBgn0266381	772	750	724	70	7	10	702
FBgn0266382	750	750	750	0	0	NA	750
FBgn0266383	753	750	727	29	4	7.25	724
FBgn0266384	751	750	744	8	4	2	743
FBgn0266388	805	750	748	112	9	12.444444444444445	693
FBgn0266389	765	750	730	50	9	5.555555555555555	715
FBgn0266391	760	750	751	19	6	3.1666666666666665	741
FBgn0266392	750	750	715	35	4	8.75	715
FBgn0266395	797	750	797	47	6	7.833333333333333	750
FBgn0266396	765	750	604	176	6	29.333333333333332	589
FBgn0266397	640	640	623	17	5	3.4	623
FBgn0266398	780	750	764	46	6	7.666666666666667	734
FBgn0266399	750	750	701	49	1	49	701
FBgn0266401	751	750	744	8	4	2	743
FBgn0266402	760	750	742	28	3	9.333333333333334	732
FBgn0266403	755	750	722	38	4	9.5	717
FBgn0266404	715	698	707	25	8	3.125	690
FBgn0266408	750	750	690	60	6	10	690
FBgn0266409	794	750	786	52	14	3.7142857142857144	742
FBgn0266410	756	750	732	30	3	10	726
FBgn0266412	750	750	730	20	3	6.666666666666667	730
FBgn0266413	781	750	755	57	6	9.5	724
FBgn0266414	750	750	734	16	4	4	734
FBgn0266415	750	750	750	0	0	NA	750
FBgn0266416	760	750	747	23	5	4.6	737
FBgn0266417	751	750	736	16	5	3.2	735
FBgn0266418	751	750	750	2	2	1	749
FBgn0266419	751	750	729	23	5	4.6	728
FBgn0266420	783	750	777	39	6	6.5	744
FBgn0266421	750	750	569	181	3	60.333333333333336	569
FBgn0266428	750	750	292	458	5	91.6	292
FBgn0266429	771	750	718	74	18	4.111111111111111	697
FBgn0266430	783	750	772	44	9	4.888888888888889	739
FBgn0266431	754	750	728	30	8	3.75	724
FBgn0266433	763	750	750	26	6	4.333333333333333	737
FBgn0266437	769	750	764	24	6	4	745
FBgn0266442	538	537	489	50	6	8.333333333333334	488
FBgn0266443	775	750	725	75	9	8.333333333333334	700
FBgn0266449	764	750	738	40	10	4	724
FBgn0266465	774	750	763	35	9	3.888888888888889	739
FBgn0266518	751	750	748	4	2	2	747
FBgn0266521	785	750	753	67	7	9.571428571428571	718
FBgn0266534	752	750	746	8	4	2	744
FBgn0266535	755	750	741	19	6	3.1666666666666665	736
FBgn0266536	759	750	739	29	6	4.833333333333333	730
FBgn0266537	770	750	718	72	7	10.285714285714286	698
FBgn0266549	751	750	738	14	5	2.8	737
FBgn0266564	766	750	681	101	12	8.416666666666666	665
FBgn0266565	771	750	749	43	10	4.3	728
FBgn0266566	762	750	752	22	4	5.5	740
FBgn0266568	796	750	530	312	14	22.285714285714285	484
FBgn0266573	753	750	699	57	2	28.5	696
FBgn0266574	751	750	751	1	1	1	750
FBgn0266577	771	750	729	63	8	7.875	708
FBgn0266579	764	750	758	20	4	5	744
FBgn0266581	750	750	750	0	0	NA	750
FBgn0266585	783	750	739	77	9	8.555555555555555	706
FBgn0266586	762	750	687	87	14	6.214285714285714	675
FBgn0266587	756	750	721	41	7	5.857142857142857	715
FBgn0266588	760	750	750	20	3	6.666666666666667	740
FBgn0266589	772	750	771	23	4	5.75	749
FBgn0266590	750	750	748	2	2	1	748
FBgn0266591	760	750	760	10	4	2.5	750
FBgn0266593	776	750	759	43	10	4.3	733
FBgn0266594	759	750	719	49	8	6.125	710
FBgn0266595	750	750	739	11	2	5.5	739
FBgn0266598	757	750	739	25	6	4.166666666666667	732
FBgn0266599	784	750	783	35	6	5.833333333333333	749
FBgn0266616	754	750	434	324	9	36	430
FBgn0266618	771	750	766	26	5	5.2	745
FBgn0266622	750	750	727	23	4	5.75	727
FBgn0266623	755	750	752	8	2	4	747
FBgn0266624	755	750	576	184	6	30.666666666666668	571
FBgn0266625	757	750	757	7	1	7	750
FBgn0266626	771	750	770	22	3	7.333333333333333	749
FBgn0266627	758	750	739	27	5	5.4	731
FBgn0266628	751	750	741	11	4	2.75	740
FBgn0266629	775	750	746	54	13	4.153846153846154	721
FBgn0266630	750	750	731	19	2	9.5	731
FBgn0266632	776	750	772	30	6	5	746
FBgn0266634	791	750	785	47	8	5.875	744
FBgn0266635	767	750	757	27	6	4.5	740
FBgn0266636	750	750	746	4	1	4	746
FBgn0266637	753	750	750	6	3	2	747
FBgn0266638	756	750	752	10	2	5	746
FBgn0266639	761	750	727	45	8	5.625	716
FBgn0266640	851	750	839	113	8	14.125	738
FBgn0266641	777	750	775	29	6	4.833333333333333	748
FBgn0266643	764	750	725	53	7	7.571428571428571	711
FBgn0266644	733	733	732	1	1	1	732
FBgn0266645	750	750	749	1	1	1	749
FBgn0266646	760	750	736	34	7	4.857142857142857	726
FBgn0266648	767	750	695	89	7	12.714285714285714	678
FBgn0266649	760	750	713	57	7	8.142857142857142	703
FBgn0266650	770	750	770	20	3	6.666666666666667	750
FBgn0266651	756	750	726	36	8	4.5	720
FBgn0266654	828	750	807	99	15	6.6	729
FBgn0266655	794	750	741	97	9	10.777777777777779	697
FBgn0266657	759	750	753	15	3	5	744
FBgn0266666	765	750	718	62	8	7.75	703
FBgn0266667	751	750	732	20	5	4	731
FBgn0266669	751	750	751	1	1	1	750
FBgn0266670	770	750	770	20	4	5	750
FBgn0266671	751	750	724	28	5	5.6	723
FBgn0266674	771	750	761	31	8	3.875	740
FBgn0266675	757	750	757	7	1	7	750
FBgn0266677	783	750	779	37	5	7.4	746
FBgn0266678	770	750	763	27	7	3.857142857142857	743
FBgn0266679	750	750	667	83	6	13.833333333333334	667
FBgn0266680	764	750	746	32	10	3.2	732
FBgn0266681	757	750	750	14	6	2.3333333333333335	743
FBgn0266682	758	750	751	15	4	3.75	743
FBgn0266685	753	750	736	20	6	3.3333333333333335	733
FBgn0266686	750	750	744	6	1	6	744
FBgn0266688	768	750	768	18	4	4.5	750
FBgn0266693	787	750	758	66	9	7.333333333333333	721
FBgn0266696	750	750	749	1	1	1	749
FBgn0266697	759	750	756	12	3	4	747
FBgn0266699	763	750	756	20	7	2.857142857142857	743
FBgn0266700	753	750	751	5	3	1.6666666666666667	748
FBgn0266701	754	750	747	11	6	1.8333333333333333	743
FBgn0266703	750	750	749	1	1	1	749
FBgn0266705	633	620	606	40	6	6.666666666666667	593
FBgn0266706	753	750	737	19	6	3.1666666666666665	734
FBgn0266707	594	583	553	52	11	4.7272727272727275	542
FBgn0266708	796	750	691	151	16	9.4375	645
FBgn0266711	755	750	736	24	6	4	731
FBgn0266717	750	750	749	1	1	1	749
FBgn0266719	750	750	750	0	0	NA	750
FBgn0266721	773	750	756	40	11	3.6363636363636362	733
FBgn0266722	750	750	749	1	1	1	749
FBgn0266723	704	703	698	7	3	2.3333333333333335	697
FBgn0266724	781	750	770	42	13	3.230769230769231	739
FBgn0266725	752	750	741	13	6	2.1666666666666665	739
FBgn0266729	531	531	525	6	2	3	525
FBgn0266731	762	750	720	54	11	4.909090909090909	708
FBgn0266732	768	750	677	109	6	18.166666666666668	659
FBgn0266734	776	750	757	45	8	5.625	731
FBgn0266735	750	750	741	9	1	9	741
FBgn0266736	769	750	767	21	6	3.5	748
FBgn0266737	768	750	755	31	7	4.428571428571429	737
FBgn0266738	771	750	752	40	9	4.444444444444445	731
FBgn0266741	750	750	744	6	2	3	744
FBgn0266742	758	750	741	25	6	4.166666666666667	733
FBgn0266744	756	750	756	6	1	6	750
FBgn0266745	762	750	748	26	6	4.333333333333333	736
FBgn0266750	751	750	749	3	2	1.5	748
FBgn0266751	750	750	734	16	4	4	734
FBgn0266752	519	519	510	9	2	4.5	510
FBgn0266756	765	750	725	55	9	6.111111111111111	710
FBgn0266757	751	750	723	29	8	3.625	722
FBgn0266758	760	750	516	254	5	50.8	506
FBgn0266763	763	750	744	32	7	4.571428571428571	731
FBgn0266764	762	750	692	82	4	20.5	680
FBgn0266766	751	750	747	5	3	1.6666666666666667	746
FBgn0266768	776	750	697	105	11	9.545454545454545	671
FBgn0266769	769	750	646	142	11	12.909090909090908	627
FBgn0266771	751	750	739	13	2	6.5	738
FBgn0266772	777	750	775	29	3	9.666666666666666	748
FBgn0266773	758	750	755	11	3	3.6666666666666665	747
FBgn0266774	742	735	684	65	10	6.5	677
FBgn0266775	750	750	731	19	1	19	731
FBgn0266776	751	750	744	8	4	2	743
FBgn0266777	770	750	750	40	6	6.666666666666667	730
FBgn0266778	807	750	778	86	10	8.6	721
FBgn0266780	750	750	696	54	8	6.75	696
FBgn0266781	752	750	750	4	3	1.3333333333333333	748
FBgn0266782	758	750	693	73	10	7.3	685
FBgn0266783	754	750	723	35	8	4.375	719
FBgn0266784	750	750	732	18	5	3.6	732
FBgn0266785	792	750	763	71	10	7.1	721
FBgn0266786	789	750	760	68	14	4.857142857142857	721
FBgn0266787	750	750	750	0	0	NA	750
FBgn0266789	640	640	619	21	4	5.25	619
FBgn0266790	750	750	742	8	3	2.6666666666666665	742
FBgn0266795	776	750	734	68	12	5.666666666666667	708
FBgn0266796	759	750	712	56	5	11.2	703
FBgn0266797	758	750	725	41	6	6.833333333333333	717
FBgn0266798	751	750	749	3	3	1	748
FBgn0266799	770	750	704	86	8	10.75	684
FBgn0266800	771	750	770	22	2	11	749
FBgn0266801	766	750	716	66	8	8.25	700
FBgn0266802	750	750	347	403	1	403	347
FBgn0266803	757	750	757	7	2	3.5	750
FBgn0266804	778	750	703	103	7	14.714285714285714	675
FBgn0266805	755	750	739	21	3	7	734
FBgn0266806	750	750	738	12	3	4	738
FBgn0266807	772	750	748	46	10	4.6	726
FBgn0266808	752	750	749	5	3	1.6666666666666667	747
FBgn0266809	806	750	805	57	4	14.25	749
FBgn0266810	770	750	765	25	6	4.166666666666667	745
FBgn0266811	752	750	746	8	4	2	744
FBgn0266812	765	750	762	18	2	9	747
FBgn0266813	780	750	775	35	6	5.833333333333333	745
FBgn0266814	751	750	669	83	3	27.666666666666668	668
FBgn0266815	779	750	719	89	7	12.714285714285714	690
FBgn0266816	753	750	750	6	5	1.2	747
FBgn0266817	595	564	559	67	8	8.375	528
FBgn0266818	768	750	699	87	12	7.25	681
FBgn0266819	759	750	737	31	7	4.428571428571429	728
FBgn0266821	754	750	754	4	3	1.3333333333333333	750
FBgn0266822	751	750	635	117	5	23.4	634
FBgn0266824	781	750	764	48	7	6.857142857142857	733
FBgn0266825	750	750	728	22	6	3.6666666666666665	728
FBgn0266827	761	750	739	33	5	6.6	728
FBgn0266828	750	750	725	25	5	5	725
FBgn0266829	788	750	788	38	3	12.666666666666666	750
FBgn0266830	563	558	561	7	2	3.5	556
FBgn0266831	758	750	750	16	5	3.2	742
FBgn0266834	750	750	735	15	3	5	735
FBgn0266836	750	750	746	4	2	2	746
FBgn0266837	758	750	721	45	7	6.428571428571429	713
FBgn0266841	750	750	733	17	5	3.4	733
FBgn0266842	766	750	753	29	9	3.2222222222222223	737
FBgn0266843	754	750	730	28	6	4.666666666666667	726
FBgn0266844	788	750	763	63	13	4.846153846153846	725
FBgn0266845	750	750	747	3	2	1.5	747
FBgn0266846	769	750	768	20	4	5	749
FBgn0266848	796	750	739	103	9	11.444444444444445	693
FBgn0266849	750	750	734	16	3	5.333333333333333	734
FBgn0266850	756	750	745	17	4	4.25	739
FBgn0266851	750	750	745	5	2	2.5	745
FBgn0266852	761	750	748	24	6	4	737
FBgn0266854	769	750	694	94	13	7.230769230769231	675
FBgn0266855	755	750	712	48	8	6	707
FBgn0266856	762	750	599	175	7	25	587
FBgn0266858	760	750	699	71	6	11.833333333333334	689
FBgn0266859	769	750	766	22	4	5.5	747
FBgn0266860	752	750	727	27	2	13.5	725
FBgn0266861	754	750	744	14	4	3.5	740
FBgn0266863	814	750	795	83	12	6.916666666666667	731
FBgn0266864	768	750	719	67	6	11.166666666666666	701
FBgn0266865	550	532	543	25	3	8.333333333333334	525
FBgn0266866	751	750	743	9	3	3	742
FBgn0266867	756	750	748	14	4	3.5	742
FBgn0266868	763	750	745	31	8	3.875	732
FBgn0266870	762	750	720	54	10	5.4	708
FBgn0266872	751	750	749	3	3	1	748
FBgn0266874	750	750	736	14	5	2.8	736
FBgn0266877	754	750	749	9	4	2.25	745
FBgn0266880	769	750	762	26	8	3.25	743
FBgn0266881	756	750	727	35	7	5	721
FBgn0266882	750	750	718	32	3	10.666666666666666	718
FBgn0266884	806	750	793	69	9	7.666666666666667	737
FBgn0266885	750	750	736	14	2	7	736
FBgn0266886	763	750	728	48	9	5.333333333333333	715
FBgn0266888	561	530	543	49	5	9.8	512
FBgn0266889	755	750	754	6	3	2	749
FBgn0266891	750	750	696	54	6	9	696
FBgn0266892	821	750	786	106	8	13.25	715
FBgn0266893	757	750	745	19	9	2.111111111111111	738
FBgn0266895	774	750	744	54	11	4.909090909090909	720
FBgn0266896	762	750	758	16	5	3.2	746
FBgn0266898	750	750	726	24	2	12	726
FBgn0266899	539	530	451	97	7	13.857142857142858	442
FBgn0266901	750	750	689	61	7	8.714285714285714	689
FBgn0266905	751	750	734	18	4	4.5	733
FBgn0266909	638	585	620	71	4	17.75	567
FBgn0266910	773	750	736	60	7	8.571428571428571	713
FBgn0266911	769	750	707	81	8	10.125	688
FBgn0266914	752	750	734	20	3	6.666666666666667	732
FBgn0266915	766	750	585	197	8	24.625	569
FBgn0266916	769	740	742	56	14	4	713
FBgn0266917	768	750	735	51	4	12.75	717
FBgn0266918	750	750	731	19	3	6.333333333333333	731
FBgn0266925	775	750	775	25	4	6.25	750
FBgn0266926	754	750	748	10	5	2	744
FBgn0266927	753	750	734	22	4	5.5	731
FBgn0266928	764	750	738	40	4	10	724
FBgn0266931	754	750	754	4	1	4	750
FBgn0266932	792	750	761	73	11	6.636363636363637	719
FBgn0266933	771	750	766	26	8	3.25	745
FBgn0266934	754	750	200	558	3	186	196
FBgn0266935	766	750	497	285	4	71.25	481
FBgn0266937	770	750	729	61	8	7.625	709
FBgn0266939	771	750	723	69	8	8.625	702
FBgn0266940	794	750	752	86	11	7.818181818181818	708
FBgn0266941	751	750	725	27	7	3.857142857142857	724
FBgn0266942	761	750	731	41	6	6.833333333333333	720
FBgn0266945	751	750	748	4	2	2	747
FBgn0266946	753	750	738	18	3	6	735
FBgn0266947	754	750	734	24	6	4	730
FBgn0266948	750	750	719	31	5	6.2	719
FBgn0266949	787	750	701	123	13	9.461538461538462	664
FBgn0266950	771	750	755	37	6	6.166666666666667	734
FBgn0266951	774	750	645	153	10	15.3	621
FBgn0266952	753	750	746	10	5	2	743
FBgn0266954	766	750	702	80	9	8.88888888888889	686
FBgn0266956	772	750	752	42	7	6	730
FBgn0266957	751	750	743	9	5	1.8	742
FBgn0266958	518	518	515	3	1	3	515
FBgn0266959	803	750	790	66	7	9.428571428571429	737
FBgn0266960	754	750	742	16	5	3.2	738
FBgn0266961	760	750	737	33	8	4.125	727
FBgn0266962	760	750	708	62	5	12.4	698
FBgn0266963	760	750	746	24	6	4	736
FBgn0266964	759	750	745	23	5	4.6	736
FBgn0266965	769	750	763	25	6	4.166666666666667	744
FBgn0266966	751	750	749	3	2	1.5	748
FBgn0266967	752	750	742	12	4	3	740
FBgn0266968	764	750	740	38	8	4.75	726
FBgn0266969	751	750	747	5	2	2.5	746
FBgn0266970	754	750	667	91	10	9.1	663
FBgn0266971	766	750	745	37	10	3.7	729
FBgn0266972	752	750	726	28	6	4.666666666666667	724
FBgn0266973	764	750	737	41	11	3.727272727272727	723
FBgn0266974	752	750	752	2	2	1	750
FBgn0266975	761	750	757	15	5	3	746
FBgn0266976	750	750	630	120	6	20	630
FBgn0266977	751	750	751	1	1	1	750
FBgn0266978	753	750	749	7	4	1.75	746
FBgn0266979	772	750	771	23	5	4.6	749
FBgn0266980	754	750	752	6	4	1.5	748
FBgn0266983	773	750	770	26	6	4.333333333333333	747
FBgn0266984	796	750	786	56	9	6.222222222222222	740
FBgn0266985	772	750	663	131	6	21.833333333333332	641
FBgn0266986	760	750	678	92	10	9.2	668
FBgn0266987	792	750	785	49	10	4.9	743
FBgn0266989	750	750	743	7	4	1.75	743
FBgn0266990	753	750	706	50	6	8.333333333333334	703
FBgn0266992	807	750	798	66	10	6.6	741
FBgn0266994	751	750	670	82	5	16.4	669
FBgn0266995	752	750	750	4	3	1.3333333333333333	748
FBgn0267003	770	750	751	39	7	5.571428571428571	731
FBgn0267005	753	750	710	46	10	4.6	707
FBgn0267006	768	750	736	50	13	3.8461538461538463	718
FBgn0267007	763	750	724	52	8	6.5	711
FBgn0267008	750	750	738	12	3	4	738
FBgn0267010	767	750	749	35	7	5	732
FBgn0267011	769	750	761	27	6	4.5	742
FBgn0267012	753	750	684	72	5	14.4	681
FBgn0267014	762	750	593	181	6	30.166666666666668	581
FBgn0267017	801	750	800	52	9	5.777777777777778	749
FBgn0267018	767	750	764	20	4	5	747
FBgn0267019	750	750	750	0	0	NA	750
FBgn0267021	769	750	699	89	8	11.125	680
FBgn0267022	779	750	748	60	11	5.454545454545454	719
FBgn0267023	762	750	760	14	4	3.5	748
FBgn0267024	750	750	749	1	1	1	749
FBgn0267025	752	750	729	25	4	6.25	727
FBgn0267026	781	750	696	116	15	7.733333333333333	665
FBgn0267028	809	750	737	131	12	10.916666666666666	678
FBgn0267030	764	750	762	16	4	4	748
FBgn0267032	803	750	761	95	6	15.833333333333334	708
FBgn0267033	761	750	748	24	5	4.8	737
FBgn0267036	770	750	763	27	6	4.5	743
FBgn0267037	754	750	696	62	12	5.166666666666667	692
FBgn0267038	759	750	726	42	12	3.5	717
FBgn0267040	750	750	684	66	13	5.076923076923077	684
FBgn0267041	792	750	775	59	12	4.916666666666667	733
FBgn0267056	776	750	763	39	6	6.5	737
FBgn0267057	813	750	808	68	4	17	745
FBgn0267065	761	750	752	20	8	2.5	741
FBgn0267066	756	750	738	24	4	6	732
FBgn0267068	757	750	741	23	3	7.666666666666667	734
FBgn0267069	752	750	706	48	8	6	704
FBgn0267071	760	750	730	40	9	4.444444444444445	720
FBgn0267072	757	750	719	45	8	5.625	712
FBgn0267074	755	750	729	31	7	4.428571428571429	724
FBgn0267075	756	750	707	55	9	6.111111111111111	701
FBgn0267076	753	750	751	5	2	2.5	748
FBgn0267077	795	750	755	85	11	7.7272727272727275	710
FBgn0267078	750	750	710	40	5	8	710
FBgn0267079	526	525	457	70	8	8.75	456
FBgn0267080	801	750	706	146	11	13.272727272727273	655
FBgn0267081	755	750	715	45	5	9	710
FBgn0267083	781	750	747	65	12	5.416666666666667	716
FBgn0267084	822	750	801	93	10	9.3	729
FBgn0267086	763	750	736	40	6	6.666666666666667	723
FBgn0267087	764	750	711	67	10	6.7	697
FBgn0267088	773	750	723	73	6	12.166666666666666	700
FBgn0267089	767	750	751	33	9	3.6666666666666665	734
FBgn0267090	751	750	710	42	9	4.666666666666667	709
FBgn0267091	754	750	690	68	7	9.714285714285714	686
FBgn0267096	767	750	705	79	11	7.181818181818182	688
FBgn0267097	758	750	691	75	15	5	683
FBgn0267098	767	750	653	131	15	8.733333333333333	636
FBgn0267099	777	750	768	36	7	5.142857142857143	741
FBgn0267100	784	750	737	81	8	10.125	703
FBgn0267101	754	750	667	91	7	13	663
FBgn0267102	779	750	771	37	9	4.111111111111111	742
FBgn0267103	760	750	600	170	5	34	590
FBgn0267104	764	750	736	42	7	6	722
FBgn0267105	751	750	704	48	4	12	703
FBgn0267106	786	750	766	56	7	8	730
FBgn0267107	751	750	737	15	6	2.5	736
FBgn0267109	750	750	491	259	1	259	491
FBgn0267110	759	750	743	25	9	2.7777777777777777	734
FBgn0267112	765	750	732	48	7	6.857142857142857	717
FBgn0267113	760	750	747	23	6	3.8333333333333335	737
FBgn0267114	750	750	749	1	1	1	749
FBgn0267115	750	750	742	8	2	4	742
FBgn0267116	772	750	714	80	12	6.666666666666667	692
FBgn0267119	758	750	746	20	6	3.3333333333333335	738
FBgn0267120	768	750	746	40	7	5.714285714285714	728
FBgn0267121	750	750	735	15	2	7.5	735
FBgn0267122	752	750	737	17	4	4.25	735
FBgn0267123	755	750	736	24	8	3	731
FBgn0267124	610	601	586	33	8	4.125	577
FBgn0267125	756	750	730	32	3	10.666666666666666	724
FBgn0267126	756	750	706	56	10	5.6	700
FBgn0267127	769	750	767	21	3	7	748
FBgn0267128	773	750	751	45	7	6.428571428571429	728
FBgn0267129	798	750	781	65	12	5.416666666666667	733
FBgn0267131	752	750	752	2	1	2	750
FBgn0267134	762	750	735	39	12	3.25	723
FBgn0267135	774	750	749	49	3	16.333333333333332	725
FBgn0267136	759	750	759	9	3	3	750
FBgn0267137	771	750	760	32	8	4	739
FBgn0267139	752	750	745	9	2	4.5	743
FBgn0267140	782	750	760	54	7	7.714285714285714	728
FBgn0267141	755	750	728	32	4	8	723
FBgn0267142	775	750	761	39	10	3.9	736
FBgn0267143	761	750	742	30	7	4.285714285714286	731
FBgn0267144	755	750	735	25	7	3.5714285714285716	730
FBgn0267145	756	750	726	36	5	7.2	720
FBgn0267146	761	750	749	23	6	3.8333333333333335	738
FBgn0267147	750	750	741	9	4	2.25	741
FBgn0267148	763	750	746	30	8	3.75	733
FBgn0267149	783	750	749	67	9	7.444444444444445	716
FBgn0267150	773	750	758	38	6	6.333333333333333	735
FBgn0267153	758	750	745	21	4	5.25	737
FBgn0267154	763	750	744	32	9	3.5555555555555554	731
FBgn0267155	777	750	768	36	7	5.142857142857143	741
FBgn0267157	769	750	759	29	5	5.8	740
FBgn0267158	750	750	648	102	4	25.5	648
FBgn0267159	758	750	754	12	4	3	746
FBgn0267160	750	750	738	12	3	4	738
FBgn0267161	798	750	785	61	10	6.1	737
FBgn0267162	768	750	624	162	9	18	606
FBgn0267164	783	750	609	207	8	25.875	576
FBgn0267165	775	750	760	40	8	5	735
FBgn0267166	790	750	766	64	10	6.4	726
FBgn0267167	750	750	724	26	6	4.333333333333333	724
FBgn0267169	780	750	739	71	14	5.071428571428571	709
FBgn0267170	770	750	717	73	8	9.125	697
FBgn0267171	767	750	744	40	10	4	727
FBgn0267173	790	750	764	66	7	9.428571428571429	724
FBgn0267176	771	750	765	27	8	3.375	744
FBgn0267178	750	750	745	5	3	1.6666666666666667	745
FBgn0267179	815	750	740	140	17	8.235294117647058	675
FBgn0267180	761	750	732	40	9	4.444444444444445	721
FBgn0267181	758	750	755	11	4	2.75	747
FBgn0267182	768	750	674	112	7	16	656
FBgn0267183	757	750	749	15	5	3	742
FBgn0267184	768	750	564	222	6	37	546
FBgn0267185	823	750	763	133	11	12.090909090909092	690
FBgn0267187	760	750	753	17	5	3.4	743
FBgn0267188	800	750	784	66	7	9.428571428571429	734
FBgn0267189	755	750	676	84	8	10.5	671
FBgn0267190	757	750	701	63	11	5.7272727272727275	694
FBgn0267191	753	750	735	21	6	3.5	732
FBgn0267192	779	750	773	35	10	3.5	744
FBgn0267194	750	750	741	9	1	9	741
FBgn0267195	778	750	744	62	9	6.888888888888889	716
FBgn0267198	777	750	771	33	4	8.25	744
FBgn0267200	783	750	778	38	4	9.5	745
FBgn0267202	761	750	758	14	5	2.8	747
FBgn0267205	757	750	714	50	9	5.555555555555555	707
FBgn0267206	750	750	740	10	4	2.5	740
FBgn0267207	750	750	310	440	3	146.66666666666666	310
FBgn0267208	750	750	745	5	1	5	745
FBgn0267209	752	750	735	19	5	3.8	733
FBgn0267210	811	750	804	68	8	8.5	743
FBgn0267212	762	750	719	55	5	11	707
FBgn0267213	766	750	734	48	8	6	718
FBgn0267214	752	750	690	64	4	16	688
FBgn0267216	769	750	751	37	9	4.111111111111111	732
FBgn0267217	774	750	760	38	8	4.75	736
FBgn0267218	755	750	687	73	8	9.125	682
FBgn0267219	759	750	741	27	4	6.75	732
FBgn0267220	776	750	753	49	8	6.125	727
FBgn0267222	759	750	716	52	9	5.777777777777778	707
FBgn0267229	753	750	732	24	3	8	729
FBgn0267230	778	750	774	32	9	3.5555555555555554	746
FBgn0267232	681	656	639	67	13	5.153846153846154	614
FBgn0267233	793	750	537	299	11	27.181818181818183	494
FBgn0267234	750	750	735	15	6	2.5	735
FBgn0267235	796	750	790	52	4	13	744
FBgn0267236	751	750	750	2	2	1	749
FBgn0267237	776	750	762	40	11	3.6363636363636362	736
FBgn0267238	753	750	724	32	6	5.333333333333333	721
FBgn0267239	751	750	725	27	5	5.4	724
FBgn0267240	779	750	757	51	5	10.2	728
FBgn0267241	750	750	740	10	3	3.3333333333333335	740
FBgn0267243	813	750	804	72	7	10.285714285714286	741
FBgn0267244	751	750	741	11	6	1.8333333333333333	740
FBgn0267245	750	750	732	18	3	6	732
FBgn0267246	757	750	747	17	5	3.4	740
FBgn0267247	757	750	747	17	5	3.4	740
FBgn0267249	750	750	739	11	3	3.6666666666666665	739
FBgn0267252	774	750	757	41	8	5.125	733
FBgn0267253	766	750	728	54	11	4.909090909090909	712
FBgn0267255	770	750	770	20	3	6.666666666666667	750
FBgn0267256	767	750	735	49	7	7	718
FBgn0267257	751	750	749	3	3	1	748
FBgn0267259	753	750	726	30	7	4.285714285714286	723
FBgn0267260	758	750	735	31	4	7.75	727
FBgn0267261	757	750	754	10	4	2.5	747
FBgn0267262	797	750	794	50	4	12.5	747
FBgn0267263	753	750	721	35	11	3.1818181818181817	718
FBgn0267264	768	750	748	38	7	5.428571428571429	730
FBgn0267265	750	750	748	2	2	1	748
FBgn0267266	750	750	728	22	3	7.333333333333333	728
FBgn0267267	757	750	406	358	5	71.6	399
FBgn0267268	774	750	583	215	7	30.714285714285715	559
FBgn0267269	750	750	745	5	2	2.5	745
FBgn0267270	776	750	769	33	4	8.25	743
FBgn0267271	751	750	720	32	8	4	719
FBgn0267273	750	750	669	81	6	13.5	669
FBgn0267274	762	750	716	58	5	11.6	704
FBgn0267275	791	750	754	78	10	7.8	713
FBgn0267276	750	750	748	2	2	1	748
FBgn0267278	750	750	561	189	2	94.5	561
FBgn0267279	829	750	823	85	9	9.444444444444445	744
FBgn0267280	778	750	743	63	10	6.3	715
FBgn0267281	801	750	775	77	12	6.416666666666667	724
FBgn0267282	783	750	771	45	5	9	738
FBgn0267283	767	750	740	44	8	5.5	723
FBgn0267284	756	750	751	11	7	1.5714285714285714	745
FBgn0267286	772	750	713	81	17	4.764705882352941	691
FBgn0267288	782	750	759	55	8	6.875	727
FBgn0267289	751	750	748	4	3	1.3333333333333333	747
FBgn0267290	751	750	747	5	3	1.6666666666666667	746
FBgn0267291	756	750	749	13	5	2.6	743
FBgn0267292	803	750	772	84	12	7	719
FBgn0267293	803	750	706	150	7	21.428571428571427	653
FBgn0267294	755	750	750	10	4	2.5	745
FBgn0267295	752	750	652	102	13	7.846153846153846	650
FBgn0267296	691	673	662	47	8	5.875	644
FBgn0267297	754	750	732	26	3	8.666666666666666	728
FBgn0267298	750	750	743	7	3	2.3333333333333335	743
FBgn0267301	771	750	752	40	3	13.333333333333334	731
FBgn0267302	788	750	785	41	5	8.2	747
FBgn0267303	781	750	781	31	3	10.333333333333334	750
FBgn0267304	787	750	776	48	5	9.6	739
FBgn0267305	757	750	714	50	8	6.25	707
FBgn0267306	756	750	738	24	6	4	732
FBgn0267307	785	750	773	47	9	5.222222222222222	738
FBgn0267308	758	750	758	8	2	4	750
FBgn0267309	752	750	736	18	3	6	734
FBgn0267310	758	750	741	25	7	3.5714285714285716	733
FBgn0267312	776	750	775	27	4	6.75	749
FBgn0267313	752	750	751	3	3	1	749
FBgn0267314	758	750	757	9	2	4.5	749
FBgn0267316	574	552	548	48	13	3.6923076923076925	526
FBgn0267317	582	582	513	69	7	9.857142857142858	513
FBgn0267318	755	750	555	205	11	18.636363636363637	550
FBgn0267319	768	750	479	307	7	43.857142857142854	461
FBgn0267320	534	510	531	27	5	5.4	507
FBgn0267322	777	750	753	51	10	5.1	726
FBgn0267323	751	750	716	36	7	5.142857142857143	715
FBgn0267327	792	750	780	54	10	5.4	738
FBgn0267330	767	750	765	19	7	2.7142857142857144	748
FBgn0267337	754	750	748	10	4	2.5	744
FBgn0267348	771	750	754	38	7	5.428571428571429	733
FBgn0267350	754	750	736	22	5	4.4	732
FBgn0267351	759	750	753	15	3	5	744
FBgn0267376	750	750	746	4	2	2	746
FBgn0267378	767	750	766	18	4	4.5	749
FBgn0267383	766	750	735	47	9	5.222222222222222	719
FBgn0267384	761	750	740	32	8	4	729
FBgn0267390	765	750	703	77	9	8.555555555555555	688
FBgn0267399	764	750	759	19	5	3.8	745
FBgn0267400	750	750	683	67	7	9.571428571428571	683
FBgn0267408	566	550	560	22	8	2.75	544
FBgn0267425	795	750	623	217	16	13.5625	578
FBgn0267428	782	750	720	94	8	11.75	688
FBgn0267438	752	750	731	23	6	3.8333333333333335	729
FBgn0267440	760	750	740	30	6	5	730
FBgn0267442	790	750	741	89	9	9.88888888888889	701
FBgn0267447	750	750	708	42	5	8.4	708
FBgn0267448	751	750	345	407	2	203.5	344
FBgn0267450	759	750	756	12	3	4	747
FBgn0267451	738	723	697	56	8	7	682
FBgn0267452	793	750	774	62	11	5.636363636363637	731
FBgn0267453	833	750	741	175	16	10.9375	658
FBgn0267454	754	750	714	44	6	7.333333333333333	710
FBgn0267455	754	750	748	10	5	2	744
FBgn0267457	751	750	739	13	5	2.6	738
FBgn0267461	753	750	752	4	2	2	749
FBgn0267462	750	750	734	16	1	16	734
FBgn0267463	789	750	781	47	9	5.222222222222222	742
FBgn0267464	750	750	743	7	2	3.5	743
FBgn0267465	752	750	717	37	7	5.285714285714286	715
FBgn0267468	750	750	750	0	0	NA	750
FBgn0267469	773	750	659	137	10	13.7	636
FBgn0267470	750	750	742	8	2	4	742
FBgn0267471	752	750	741	13	3	4.333333333333333	739
FBgn0267472	750	750	747	3	1	3	747
FBgn0267473	762	750	699	75	10	7.5	687
FBgn0267474	751	750	740	12	3	4	739
FBgn0267476	770	750	740	50	6	8.333333333333334	720
FBgn0267479	750	750	739	11	3	3.6666666666666665	739
FBgn0267480	792	750	767	67	9	7.444444444444445	725
FBgn0267482	779	750	763	45	5	9	734
FBgn0267484	756	750	717	45	4	11.25	711
FBgn0267485	750	750	746	4	2	2	746
FBgn0267487	750	750	703	47	8	5.875	703
FBgn0267488	751	750	722	30	6	5	721
FBgn0267525	759	750	714	54	8	6.75	705
FBgn0267526	750	750	731	19	3	6.333333333333333	731
FBgn0267527	750	750	692	58	8	7.25	692
FBgn0267528	797	750	721	123	7	17.571428571428573	674
FBgn0267529	757	750	715	49	8	6.125	708
FBgn0267531	750	750	747	3	1	3	747
FBgn0267535	757	750	735	29	7	4.142857142857143	728
FBgn0267541	766	750	740	42	10	4.2	724
FBgn0267544	787	750	784	40	7	5.714285714285714	747
FBgn0267545	771	750	764	28	6	4.666666666666667	743
FBgn0267546	769	750	759	29	7	4.142857142857143	740
FBgn0267547	803	750	798	58	6	9.666666666666666	745
FBgn0267548	761	750	739	33	3	11	728
FBgn0267549	762	750	697	77	10	7.7	685
FBgn0267550	655	655	104	551	2	275.5	104
FBgn0267551	761	750	749	23	5	4.6	738
FBgn0267555	822	750	802	92	9	10.222222222222221	730
FBgn0267556	757	750	754	10	2	5	747
FBgn0267559	751	750	264	488	5	97.6	263
FBgn0267560	770	750	724	66	8	8.25	704
FBgn0267561	753	750	746	10	3	3.3333333333333335	743
FBgn0267564	768	750	751	35	6	5.833333333333333	733
FBgn0267566	751	750	739	13	4	3.25	738
FBgn0267567	774	750	769	29	3	9.666666666666666	745
FBgn0267568	768	750	759	27	6	4.5	741
FBgn0267569	752	750	739	15	3	5	737
FBgn0267570	755	750	754	6	5	1.2	749
FBgn0267571	764	750	676	102	9	11.333333333333334	662
FBgn0267572	750	750	734	16	2	8	734
FBgn0267573	794	750	755	83	11	7.545454545454546	711
FBgn0267574	778	750	775	31	5	6.2	747
FBgn0267575	750	750	748	2	1	2	748
FBgn0267576	754	750	747	11	4	2.75	743
FBgn0267577	524	524	516	8	1	8	516
FBgn0267579	755	750	753	7	4	1.75	748
FBgn0267580	789	750	787	41	5	8.2	748
FBgn0267586	769	750	677	111	10	11.1	658
FBgn0267587	750	750	748	2	1	2	748
FBgn0267589	750	750	750	0	0	NA	750
FBgn0267590	750	750	747	3	1	3	747
FBgn0267591	759	750	744	24	5	4.8	735
FBgn0267597	794	750	682	156	15	10.4	638
FBgn0267598	784	750	763	55	7	7.857142857142857	729
FBgn0267599	805	750	778	82	10	8.2	723
FBgn0267601	830	750	807	103	13	7.923076923076923	727
FBgn0267604	783	750	773	43	9	4.777777777777778	740
FBgn0267605	628	624	627	5	3	1.6666666666666667	623
FBgn0267606	824	750	805	93	9	10.333333333333334	731
FBgn0267607	767	750	729	55	6	9.166666666666666	712
FBgn0267611	794	750	752	86	11	7.818181818181818	708
FBgn0267620	755	750	745	15	2	7.5	740
FBgn0267621	783	750	777	39	5	7.8	744
FBgn0267622	788	750	773	53	9	5.888888888888889	735
FBgn0267625	762	750	734	40	5	8	722
FBgn0267626	772	750	771	23	6	3.8333333333333335	749
FBgn0267628	750	750	719	31	4	7.75	719
FBgn0267629	757	750	744	20	5	4	737
FBgn0267630	754	750	732	26	6	4.333333333333333	728
FBgn0267631	764	750	760	18	6	3	746
FBgn0267632	750	750	746	4	2	2	746
FBgn0267633	761	750	755	17	5	3.4	744
FBgn0267636	751	750	721	31	6	5.166666666666667	720
FBgn0267639	755	750	726	34	7	4.857142857142857	721
FBgn0267642	750	750	735	15	3	5	735
FBgn0267644	768	750	724	62	15	4.133333333333334	706
FBgn0267647	760	750	745	25	4	6.25	735
FBgn0267653	753	750	752	4	3	1.3333333333333333	749
FBgn0267655	763	750	748	28	7	4	735
FBgn0267658	790	750	776	54	5	10.8	736
FBgn0267660	795	750	782	58	10	5.8	737
FBgn0267661	791	750	738	94	11	8.545454545454545	697
FBgn0267663	750	750	698	52	5	10.4	698
FBgn0267664	750	750	711	39	5	7.8	711
FBgn0267665	769	750	756	32	8	4	737
FBgn0267666	754	750	740	18	6	3	736
FBgn0267668	788	750	779	47	5	9.4	741
FBgn0267671	750	750	749	1	1	1	749
FBgn0267672	752	750	741	13	3	4.333333333333333	739
FBgn0267674	786	750	783	39	5	7.8	747
FBgn0267675	764	750	745	33	8	4.125	731
FBgn0267676	750	750	749	1	1	1	749
FBgn0267681	758	750	758	8	3	2.6666666666666665	750
FBgn0267683	766	750	752	30	6	5	736
FBgn0267685	769	750	761	27	7	3.857142857142857	742
FBgn0267689	756	750	738	24	7	3.4285714285714284	732
FBgn0267690	765	718	738	74	12	6.166666666666667	691
FBgn0267692	751	750	749	3	2	1.5	748
FBgn0267693	769	750	730	58	6	9.666666666666666	711
FBgn0267694	774	750	727	71	9	7.888888888888889	703
FBgn0267695	750	750	750	0	0	NA	750
FBgn0267697	753	750	751	5	4	1.25	748
FBgn0267702	753	750	694	62	9	6.888888888888889	691
FBgn0267703	788	750	785	41	5	8.2	747
FBgn0267707	768	750	716	70	12	5.833333333333333	698
FBgn0267708	763	750	699	77	10	7.7	686
FBgn0267710	755	750	743	17	8	2.125	738
FBgn0267711	755	750	618	142	3	47.333333333333336	613
FBgn0267712	794	750	772	66	11	6	728
FBgn0267713	756	750	674	88	8	11	668
FBgn0267714	750	750	72	678	2	339	72
FBgn0267715	848	750	659	287	13	22.076923076923077	561
FBgn0267716	767	750	743	41	12	3.4166666666666665	726
FBgn0267717	757	750	686	78	8	9.75	679
FBgn0267721	751	750	706	46	6	7.666666666666667	705
FBgn0267722	764	750	761	17	5	3.4	747
FBgn0267723	752	750	738	16	7	2.2857142857142856	736
FBgn0267725	754	750	677	81	10	8.1	673
FBgn0267728	587	571	581	22	8	2.75	565
FBgn0267729	759	750	734	34	5	6.8	725
FBgn0267730	750	750	714	36	4	9	714
FBgn0267732	784	750	772	46	10	4.6	738
FBgn0267735	815	750	794	86	12	7.166666666666667	729
FBgn0267736	762	750	725	49	8	6.125	713
FBgn0267737	806	750	779	83	7	11.857142857142858	723
FBgn0267738	758	750	757	9	3	3	749
FBgn0267739	750	750	750	0	0	NA	750
FBgn0267740	764	750	636	142	11	12.909090909090908	622
FBgn0267742	772	750	772	22	2	11	750
FBgn0267744	772	750	764	30	5	6	742
FBgn0267745	757	750	721	43	6	7.166666666666667	714
FBgn0267746	750	750	740	10	5	2	740
FBgn0267747	751	750	734	18	7	2.5714285714285716	733
FBgn0267748	753	750	696	60	4	15	693
FBgn0267751	797	750	794	50	6	8.333333333333334	747
FBgn0267753	751	750	739	13	5	2.6	738
FBgn0267754	757	750	757	7	2	3.5	750
FBgn0267755	750	750	741	9	2	4.5	741
FBgn0267756	750	750	749	1	1	1	749
FBgn0267760	764	750	757	21	3	7	743
FBgn0267761	790	750	790	40	3	13.333333333333334	750
FBgn0267762	753	750	751	5	3	1.6666666666666667	748
FBgn0267763	751	750	686	66	4	16.5	685
FBgn0267765	759	750	751	17	4	4.25	742
FBgn0267766	751	750	724	28	3	9.333333333333334	723
FBgn0267767	762	750	741	33	9	3.6666666666666665	729
FBgn0267768	750	750	750	0	0	NA	750
FBgn0267769	757	750	740	24	7	3.4285714285714284	733
FBgn0267770	750	750	747	3	1	3	747
FBgn0267771	760	750	707	63	9	7	697
FBgn0267773	800	750	791	59	8	7.375	741
FBgn0267774	788	750	761	65	9	7.222222222222222	723
FBgn0267775	751	750	729	23	7	3.2857142857142856	728
FBgn0267776	758	750	754	12	5	2.4	746
FBgn0267778	750	750	750	0	0	NA	750
FBgn0267779	772	750	702	92	9	10.222222222222221	680
FBgn0267782	767	750	744	40	5	8	727
FBgn0267783	751	750	732	20	9	2.2222222222222223	731
FBgn0267785	750	750	716	34	2	17	716
FBgn0267788	760	750	728	42	13	3.230769230769231	718
FBgn0267789	761	750	747	25	6	4.166666666666667	736
FBgn0267790	754	750	713	45	4	11.25	709
FBgn0267791	773	750	762	34	8	4.25	739
FBgn0267792	751	750	492	260	3	86.66666666666667	491
FBgn0267793	751	750	737	15	4	3.75	736
FBgn0267794	783	750	757	59	7	8.428571428571429	724
FBgn0267795	753	750	750	6	3	2	747
FBgn0267796	801	750	795	57	5	11.4	744
FBgn0267803	750	750	750	0	0	NA	750
FBgn0267804	766	721	752	59	10	5.9	707
FBgn0267805	778	750	775	31	8	3.875	747
FBgn0267806	753	750	715	41	6	6.833333333333333	712
FBgn0267807	772	750	767	27	6	4.5	745
FBgn0267809	754	750	743	15	5	3	739
FBgn0267810	794	750	771	67	10	6.7	727
FBgn0267811	771	750	762	30	5	6	741
FBgn0267812	763	750	759	17	5	3.4	746
FBgn0267817	779	750	751	57	7	8.142857142857142	722
FBgn0267819	753	750	753	3	1	3	750
FBgn0267820	765	750	755	25	7	3.5714285714285716	740
FBgn0267821	633	630	273	363	4	90.75	270
FBgn0267823	750	750	750	0	0	NA	750
FBgn0267826	812	750	714	160	15	10.666666666666666	652
FBgn0267827	750	750	728	22	6	3.6666666666666665	728
FBgn0267828	750	750	748	2	1	2	748
FBgn0267849	769	750	749	39	8	4.875	730
FBgn0267865	752	750	745	9	6	1.5	743
FBgn0267868	769	750	708	80	8	10	689
FBgn0267912	803	750	797	59	9	6.555555555555555	744
FBgn0267914	757	750	744	20	5	4	737
FBgn0267915	812	750	759	115	9	12.777777777777779	697
FBgn0267916	757	750	702	62	8	7.75	695
FBgn0267917	759	750	755	13	3	4.333333333333333	746
FBgn0267918	777	750	777	27	4	6.75	750
FBgn0267919	759	750	745	23	9	2.5555555555555554	736
FBgn0267921	785	750	593	227	13	17.46153846153846	558
FBgn0267922	754	750	739	19	8	2.375	735
FBgn0267923	763	750	755	21	8	2.625	742
FBgn0267925	773	750	728	68	8	8.5	705
FBgn0267926	755	750	742	18	6	3	737
FBgn0267927	754	750	740	18	7	2.5714285714285716	736
FBgn0267928	779	750	763	45	8	5.625	734
FBgn0267930	762	750	727	47	7	6.714285714285714	715
FBgn0267932	767	750	748	36	10	3.6	731
FBgn0267933	757	750	757	7	3	2.3333333333333335	750
FBgn0267934	807	750	754	110	9	12.222222222222221	697
FBgn0267935	765	750	734	46	9	5.111111111111111	719
FBgn0267936	756	750	690	72	9	8	684
FBgn0267937	751	750	748	4	2	2	747
FBgn0267938	754	750	721	37	6	6.166666666666667	717
FBgn0267939	751	750	728	24	3	8	727
FBgn0267940	783	750	745	71	10	7.1	712
FBgn0267941	824	750	811	87	11	7.909090909090909	737
FBgn0267945	752	750	707	47	6	7.833333333333333	705
FBgn0267946	751	750	716	36	6	6	715
FBgn0267947	784	750	737	81	14	5.785714285714286	703
FBgn0267948	758	750	719	47	8	5.875	711
FBgn0267950	764	750	742	36	8	4.5	728
FBgn0267952	757	750	743	21	4	5.25	736
FBgn0267953	750	750	750	0	0	NA	750
FBgn0267954	758	750	756	10	5	2	748
FBgn0267956	757	750	724	40	9	4.444444444444445	717
FBgn0267957	752	750	586	168	7	24	584
FBgn0267958	758	750	718	48	5	9.6	710
FBgn0267959	760	750	743	27	5	5.4	733
FBgn0267960	785	750	719	101	16	6.3125	684
FBgn0267961	753	750	729	27	6	4.5	726
FBgn0267962	765	750	709	71	10	7.1	694
FBgn0267963	777	750	665	139	13	10.692307692307692	638
FBgn0267966	754	750	708	50	7	7.142857142857143	704
FBgn0267969	750	750	718	32	7	4.571428571428571	718
FBgn0267970	750	750	737	13	3	4.333333333333333	737
FBgn0267972	754	750	722	36	7	5.142857142857143	718
FBgn0267976	762	750	365	409	12	34.083333333333336	353
FBgn0267977	764	750	744	34	8	4.25	730
FBgn0267978	762	750	727	47	11	4.2727272727272725	715
FBgn0267982	760	750	749	21	5	4.2	739
FBgn0267984	773	750	711	85	9	9.444444444444445	688
FBgn0267988	782	750	741	73	9	8.11111111111111	709
FBgn0267989	756	750	745	17	3	5.666666666666667	739
FBgn0267992	754	750	722	36	6	6	718
FBgn0267993	750	750	710	40	6	6.666666666666667	710
FBgn0267994	779	750	779	29	6	4.833333333333333	750
FBgn0267995	755	750	739	21	4	5.25	734
FBgn0267996	753	750	750	6	3	2	747
FBgn0268063	760	750	740	30	5	6	730
FBgn0270925	753	750	628	128	7	18.285714285714285	625
FBgn0270927	750	750	735	15	5	3	735
FBgn0275432	766	750	763	19	6	3.1666666666666665	747
FBgn0275434	772	750	752	42	8	5.25	730
FBgn0275436	618	566	598	72	7	10.285714285714286	546
FBgn0278597	753	750	752	4	3	1.3333333333333333	749
FBgn0278599	750	750	688	62	6	10.333333333333334	688
FBgn0278600	794	750	794	44	4	11	750
FBgn0278604	750	750	749	1	1	1	749
FBgn0283426	773	750	752	44	10	4.4	729
FBgn0283427	759	750	755	13	4	3.25	746
FBgn0283437	755	750	700	60	8	7.5	695
FBgn0283438	752	750	748	6	3	2	746
FBgn0283451	782	750	780	34	7	4.857142857142857	748
FBgn0283461	811	750	739	133	9	14.777777777777779	678
FBgn0283467	753	750	746	10	6	1.6666666666666667	743
FBgn0283468	760	750	753	17	5	3.4	743
FBgn0283469	789	750	776	52	7	7.428571428571429	737
FBgn0283471	754	750	698	60	14	4.285714285714286	694
FBgn0283472	752	750	751	3	2	1.5	749
FBgn0283476	797	750	788	56	9	6.222222222222222	741
FBgn0283477	753	750	746	10	4	2.5	743
FBgn0283478	750	750	744	6	2	3	744
FBgn0283479	758	750	734	32	7	4.571428571428571	726
FBgn0283480	817	750	787	97	8	12.125	720
FBgn0283499	757	750	426	338	7	48.285714285714285	419
FBgn0283500	750	750	744	6	3	2	744
FBgn0283501	771	750	769	23	6	3.8333333333333335	748
FBgn0283508	770	750	746	44	6	7.333333333333333	726
FBgn0283509	761	750	760	12	3	4	749
FBgn0283521	806	750	700	162	8	20.25	644
FBgn0283525	755	746	722	42	4	10.5	713
FBgn0283531	789	750	735	93	7	13.285714285714286	696
FBgn0283535	761	750	757	15	5	3	746
FBgn0283536	760	750	754	16	9	1.7777777777777777	744
FBgn0283547	770	750	745	45	5	9	725
FBgn0283548	750	750	746	4	3	1.3333333333333333	746
FBgn0283554	789	750	788	40	3	13.333333333333334	749
FBgn0283557	751	750	741	11	3	3.6666666666666665	740
FBgn0283560	762	750	755	19	3	6.333333333333333	743
FBgn0283625	809	750	798	70	9	7.777777777777778	739
FBgn0283626	750	750	106	644	2	322	106
FBgn0283627	822	750	630	264	9	29.333333333333332	558
FBgn0283649	782	750	782	32	3	10.666666666666666	750
FBgn0283651	751	750	746	6	3	2	745
FBgn0283657	751	750	751	1	1	1	750
FBgn0283658	768	750	693	93	12	7.75	675
FBgn0283659	750	750	745	5	3	1.6666666666666667	745
FBgn0283666	764	750	743	35	10	3.5	729
FBgn0283678	750	750	638	112	5	22.4	638
FBgn0283680	763	750	744	32	9	3.5555555555555554	731
FBgn0283681	750	750	750	0	0	NA	750
FBgn0283682	756	750	744	18	4	4.5	738
FBgn0283712	516	506	507	19	8	2.375	497
FBgn0283724	769	750	763	25	6	4.166666666666667	744
FBgn0283728	750	750	742	8	3	2.6666666666666665	742
FBgn0284081	819	750	806	82	14	5.857142857142857	737
FBgn0284084	776	750	775	27	2	13.5	749
FBgn0284220	752	750	703	51	12	4.25	701
FBgn0284243	776	750	526	276	12	23	500
FBgn0284244	750	750	687	63	7	9	687
FBgn0284245	751	750	730	22	4	5.5	729
FBgn0284246	781	750	561	251	9	27.88888888888889	530
FBgn0284247	750	750	749	1	1	1	749
FBgn0284249	754	750	741	17	4	4.25	737
FBgn0284252	796	750	790	52	10	5.2	744
FBgn0284253	752	750	742	12	3	4	740
FBgn0284255	774	750	759	39	13	3	735
FBgn0284256	765	750	708	72	8	9	693
FBgn0284257	769	750	676	112	10	11.2	657
FBgn0284408	751	750	602	150	7	21.428571428571427	601
FBgn0284409	750	750	711	39	3	13	711
FBgn0284410	753	750	749	7	3	2.3333333333333335	746
FBgn0284411	773	750	736	60	9	6.666666666666667	713
FBgn0284412	754	750	714	44	7	6.285714285714286	710
FBgn0284413	773	750	700	96	8	12	677
FBgn0284414	773	750	759	37	7	5.285714285714286	736
FBgn0284415	758	750	731	35	8	4.375	723
FBgn0284416	803	750	787	69	7	9.857142857142858	734
FBgn0284418	759	750	737	31	5	6.2	728
FBgn0284419	751	750	734	18	4	4.5	733
FBgn0284420	756	750	751	11	5	2.2	745
FBgn0284421	759	750	734	34	4	8.5	725
FBgn0284435	550	543	542	15	6	2.5	535
FBgn0284444	757	750	693	71	12	5.916666666666667	686
FBgn0285879	752	750	734	20	7	2.857142857142857	732
FBgn0285892	770	750	747	43	5	8.6	727
FBgn0285917	752	750	750	4	3	1.3333333333333333	748
FBgn0285926	772	750	741	53	11	4.818181818181818	719
FBgn0285940	775	750	748	52	8	6.5	723
FBgn0285941	767	750	742	42	3	14	725
FBgn0285943	758	750	752	14	4	3.5	744
FBgn0285944	778	750	759	47	6	7.833333333333333	731
FBgn0285947	750	750	491	259	5	51.8	491
FBgn0285948	664	639	624	65	8	8.125	599
FBgn0285950	762	750	761	13	2	6.5	749
FBgn0285954	752	750	748	6	4	1.5	746
FBgn0285955	750	750	745	5	2	2.5	745
FBgn0285962	769	750	744	44	8	5.5	725
FBgn0285963	773	750	748	48	11	4.363636363636363	725
FBgn0285971	772	750	770	24	4	6	748
FBgn0286005	752	750	742	12	3	4	740
FBgn0286027	756	750	751	11	4	2.75	745
FBgn0286028	761	750	751	21	4	5.25	740
FBgn0286029	752	750	727	27	8	3.375	725
FBgn0286031	767	750	766	18	4	4.5	749
FBgn0286033	759	750	757	11	3	3.6666666666666665	748
FBgn0286051	795	750	791	49	8	6.125	746
FBgn0286070	750	750	731	19	3	6.333333333333333	731
FBgn0286071	772	750	585	209	8	26.125	563
FBgn0286075	753	750	752	4	2	2	749
FBgn0286198	772	750	761	33	6	5.5	739
FBgn0286203	750	750	657	93	4	23.25	657
FBgn0286204	764	750	717	61	9	6.777777777777778	703
FBgn0286222	765	750	752	28	5	5.6	737
FBgn0286507	735	711	734	25	3	8.333333333333334	710
FBgn0286508	757	750	646	118	14	8.428571428571429	639
FBgn0286516	758	750	742	24	9	2.6666666666666665	734
FBgn0286567	771	750	770	22	5	4.4	749
FBgn0286723	771	750	761	31	8	3.875	740
FBgn0286726	753	750	737	19	3	6.333333333333333	734
FBgn0286728	750	750	746	4	2	2	746
FBgn0286731	775	750	769	31	13	2.3846153846153846	744
FBgn0286732	797	750	792	52	6	8.666666666666666	745
FBgn0286733	806	750	800	62	7	8.857142857142858	744
FBgn0286734	764	750	721	57	10	5.7	707
FBgn0286735	781	750	747	65	9	7.222222222222222	716
FBgn0286740	759	750	738	30	3	10	729
FBgn0286778	586	567	545	60	6	10	526
FBgn0286781	659	646	608	64	11	5.818181818181818	595
FBgn0286782	805	750	755	105	16	6.5625	700
FBgn0286783	735	710	697	63	9	7	672
FBgn0286784	753	750	746	10	4	2.5	743
FBgn0286785	801	750	722	130	11	11.818181818181818	671
FBgn0286786	813	750	795	81	8	10.125	732
FBgn0286813	751	750	749	3	2	1.5	748
FBgn0286827	753	750	696	60	6	10	693
FBgn0286828	756	750	755	7	4	1.75	749
FBgn0286833	751	750	735	17	2	8.5	734
FBgn0286834	776	750	775	27	5	5.4	749
FBgn0286852	788	750	750	76	11	6.909090909090909	712
FBgn0286868	777	750	732	72	10	7.2	705
FBgn0286873	805	750	793	67	13	5.153846153846154	738
FBgn0286874	752	750	745	9	5	1.8	743
FBgn0286875	793	750	773	63	14	4.5	730
FBgn0286880	752	750	700	54	5	10.8	698
FBgn0286881	800	750	711	139	9	15.444444444444445	661
FBgn0286882	752	750	751	3	3	1	749
FBgn0286885	711	711	166	545	2	272.5	166
FBgn0286891	750	750	716	34	4	8.5	716
FBgn0286898	751	750	741	11	3	3.6666666666666665	740
FBgn0286915	750	750	652	98	3	32.666666666666664	652
FBgn0286916	789	750	786	42	7	6	747
FBgn0286918	783	750	699	117	9	13	666
FBgn0286921	820	750	796	94	8	11.75	726
FBgn0286926	757	750	717	47	8	5.875	710
FBgn0286927	781	750	716	96	10	9.6	685
FBgn0286933	766	750	747	35	10	3.5	731
FBgn0287182	785	750	672	148	13	11.384615384615385	637
FBgn0287184	812	750	774	100	13	7.6923076923076925	712
FBgn0287185	791	750	596	236	12	19.666666666666668	555
FBgn0287186	762	750	721	53	8	6.625	709
FBgn0287211	759	750	702	66	9	7.333333333333333	693
FBgn0287213	762	750	756	18	7	2.5714285714285716	744
FBgn0287214	765	750	765	15	2	7.5	750
FBgn0287216	750	750	734	16	2	8	734
FBgn0287218	761	750	754	18	4	4.5	743
FBgn0287225	752	750	745	9	3	3	743
FBgn0287234	753	750	742	14	5	2.8	739
FBgn0287423	757	750	722	42	10	4.2	715
FBgn0287454	780	750	763	47	4	11.75	733
FBgn0287462	752	750	751	3	3	1	749
FBgn0287463	750	750	748	2	1	2	748
FBgn0287464	789	750	762	66	10	6.6	723
FBgn0287465	751	750	743	9	3	3	742
FBgn0287585	773	750	765	31	9	3.4444444444444446	742
FBgn0287587	766	750	764	18	3	6	748
FBgn0287591	771	750	760	32	4	8	739
FBgn0287594	780	750	720	90	8	11.25	690
FBgn0287601	757	750	748	16	5	3.2	741
FBgn0287602	758	750	746	20	6	3.3333333333333335	738
FBgn0287604	783	750	723	93	11	8.454545454545455	690
FBgn0287605	759	750	743	25	5	5	734
FBgn0287609	758	750	742	24	6	4	734
FBgn0287614	752	750	329	425	7	60.714285714285715	327
FBgn0287615	750	750	694	56	9	6.222222222222222	694
FBgn0287616	763	750	613	163	9	18.11111111111111	600
FBgn0287617	757	750	742	22	5	4.4	735
FBgn0287618	769	750	341	447	6	74.5	322
FBgn0287621	755	750	745	15	5	3	740
FBgn0287631	754	750	711	47	8	5.875	707
FBgn0287633	771	750	657	135	13	10.384615384615385	636
FBgn0287645	778	750	748	58	9	6.444444444444445	720
FBgn0287667	751	750	746	6	4	1.5	745
FBgn0287668	780	750	777	33	5	6.6	747
FBgn0287670	751	750	737	15	6	2.5	736
FBgn0287695	769	750	767	21	7	3	748
FBgn0287696	754	750	746	12	5	2.4	742
FBgn0287720	764	750	733	45	11	4.090909090909091	719
FBgn0287767	750	750	163	587	1	587	163
FBgn0287768	760	750	726	44	9	4.888888888888889	716
FBgn0287775	750	750	740	10	3	3.3333333333333335	740
FBgn0287788	750	750	747	3	1	3	747
FBgn0287825	750	750	738	12	2	6	738
FBgn0287828	790	750	751	79	10	7.9	711
FBgn0287844	809	750	794	74	9	8.222222222222221	735
FBgn0287864	752	750	734	20	5	4	732
FBgn0287873	765	750	754	26	6	4.333333333333333	739
FBgn0288433	759	750	756	12	2	6	747
