gene	gapped_len	mel_len	sim_len	gap_num	indel_num	indel_mean_len	ungapped_len
FBgn0000008	1066	1000	1014	118	14	8.428571428571429	948
FBgn0000014	1008	1000	1002	14	6	2.3333333333333335	994
FBgn0000015	1037	1000	1032	42	8	5.25	995
FBgn0000022	1024	1000	1022	26	6	4.333333333333333	998
FBgn0000024	1025	1000	999	51	11	4.636363636363637	974
FBgn0000028	1011	1000	995	27	7	3.857142857142857	984
FBgn0000036	1030	1000	1004	56	8	7	974
FBgn0000037	1004	1000	994	14	5	2.8	990
FBgn0000038	1006	1000	994	18	8	2.25	988
FBgn0000039	1018	1000	1007	29	10	2.9	989
FBgn0000043	1017	1000	368	666	6	111	351
FBgn0000044	1025	1000	994	56	10	5.6	969
FBgn0000046	1010	1000	968	52	9	5.777777777777778	958
FBgn0000047	1082	1000	1070	94	10	9.4	988
FBgn0000052	1019	1000	1005	33	8	4.125	986
FBgn0000053	1029	1000	1014	44	9	4.888888888888889	985
FBgn0000057	1037	1000	1031	43	5	8.6	994
FBgn0000061	1002	1000	994	10	3	3.3333333333333335	992
FBgn0000063	1008	1000	993	23	7	3.2857142857142856	985
FBgn0000064	1009	1000	1005	13	5	2.6	996
FBgn0000071	1054	1000	1032	76	8	9.5	978
FBgn0000077	1002	1000	972	32	7	4.571428571428571	970
FBgn0000079	1020	1000	1015	25	6	4.166666666666667	995
FBgn0000083	1067	1000	1052	82	10	8.2	985
FBgn0000092	1020	1000	981	59	8	7.375	961
FBgn0000094	1064	1000	1054	74	12	6.166666666666667	990
FBgn0000097	1005	1000	995	15	8	1.875	990
FBgn0000100	1038	1000	1028	48	8	6	990
FBgn0000108	1023	1000	990	56	9	6.222222222222222	967
FBgn0000109	1009	1000	967	51	6	8.5	958
FBgn0000114	1015	1000	503	527	6	87.83333333333333	488
FBgn0000115	1002	1000	1002	2	2	1	1000
FBgn0000116	1016	1000	990	42	9	4.666666666666667	974
FBgn0000120	1058	1000	1021	95	10	9.5	963
FBgn0000121	1001	1000	997	5	3	1.6666666666666667	996
FBgn0000137	1001	1000	991	11	3	3.6666666666666665	990
FBgn0000139	1003	1000	1002	4	2	2	999
FBgn0000147	1004	1000	794	214	3	71.33333333333333	790
FBgn0000152	1047	1000	1044	50	7	7.142857142857143	997
FBgn0000153	1026	1000	961	91	8	11.375	935
FBgn0000157	1013	1000	1013	13	3	4.333333333333333	1000
FBgn0000158	1037	1000	962	112	18	6.222222222222222	925
FBgn0000166	1034	1000	950	118	17	6.9411764705882355	916
FBgn0000173	1020	1000	1016	24	6	4	996
FBgn0000179	1026	1000	1013	39	8	4.875	987
FBgn0000180	1028	1000	970	86	14	6.142857142857143	942
FBgn0000183	1004	1000	990	18	5	3.6	986
FBgn0000212	1031	1000	894	168	7	24	863
FBgn0000216	1004	1000	993	15	6	2.5	989
FBgn0000221	1004	1000	1002	6	2	3	998
FBgn0000227	1000	1000	982	18	2	9	982
FBgn0000228	1001	1000	709	293	5	58.6	708
FBgn0000229	1000	1000	1000	0	0	NA	1000
FBgn0000239	1036	1000	1031	41	8	5.125	995
FBgn0000244	1020	1000	980	60	8	7.5	960
FBgn0000246	1018	1000	1002	34	4	8.5	984
FBgn0000247	1023	1000	1022	24	4	6	999
FBgn0000250	1079	1000	1073	85	10	8.5	994
FBgn0000251	1019	1000	939	99	10	9.9	920
FBgn0000256	1009	1000	1000	18	5	3.6	991
FBgn0000257	1001	1000	833	169	8	21.125	832
FBgn0000273	1063	1000	1046	80	7	11.428571428571429	983
FBgn0000274	1018	1000	1017	19	4	4.75	999
FBgn0000278	1031	1000	982	80	14	5.714285714285714	951
FBgn0000279	1018	1000	957	79	8	9.875	939
FBgn0000286	1001	1000	999	3	3	1	998
FBgn0000287	1062	1000	1050	74	12	6.166666666666667	988
FBgn0000289	884	884	883	1	1	1	883
FBgn0000299	1027	1000	692	362	6	60.333333333333336	665
FBgn0000308	1031	1000	975	87	11	7.909090909090909	944
FBgn0000317	1053	1000	1032	74	8	9.25	979
FBgn0000318	1003	1000	927	79	5	15.8	924
FBgn0000320	1079	1000	1048	110	11	10	969
FBgn0000326	967	967	874	93	4	23.25	874
FBgn0000330	1057	1000	1041	73	5	14.6	984
FBgn0000337	1094	1000	1008	180	17	10.588235294117647	914
FBgn0000339	1048	1000	1037	59	6	9.833333333333334	989
FBgn0000352	1013	1000	1000	26	7	3.7142857142857144	987
FBgn0000355	965	953	960	17	5	3.4	948
FBgn0000356	1051	1000	1016	86	7	12.285714285714286	965
FBgn0000357	1006	1000	1004	8	4	2	998
FBgn0000359	1026	1000	973	79	21	3.761904761904762	947
FBgn0000360	1037	1000	1006	68	14	4.857142857142857	969
FBgn0000370	1019	1000	944	94	14	6.714285714285714	925
FBgn0000382	1037	1000	1029	45	9	5	992
FBgn0000394	1000	1000	989	11	3	3.6666666666666665	989
FBgn0000395	1063	1000	999	127	11	11.545454545454545	936
FBgn0000404	1103	1000	985	221	20	11.05	882
FBgn0000405	1014	1000	996	32	8	4	982
FBgn0000406	1022	1000	986	58	8	7.25	964
FBgn0000411	1022	1000	742	302	7	43.142857142857146	720
FBgn0000414	1026	1000	995	57	5	11.4	969
FBgn0000416	1017	1000	996	38	6	6.333333333333333	979
FBgn0000422	1038	1000	907	169	12	14.083333333333334	869
FBgn0000426	1000	1000	996	4	2	2	996
FBgn0000427	1040	1000	984	96	12	8	944
FBgn0000439	1041	1000	1024	58	6	9.666666666666666	983
FBgn0000442	1002	1000	973	31	8	3.875	971
FBgn0000447	977	959	973	22	7	3.142857142857143	955
FBgn0000451	1004	1000	961	47	11	4.2727272727272725	957
FBgn0000455	1000	1000	1000	0	0	NA	1000
FBgn0000459	1018	1000	1018	18	1	18	1000
FBgn0000477	1005	1000	978	32	8	4	973
FBgn0000482	1012	1000	989	35	9	3.888888888888889	977
FBgn0000489	1007	1000	988	26	11	2.3636363636363638	981
FBgn0000490	1010	1000	965	55	8	6.875	955
FBgn0000492	1008	1000	987	29	5	5.8	979
FBgn0000499	1003	1000	945	61	7	8.714285714285714	942
FBgn0000529	1007	1000	999	15	7	2.142857142857143	992
FBgn0000533	1024	1000	988	60	8	7.5	964
FBgn0000536	1007	1000	986	28	8	3.5	979
FBgn0000543	1035	1000	993	77	9	8.555555555555555	958
FBgn0000551	1014	1000	1003	25	5	5	989
FBgn0000552	1053	1000	1043	63	12	5.25	990
FBgn0000560	1007	1000	956	58	8	7.25	949
FBgn0000564	1028	1000	983	73	11	6.636363636363637	955
FBgn0000567	1039	969	1011	98	12	8.166666666666666	941
FBgn0000568	1038	1000	1002	74	12	6.166666666666667	964
FBgn0000575	1013	1000	1003	23	6	3.8333333333333335	990
FBgn0000576	1012	1000	1005	19	3	6.333333333333333	993
FBgn0000577	1001	1000	1001	1	1	1	1000
FBgn0000578	771	725	734	83	13	6.384615384615385	688
FBgn0000579	1007	1000	996	18	6	3	989
FBgn0000581	1006	1000	992	20	7	2.857142857142857	986
FBgn0000591	1003	1000	951	55	3	18.333333333333332	948
FBgn0000606	1000	1000	991	9	3	3	991
FBgn0000611	1038	1000	1017	59	9	6.555555555555555	979
FBgn0000615	1011	1000	1000	22	6	3.6666666666666665	989
FBgn0000617	1019	1000	986	52	9	5.777777777777778	967
FBgn0000618	1001	1000	1000	2	2	1	999
FBgn0000625	1087	1000	1080	94	11	8.545454545454545	993
FBgn0000629	1019	1000	896	142	16	8.875	877
FBgn0000633	1066	1000	1016	116	24	4.833333333333333	950
FBgn0000635	1017	1000	962	72	9	8	945
FBgn0000636	1030	1000	953	107	12	8.916666666666666	923
FBgn0000639	1017	1000	999	35	5	7	982
FBgn0000640	692	683	673	28	4	7	664
FBgn0000644	1015	1000	982	48	16	3	967
FBgn0000662	1024	1000	994	54	9	6	970
FBgn0000709	1018	1000	1003	33	6	5.5	985
FBgn0000715	1002	1000	996	8	5	1.6	994
FBgn0000721	1008	1000	951	65	13	5	943
FBgn0000723	1025	1000	943	107	14	7.642857142857143	918
FBgn0000810	1021	1000	1016	26	5	5.2	995
FBgn0000928	1004	1000	972	36	9	4	968
FBgn0000964	1030	1000	1006	54	19	2.8421052631578947	976
FBgn0000996	1056	1000	1045	67	16	4.1875	989
FBgn0001075	1038	1000	1006	70	15	4.666666666666667	968
FBgn0001077	1000	1000	982	18	4	4.5	982
FBgn0001079	1033	1000	1011	55	8	6.875	978
FBgn0001083	1047	1000	970	124	23	5.391304347826087	923
FBgn0001085	1003	1000	962	44	6	7.333333333333333	959
FBgn0001086	1000	1000	991	9	4	2.25	991
FBgn0001087	851	823	778	101	9	11.222222222222221	750
FBgn0001089	1011	1000	938	84	11	7.636363636363637	927
FBgn0001090	1024	1000	986	62	8	7.75	962
FBgn0001091	1000	1000	978	22	6	3.6666666666666665	978
FBgn0001092	1012	1000	996	28	10	2.8	984
FBgn0001104	1005	1000	909	101	15	6.733333333333333	904
FBgn0001108	1047	1000	995	99	9	11	948
FBgn0001112	1040	1000	1037	43	9	4.777777777777778	997
FBgn0001114	1010	1000	960	60	9	6.666666666666667	950
FBgn0001120	1079	1000	1052	106	15	7.066666666666666	973
FBgn0001122	1044	1000	1006	82	12	6.833333333333333	962
FBgn0001124	1009	1000	1008	10	4	2.5	999
FBgn0001125	1000	1000	989	11	5	2.2	989
FBgn0001128	1016	1000	888	144	12	12	872
FBgn0001133	1000	1000	998	2	2	1	998
FBgn0001134	1015	1000	1009	21	4	5.25	994
FBgn0001138	1000	1000	993	7	3	2.3333333333333335	993
FBgn0001139	896	872	775	145	12	12.083333333333334	751
FBgn0001145	1029	1000	1004	54	12	4.5	975
FBgn0001147	1006	1000	1005	7	3	2.3333333333333335	999
FBgn0001148	1072	1000	1054	90	11	8.181818181818182	982
FBgn0001150	1008	1000	941	75	6	12.5	933
FBgn0001168	1002	1000	945	59	6	9.833333333333334	943
FBgn0001169	1033	1000	1013	53	11	4.818181818181818	980
FBgn0001174	1117	1000	1066	168	16	10.5	949
FBgn0001180	1020	1000	982	58	10	5.8	962
FBgn0001185	1023	1000	1011	35	8	4.375	988
FBgn0001186	1020	1000	982	58	11	5.2727272727272725	962
FBgn0001187	1015	1000	1013	17	5	3.4	998
FBgn0001189	1002	1000	1001	3	2	1.5	999
FBgn0001206	1023	1000	1000	46	8	5.75	977
FBgn0001208	1007	1000	1001	13	3	4.333333333333333	994
FBgn0001215	1000	1000	514	486	2	243	514
FBgn0001216	1019	1000	952	86	11	7.818181818181818	933
FBgn0001222	1015	1000	997	33	15	2.2	982
FBgn0001224	766	762	675	95	5	19	671
FBgn0001225	679	674	673	11	6	1.8333333333333333	668
FBgn0001226	1018	1000	988	48	11	4.363636363636363	970
FBgn0001227	1001	1000	924	78	8	9.75	923
FBgn0001228	1003	1000	1003	3	1	3	1000
FBgn0001229	1004	1000	961	47	8	5.875	957
FBgn0001230	1021	1000	959	83	12	6.916666666666667	938
FBgn0001235	1012	1000	1000	24	6	4	988
FBgn0001247	1010	1000	971	49	7	7	961
FBgn0001248	1015	1000	1004	26	7	3.7142857142857144	989
FBgn0001250	1013	1000	955	71	8	8.875	942
FBgn0001253	1010	1000	934	86	7	12.285714285714286	924
FBgn0001254	1045	1000	987	103	12	8.583333333333334	942
FBgn0001256	1000	1000	969	31	5	6.2	969
FBgn0001257	1014	1000	1010	18	6	3	996
FBgn0001259	1014	1000	978	50	9	5.555555555555555	964
FBgn0001269	1001	1000	623	379	2	189.5	622
FBgn0001276	1012	1000	989	35	9	3.888888888888889	977
FBgn0001280	1000	1000	999	1	1	1	999
FBgn0001291	1008	1000	989	27	9	3	981
FBgn0001297	1044	1000	963	125	12	10.416666666666666	919
FBgn0001301	1120	1000	1068	172	14	12.285714285714286	948
FBgn0001308	1000	1000	999	1	1	1	999
FBgn0001311	1059	1000	1056	62	12	5.166666666666667	997
FBgn0001316	1044	1000	1036	52	9	5.777777777777778	992
FBgn0001319	1042	1000	1000	84	9	9.333333333333334	958
FBgn0001320	1015	1000	992	38	10	3.8	977
FBgn0001321	1007	1000	968	46	12	3.8333333333333335	961
FBgn0001323	1009	1000	986	32	5	6.4	977
FBgn0001325	1002	1000	999	5	2	2.5	997
FBgn0001330	1044	1000	1032	56	9	6.222222222222222	988
FBgn0001404	875	873	818	59	12	4.916666666666667	816
FBgn0001491	1015	1000	1004	26	6	4.333333333333333	989
FBgn0001612	1034	1000	994	74	15	4.933333333333334	960
FBgn0001624	821	784	795	63	9	7	758
FBgn0001941	1039	1000	990	88	16	5.5	951
FBgn0001942	1031	1000	978	84	10	8.4	947
FBgn0001961	1006	1000	981	31	7	4.428571428571429	975
FBgn0001965	1004	1000	499	509	5	101.8	495
FBgn0001967	1018	1000	962	74	15	4.933333333333334	944
FBgn0001970	1043	1000	970	116	16	7.25	927
FBgn0001977	1001	1000	972	30	6	5	971
FBgn0001983	1008	1000	1003	13	5	2.6	995
FBgn0001987	1050	1000	850	250	19	13.157894736842104	800
FBgn0001991	1075	1000	1049	101	13	7.769230769230769	974
FBgn0001992	1024	1000	997	51	12	4.25	973
FBgn0001994	1029	1000	1014	44	10	4.4	985
FBgn0001995	1070	1000	1036	104	18	5.777777777777778	966
FBgn0002022	754	739	747	22	9	2.4444444444444446	732
FBgn0002023	1000	1000	786	214	2	107	786
FBgn0002044	1020	1000	978	62	7	8.857142857142858	958
FBgn0002174	1023	1000	1002	44	8	5.5	979
FBgn0002283	721	674	701	67	8	8.375	654
FBgn0002306	1056	1000	1006	106	17	6.235294117647059	950
FBgn0002354	1002	1000	997	7	4	1.75	995
FBgn0002413	1045	1000	1012	78	17	4.588235294117647	967
FBgn0002431	968	954	924	58	9	6.444444444444445	910
FBgn0002440	1032	1000	1029	35	4	8.75	997
FBgn0002441	1002	1000	999	5	4	1.25	997
FBgn0002524	1011	1000	974	48	6	8	963
FBgn0002525	1006	1000	999	13	4	3.25	993
FBgn0002526	1034	1000	971	97	10	9.7	937
FBgn0002531	1076	1000	1043	109	15	7.266666666666667	967
FBgn0002542	1005	1000	962	48	3	16	957
FBgn0002552	1025	1000	1017	33	5	6.6	992
FBgn0002561	1014	1000	1008	20	7	2.857142857142857	994
FBgn0002562	1042	1000	1000	84	13	6.461538461538462	958
FBgn0002563	1003	1000	943	63	8	7.875	940
FBgn0002564	1047	1000	612	482	3	160.66666666666666	565
FBgn0002565	1008	989	952	75	6	12.5	933
FBgn0002570	1049	1000	931	167	12	13.916666666666666	882
FBgn0002571	1003	1000	988	18	5	3.6	985
FBgn0002573	1027	1000	985	69	9	7.666666666666667	958
FBgn0002576	1020	1000	993	47	5	9.4	973
FBgn0002579	1015	1000	1014	16	4	4	999
FBgn0002593	1000	1000	997	3	3	1	997
FBgn0002626	1007	1000	997	17	7	2.4285714285714284	990
FBgn0002629	1001	1000	1000	2	2	1	999
FBgn0002631	1000	1000	965	35	2	17.5	965
FBgn0002632	1008	1000	1005	11	5	2.2	997
FBgn0002638	996	996	974	22	4	5.5	974
FBgn0002641	1047	1000	1042	52	5	10.4	995
FBgn0002643	1031	1000	1012	50	10	5	981
FBgn0002673	1042	1000	1005	79	8	9.875	963
FBgn0002715	1008	1000	1006	10	3	3.3333333333333335	998
FBgn0002732	1000	1000	1000	0	0	NA	1000
FBgn0002734	1009	1000	949	69	9	7.666666666666667	940
FBgn0002735	1000	1000	966	34	3	11.333333333333334	966
FBgn0002736	1006	1000	998	14	4	3.5	992
FBgn0002772	1043	1000	1033	53	12	4.416666666666667	990
FBgn0002773	1007	1000	977	37	4	9.25	970
FBgn0002775	1012	1000	1011	13	3	4.333333333333333	999
FBgn0002778	679	675	677	6	4	1.5	673
FBgn0002780	1037	1000	898	176	3	58.666666666666664	861
FBgn0002783	1009	1000	1001	17	6	2.8333333333333335	992
FBgn0002787	1003	1000	1000	6	2	3	997
FBgn0002789	1104	1000	1086	122	18	6.777777777777778	982
FBgn0002842	1005	1000	929	81	9	9	924
FBgn0002862	1008	1000	904	112	10	11.2	896
FBgn0002863	770	756	753	31	8	3.875	739
FBgn0002865	1001	1000	984	18	6	3	983
FBgn0002868	1013	1000	1011	15	6	2.5	998
FBgn0002872	1000	1000	981	19	3	6.333333333333333	981
FBgn0002878	1033	1000	1027	39	5	7.8	994
FBgn0002899	1019	1000	993	45	10	4.5	974
FBgn0002901	1041	1000	1010	72	3	24	969
FBgn0002905	1003	1000	743	263	13	20.23076923076923	740
FBgn0002906	1035	1000	1029	41	4	10.25	994
FBgn0002917	1012	1000	1000	24	6	4	988
FBgn0002922	1024	1000	954	94	16	5.875	930
FBgn0002924	1002	1000	1001	3	2	1.5	999
FBgn0002926	1026	1000	973	79	12	6.583333333333333	947
FBgn0002930	1000	1000	993	7	1	7	993
FBgn0002932	1002	1000	1000	4	4	1	998
FBgn0002937	1059	1000	1017	101	18	5.611111111111111	958
FBgn0002939	1063	1000	1053	73	9	8.11111111111111	990
FBgn0002940	1013	1000	993	33	8	4.125	980
FBgn0002941	1004	1000	957	51	7	7.285714285714286	953
FBgn0002962	1017	1000	1015	19	5	3.8	998
FBgn0002985	1000	1000	968	32	4	8	968
FBgn0002989	1002	1000	987	17	6	2.8333333333333335	985
FBgn0003008	1002	1000	998	6	5	1.2	996
FBgn0003009	1033	1000	1006	60	11	5.454545454545454	973
FBgn0003011	1003	1000	957	49	6	8.166666666666666	954
FBgn0003015	1008	1000	951	65	12	5.416666666666667	943
FBgn0003016	1064	1000	485	643	12	53.583333333333336	421
FBgn0003028	1042	1000	1035	49	12	4.083333333333333	993
FBgn0003034	1009	1000	989	29	10	2.9	980
FBgn0003041	1045	1000	1013	77	7	11	968
FBgn0003044	1015	1000	997	33	15	2.2	982
FBgn0003046	1014	1000	997	31	8	3.875	983
FBgn0003053	1049	1000	983	115	9	12.777777777777779	934
FBgn0003057	1023	1000	1005	41	6	6.833333333333333	982
FBgn0003060	1018	1000	995	41	9	4.555555555555555	977
FBgn0003062	1005	1000	955	55	8	6.875	950
FBgn0003065	1012	1000	987	37	6	6.166666666666667	975
FBgn0003068	1020	1000	952	88	12	7.333333333333333	932
FBgn0003071	1004	1000	999	9	5	1.8	995
FBgn0003074	1025	1000	1022	28	3	9.333333333333334	997
FBgn0003076	1061	1000	1043	79	10	7.9	982
FBgn0003079	1078	1000	983	173	20	8.65	905
FBgn0003082	1069	1000	1059	79	9	8.777777777777779	990
FBgn0003087	1000	1000	989	11	3	3.6666666666666665	989
FBgn0003089	1029	1000	1019	39	8	4.875	990
FBgn0003091	1045	1000	1034	56	11	5.090909090909091	989
FBgn0003093	1000	1000	999	1	1	1	999
FBgn0003114	1001	1000	1000	2	2	1	999
FBgn0003117	1003	1000	976	30	7	4.285714285714286	973
FBgn0003118	1010	1000	938	82	11	7.454545454545454	928
FBgn0003124	837	827	800	47	10	4.7	790
FBgn0003129	1016	1000	1011	21	6	3.5	995
FBgn0003130	1023	1000	994	52	9	5.777777777777778	971
FBgn0003137	1005	1000	982	28	6	4.666666666666667	977
FBgn0003139	1016	1000	934	98	11	8.909090909090908	918
FBgn0003140	1006	1000	970	42	7	6	964
FBgn0003141	1000	1000	1000	0	0	NA	1000
FBgn0003145	1039	1000	990	88	13	6.769230769230769	951
FBgn0003149	1016	1000	1007	25	6	4.166666666666667	991
FBgn0003159	1040	1000	1001	79	15	5.266666666666667	961
FBgn0003162	1028	1000	973	83	9	9.222222222222221	945
FBgn0003165	837	836	787	51	10	5.1	786
FBgn0003169	1017	1000	1016	18	5	3.6	999
FBgn0003175	1029	1000	1008	50	12	4.166666666666667	979
FBgn0003187	888	878	807	91	14	6.5	797
FBgn0003189	1024	1000	1017	31	8	3.875	993
FBgn0003204	1048	1000	1033	63	8	7.875	985
FBgn0003205	1000	1000	1000	0	0	NA	1000
FBgn0003206	1000	1000	1000	0	0	NA	1000
FBgn0003209	1047	1000	773	321	11	29.181818181818183	726
FBgn0003231	1018	1000	368	668	5	133.6	350
FBgn0003249	1038	1000	963	113	9	12.555555555555555	925
FBgn0003250	1022	1000	1021	23	4	5.75	999
FBgn0003254	1047	1000	1029	65	8	8.125	982
FBgn0003255	1028	1000	992	64	14	4.571428571428571	964
FBgn0003256	1002	1000	287	717	4	179.25	285
FBgn0003257	1020	1000	991	49	9	5.444444444444445	971
FBgn0003261	1081	1000	785	377	21	17.952380952380953	704
FBgn0003267	1003	1000	979	27	7	3.857142857142857	976
FBgn0003268	1001	1000	1000	2	2	1	999
FBgn0003274	1036	1000	1005	67	10	6.7	969
FBgn0003279	1027	1000	998	56	10	5.6	971
FBgn0003285	1013	1000	977	49	12	4.083333333333333	964
FBgn0003292	1014	1000	977	51	12	4.25	963
FBgn0003295	1035	1000	940	130	15	8.666666666666666	905
FBgn0003300	1013	1000	963	63	8	7.875	950
FBgn0003301	1007	1000	991	23	8	2.875	984
FBgn0003310	1000	1000	1000	0	0	NA	1000
FBgn0003312	1041	1000	1028	54	10	5.4	987
FBgn0003317	1006	1000	979	33	8	4.125	973
FBgn0003319	1010	1000	950	70	8	8.75	940
FBgn0003321	1021	1000	1019	23	4	5.75	998
FBgn0003326	1009	1000	944	74	10	7.4	935
FBgn0003330	1031	1000	1025	37	7	5.285714285714286	994
FBgn0003334	1062	1000	858	266	11	24.181818181818183	796
FBgn0003339	1021	1000	1020	22	5	4.4	999
FBgn0003346	1042	1000	1014	70	14	5	972
FBgn0003353	1006	1000	989	23	8	2.875	983
FBgn0003356	729	683	664	111	13	8.538461538461538	618
FBgn0003357	1006	1000	997	15	4	3.75	991
FBgn0003360	1000	1000	361	639	3	213	361
FBgn0003366	1037	1000	975	99	18	5.5	938
FBgn0003372	1047	1000	994	100	11	9.090909090909092	947
FBgn0003377	1019	957	999	82	12	6.833333333333333	937
FBgn0003378	998	928	991	77	11	7	921
FBgn0003380	1008	1000	998	18	7	2.5714285714285716	990
FBgn0003382	1014	1000	983	45	9	5	969
FBgn0003388	1014	1000	992	36	10	3.6	978
FBgn0003390	1027	1000	920	134	21	6.380952380952381	893
FBgn0003391	1003	1000	960	46	7	6.571428571428571	957
FBgn0003396	1054	1000	917	191	15	12.733333333333333	863
FBgn0003410	1042	1000	1029	55	9	6.111111111111111	987
FBgn0003411	1021	1000	964	78	15	5.2	943
FBgn0003415	1007	1000	973	41	6	6.833333333333333	966
FBgn0003429	1004	1000	999	9	3	3	995
FBgn0003430	1019	1000	1014	24	5	4.8	995
FBgn0003435	1028	1000	1014	42	7	6	986
FBgn0003444	1010	1000	984	36	7	5.142857142857143	974
FBgn0003447	1000	1000	990	10	3	3.3333333333333335	990
FBgn0003448	1034	1000	897	171	8	21.375	863
FBgn0003449	1023	1000	1022	24	5	4.8	999
FBgn0003450	1003	1000	970	36	8	4.5	967
FBgn0003460	1032	1000	986	78	11	7.090909090909091	954
FBgn0003462	1022	1000	994	50	12	4.166666666666667	972
FBgn0003463	1054	1000	1002	106	14	7.571428571428571	948
FBgn0003464	1030	1000	1027	33	8	4.125	997
FBgn0003479	1025	1000	998	52	7	7.428571428571429	973
FBgn0003483	1006	1000	965	47	8	5.875	959
FBgn0003495	1052	1000	954	150	19	7.894736842105263	902
FBgn0003499	1043	1000	1023	63	6	10.5	980
FBgn0003507	1122	1000	1067	177	16	11.0625	945
FBgn0003512	1014	1000	986	42	6	7	972
FBgn0003513	1002	1000	1002	2	2	1	1000
FBgn0003514	1014	1000	979	49	8	6.125	965
FBgn0003515	1085	1000	1064	106	12	8.833333333333334	979
FBgn0003517	1023	1000	1005	41	10	4.1	982
FBgn0003520	1011	1000	1010	12	4	3	999
FBgn0003525	1020	1000	980	60	10	6	960
FBgn0003545	1051	1000	1050	52	7	7.428571428571429	999
FBgn0003557	1000	1000	981	19	4	4.75	981
FBgn0003567	1023	1000	1019	27	7	3.857142857142857	996
FBgn0003575	1000	1000	973	27	3	9	973
FBgn0003598	1000	1000	975	25	5	5	975
FBgn0003607	997	996	979	19	4	4.75	978
FBgn0003654	1012	1000	636	388	20	19.4	624
FBgn0003655	1002	1000	981	23	5	4.6	979
FBgn0003660	1059	1000	1050	68	10	6.8	991
FBgn0003701	1000	1000	797	203	6	33.833333333333336	797
FBgn0003714	1001	1000	993	9	5	1.8	992
FBgn0003716	1011	1000	1007	15	6	2.5	996
FBgn0003719	1016	1000	984	48	7	6.857142857142857	968
FBgn0003720	1000	1000	608	392	2	196	608
FBgn0003721	1000	1000	998	2	1	2	998
FBgn0003733	1083	1000	1071	95	11	8.636363636363637	988
FBgn0003744	1000	1000	968	32	4	8	968
FBgn0003747	1038	1000	1019	57	15	3.8	981
FBgn0003748	1016	1000	891	141	14	10.071428571428571	875
FBgn0003861	1048	1000	985	111	11	10.090909090909092	937
FBgn0003862	1002	1000	943	61	6	10.166666666666666	941
FBgn0003866	1007	1000	858	156	7	22.285714285714285	851
FBgn0003867	1032	1000	1032	32	4	8	1000
FBgn0003870	1000	1000	978	22	2	11	978
FBgn0003885	1086	1000	1043	129	19	6.7894736842105265	957
FBgn0003886	1037	1000	1003	71	12	5.916666666666667	966
FBgn0003888	1013	1000	968	58	11	5.2727272727272725	955
FBgn0003890	1021	1000	987	55	17	3.235294117647059	966
FBgn0003892	1033	1000	995	71	14	5.071428571428571	962
FBgn0003896	1001	1000	965	37	6	6.166666666666667	964
FBgn0003936	1010	1000	973	47	10	4.7	963
FBgn0003938	1006	1000	970	42	8	5.25	964
FBgn0003941	1019	1000	957	81	14	5.785714285714286	938
FBgn0003943	1001	1000	998	4	3	1.3333333333333333	997
FBgn0003950	1015	1000	715	315	11	28.636363636363637	700
FBgn0003965	1053	1000	1021	85	12	7.083333333333333	968
FBgn0003969	1022	1000	992	52	10	5.2	970
FBgn0003975	1013	1000	1008	18	6	3	995
FBgn0003977	1014	1000	984	44	9	4.888888888888889	970
FBgn0003978	1016	1000	978	54	11	4.909090909090909	962
FBgn0003979	1000	1000	374	626	1	626	374
FBgn0003983	1017	1000	989	45	9	5	972
FBgn0003984	1076	1000	1059	93	8	11.625	983
FBgn0003997	1030	1000	971	89	11	8.090909090909092	941
FBgn0004003	1013	1000	974	52	6	8.666666666666666	961
FBgn0004034	1014	1000	977	51	8	6.375	963
FBgn0004045	1015	1000	980	50	10	5	965
FBgn0004047	1080	1000	971	189	29	6.517241379310345	891
FBgn0004049	1015	1000	988	42	7	6	973
FBgn0004050	1003	1000	1001	5	3	1.6666666666666667	998
FBgn0004052	1041	1000	1035	47	8	5.875	994
FBgn0004053	1002	1000	904	100	7	14.285714285714286	902
FBgn0004054	1076	1000	1020	132	12	11	944
FBgn0004055	1065	1000	1042	88	10	8.8	977
FBgn0004066	1015	1000	995	35	9	3.888888888888889	980
FBgn0004101	1050	1000	1044	56	6	9.333333333333334	994
FBgn0004102	1013	1000	1003	23	5	4.6	990
FBgn0004103	1033	1000	1026	40	7	5.714285714285714	993
FBgn0004106	1033	1000	1012	54	11	4.909090909090909	979
FBgn0004108	1000	1000	982	18	4	4.5	982
FBgn0004110	1043	1000	838	248	9	27.555555555555557	795
FBgn0004117	1009	1000	973	45	13	3.4615384615384617	964
FBgn0004132	1032	1000	1028	36	4	9	996
FBgn0004133	1021	1000	994	48	10	4.8	973
FBgn0004143	1073	1000	1036	110	17	6.470588235294118	963
FBgn0004168	1035	1000	993	77	12	6.416666666666667	958
FBgn0004169	1018	1000	1010	26	10	2.6	992
FBgn0004170	1014	1000	1013	15	5	3	999
FBgn0004172	1008	1000	721	295	6	49.166666666666664	713
FBgn0004173	679	675	640	43	8	5.375	636
FBgn0004177	1001	1000	795	207	7	29.571428571428573	794
FBgn0004185	1007	1000	992	22	9	2.4444444444444446	985
FBgn0004192	1020	1000	949	91	13	7	929
FBgn0004197	1001	1000	986	16	4	4	985
FBgn0004198	1046	1000	1042	50	7	7.142857142857143	996
FBgn0004228	727	725	691	38	5	7.6	689
FBgn0004237	1071	1000	936	206	13	15.846153846153847	865
FBgn0004242	1048	1000	923	173	15	11.533333333333333	875
FBgn0004244	1012	1000	1003	21	7	3	991
FBgn0004359	1001	1000	985	17	5	3.4	984
FBgn0004360	1041	1000	1024	58	10	5.8	983
FBgn0004362	1019	1000	917	121	15	8.066666666666666	898
FBgn0004363	1001	1000	974	28	6	4.666666666666667	973
FBgn0004367	1005	1000	996	14	5	2.8	991
FBgn0004368	1052	1000	1045	59	7	8.428571428571429	993
FBgn0004369	1038	1000	1027	49	10	4.9	989
FBgn0004372	1059	1000	1031	87	13	6.6923076923076925	972
FBgn0004373	1009	1000	962	56	10	5.6	953
FBgn0004374	1001	1000	983	19	3	6.333333333333333	982
FBgn0004379	1003	1000	1003	3	3	1	1000
FBgn0004380	1037	1000	1000	74	18	4.111111111111111	963
FBgn0004389	1020	1000	979	61	9	6.777777777777778	959
FBgn0004390	1011	1000	985	37	11	3.3636363636363638	974
FBgn0004391	1004	1000	1004	4	2	2	1000
FBgn0004394	1037	1000	913	161	13	12.384615384615385	876
FBgn0004396	1075	1000	1068	82	11	7.454545454545454	993
FBgn0004397	1017	1000	1007	27	7	3.857142857142857	990
FBgn0004403	1016	1000	1013	19	4	4.75	997
FBgn0004414	1000	1000	994	6	1	6	994
FBgn0004419	1101	1000	1044	158	20	7.9	943
FBgn0004427	1018	1000	1006	30	7	4.285714285714286	988
FBgn0004431	1003	1000	325	681	4	170.25	322
FBgn0004432	1107	1000	1080	134	15	8.933333333333334	973
FBgn0004449	1038	1000	828	248	10	24.8	790
FBgn0004507	1027	1000	1003	51	10	5.1	976
FBgn0004509	1034	1000	1031	37	5	7.4	997
FBgn0004510	1031	1000	988	74	6	12.333333333333334	957
FBgn0004511	1024	1000	949	99	9	11	925
FBgn0004512	1019	1000	938	100	16	6.25	919
FBgn0004513	892	891	891	2	2	1	890
FBgn0004514	1071	1000	1053	89	13	6.846153846153846	982
FBgn0004516	1024	1000	1007	41	13	3.1538461538461537	983
FBgn0004552	1001	1000	992	10	5	2	991
FBgn0004554	1054	1000	1036	72	11	6.545454545454546	982
FBgn0004567	1001	1000	985	17	7	2.4285714285714284	984
FBgn0004569	1067	1000	997	137	9	15.222222222222221	930
FBgn0004574	1000	1000	999	1	1	1	999
FBgn0004575	1036	1000	1011	61	8	7.625	975
FBgn0004577	1011	1000	971	51	8	6.375	960
FBgn0004580	1002	1000	1001	3	2	1.5	999
FBgn0004581	709	696	689	33	9	3.6666666666666665	676
FBgn0004583	1061	1000	1049	73	8	9.125	988
FBgn0004584	1024	1000	1002	46	7	6.571428571428571	978
FBgn0004587	1084	1000	1017	151	16	9.4375	933
FBgn0004588	1017	1000	999	35	7	5	982
FBgn0004589	857	842	850	22	9	2.4444444444444446	835
FBgn0004590	1006	1000	963	49	8	6.125	957
FBgn0004591	1000	1000	957	43	4	10.75	957
FBgn0004592	738	734	738	4	2	2	734
FBgn0004593	1043	1000	947	139	11	12.636363636363637	904
FBgn0004594	1070	1000	1010	130	14	9.285714285714286	940
FBgn0004595	1009	1000	986	32	6	5.333333333333333	977
FBgn0004597	1003	1000	1000	6	4	1.5	997
FBgn0004598	1004	1000	1004	4	1	4	1000
FBgn0004606	1004	1000	990	18	9	2	986
FBgn0004607	1044	1000	936	152	10	15.2	892
FBgn0004611	1034	1000	1016	52	7	7.428571428571429	982
FBgn0004618	1055	1000	980	130	15	8.666666666666666	925
FBgn0004619	1028	1000	1023	33	4	8.25	995
FBgn0004623	1009	1000	979	39	6	6.5	970
FBgn0004635	1042	1000	957	127	16	7.9375	915
FBgn0004638	1024	1000	1024	24	1	24	1000
FBgn0004643	1034	1000	1004	64	13	4.923076923076923	970
FBgn0004644	1022	1000	993	51	12	4.25	971
FBgn0004647	1044	1000	923	165	19	8.68421052631579	879
FBgn0004649	1025	1000	962	88	7	12.571428571428571	937
FBgn0004650	1011	1000	1005	17	6	2.8333333333333335	994
FBgn0004652	1022	1000	1000	44	10	4.4	978
FBgn0004656	1005	1000	1003	7	6	1.1666666666666667	998
FBgn0004657	1003	1000	996	10	5	2	993
FBgn0004666	1025	1000	950	100	17	5.882352941176471	925
FBgn0004687	1001	1000	1000	2	2	1	999
FBgn0004698	1028	1000	1012	44	8	5.5	984
FBgn0004781	1044	1000	1007	81	10	8.1	963
FBgn0004782	1112	1000	1101	123	13	9.461538461538462	989
FBgn0004783	1112	1000	1101	123	13	9.461538461538462	989
FBgn0004784	1044	1000	991	97	10	9.7	947
FBgn0004795	1017	1000	1003	31	7	4.428571428571429	986
FBgn0004797	891	866	873	43	7	6.142857142857143	848
FBgn0004811	1024	1000	993	55	11	5	969
FBgn0004832	1004	1000	1002	6	2	3	998
FBgn0004837	1001	1000	987	15	4	3.75	986
FBgn0004838	1005	1000	979	31	11	2.8181818181818183	974
FBgn0004839	1051	1000	1022	80	13	6.153846153846154	971
FBgn0004841	1034	1000	954	114	14	8.142857142857142	920
FBgn0004842	761	748	729	45	5	9	716
FBgn0004852	1029	1000	950	108	9	12	921
FBgn0004854	1006	1000	956	56	3	18.666666666666668	950
FBgn0004855	1020	1000	1017	23	5	4.6	997
FBgn0004858	1011	1000	1004	18	8	2.25	993
FBgn0004859	1046	1000	899	193	14	13.785714285714286	853
FBgn0004862	1111	1000	1103	119	12	9.916666666666666	992
FBgn0004863	1003	1000	1001	5	3	1.6666666666666667	998
FBgn0004864	1006	1000	966	46	6	7.666666666666667	960
FBgn0004865	1005	1000	993	17	4	4.25	988
FBgn0004868	1023	1000	1015	31	10	3.1	992
FBgn0004870	1023	1000	986	60	7	8.571428571428571	963
FBgn0004872	1002	1000	751	253	3	84.33333333333333	749
FBgn0004875	722	679	668	97	8	12.125	625
FBgn0004878	1029	1000	1019	39	10	3.9	990
FBgn0004880	1000	1000	998	2	2	1	998
FBgn0004882	1007	1000	992	22	6	3.6666666666666665	985
FBgn0004885	1003	1000	989	17	5	3.4	986
FBgn0004889	1024	997	886	165	15	11	859
FBgn0004892	1008	1000	955	61	4	15.25	947
FBgn0004893	1011	1000	990	32	7	4.571428571428571	979
FBgn0004895	1026	1000	1011	41	9	4.555555555555555	985
FBgn0004896	1003	1000	974	32	9	3.5555555555555554	971
FBgn0004897	1069	1000	1043	95	12	7.916666666666667	974
FBgn0004898	1005	1000	984	26	8	3.25	979
FBgn0004901	763	708	755	63	8	7.875	700
FBgn0004903	1040	1000	1031	49	7	7	991
FBgn0004907	1000	1000	1000	0	0	NA	1000
FBgn0004908	1009	1000	761	257	5	51.4	752
FBgn0004910	1030	1000	1011	49	5	9.8	981
FBgn0004911	1014	1000	945	83	14	5.928571428571429	931
FBgn0004913	1002	1000	423	581	8	72.625	421
FBgn0004914	874	823	870	55	5	11	819
FBgn0004915	1011	1000	1011	11	3	3.6666666666666665	1000
FBgn0004921	832	828	827	9	4	2.25	823
FBgn0004924	1035	1000	1023	47	9	5.222222222222222	988
FBgn0004926	907	899	832	83	13	6.384615384615385	824
FBgn0004956	1022	1000	1001	43	7	6.142857142857143	979
FBgn0004957	1001	1000	997	5	3	1.6666666666666667	996
FBgn0004959	1037	1000	1034	40	7	5.714285714285714	997
FBgn0005198	1027	1000	972	82	16	5.125	945
FBgn0005278	1004	1000	993	15	3	5	989
FBgn0005390	1012	1000	998	26	6	4.333333333333333	986
FBgn0005391	1011	1000	980	42	9	4.666666666666667	969
FBgn0005411	1004	1000	917	91	5	18.2	913
FBgn0005533	1049	1000	1035	63	8	7.875	986
FBgn0005558	1056	1000	984	128	16	8	928
FBgn0005564	956	905	945	62	8	7.75	894
FBgn0005585	1000	1000	996	4	2	2	996
FBgn0005590	1014	1000	983	45	7	6.428571428571429	969
FBgn0005596	1001	1000	984	18	3	6	983
FBgn0005612	1013	1000	1001	25	9	2.7777777777777777	988
FBgn0005613	1023	1000	1010	36	9	4	987
FBgn0005614	1005	1000	948	62	10	6.2	943
FBgn0005616	1000	1000	983	17	2	8.5	983
FBgn0005619	1045	1000	1038	52	6	8.666666666666666	993
FBgn0005624	1002	1000	933	71	5	14.2	931
FBgn0005626	1024	1000	1010	38	4	9.5	986
FBgn0005632	1020	1000	1002	38	9	4.222222222222222	982
FBgn0005636	1018	1000	1015	21	4	5.25	997
FBgn0005640	1052	1000	1026	78	14	5.571428571428571	974
FBgn0005642	1020	1000	950	90	8	11.25	930
FBgn0005649	1010	993	1008	19	4	4.75	991
FBgn0005659	1038	1000	983	93	15	6.2	945
FBgn0005660	1092	1000	1027	157	17	9.235294117647058	935
FBgn0005664	1028	1000	1003	53	8	6.625	975
FBgn0005670	1022	1000	936	108	13	8.307692307692308	914
FBgn0005671	1000	1000	966	34	5	6.8	966
FBgn0005672	1016	1000	989	43	7	6.142857142857143	973
FBgn0005674	1023	1000	995	51	6	8.5	972
FBgn0005677	1007	1000	1005	9	3	3	998
FBgn0005683	1073	1000	1066	80	12	6.666666666666667	993
FBgn0005695	1035	1000	1021	49	9	5.444444444444445	986
FBgn0005696	1002	1000	920	84	10	8.4	918
FBgn0005771	1006	1000	1005	7	4	1.75	999
FBgn0005775	1037	1000	1033	41	5	8.2	996
FBgn0005777	1032	1000	1031	33	8	4.125	999
FBgn0005778	1012	1000	1009	15	4	3.75	997
FBgn0005779	1026	1000	676	376	9	41.77777777777778	650
FBgn0008635	1061	1000	1018	104	18	5.777777777777778	957
FBgn0008636	1015	1000	928	102	8	12.75	913
FBgn0008646	1015	1000	994	36	7	5.142857142857143	979
FBgn0010015	1009	1000	959	59	13	4.538461538461538	950
FBgn0010041	946	932	294	666	8	83.25	280
FBgn0010042	729	713	285	460	4	115	269
FBgn0010043	686	680	334	358	4	89.5	328
FBgn0010044	847	787	789	118	17	6.9411764705882355	729
FBgn0010051	1048	1000	976	120	14	8.571428571428571	928
FBgn0010052	765	719	736	75	10	7.5	690
FBgn0010053	818	818	801	17	5	3.4	801
FBgn0010078	1039	1000	1007	71	9	7.888888888888889	968
FBgn0010097	1002	1000	994	10	7	1.4285714285714286	992
FBgn0010105	1008	1000	1006	10	7	1.4285714285714286	998
FBgn0010109	1013	1000	967	59	11	5.363636363636363	954
FBgn0010113	1014	1000	985	43	9	4.777777777777778	971
FBgn0010173	1064	1000	1034	94	12	7.833333333333333	970
FBgn0010197	1019	1000	1011	27	9	3	992
FBgn0010198	1001	1000	719	283	5	56.6	718
FBgn0010213	1005	1000	989	21	5	4.2	984
FBgn0010217	1008	1000	911	105	8	13.125	903
FBgn0010220	1001	1000	978	24	7	3.4285714285714284	977
FBgn0010222	1001	1000	990	12	3	4	989
FBgn0010223	1005	1000	969	41	9	4.555555555555555	964
FBgn0010226	1011	1000	979	43	10	4.3	968
FBgn0010235	1004	1000	1003	5	4	1.25	999
FBgn0010238	1008	1000	1001	15	6	2.5	993
FBgn0010241	996	971	979	42	11	3.8181818181818183	954
FBgn0010263	1004	1000	992	16	6	2.6666666666666665	988
FBgn0010265	1000	1000	993	7	3	2.3333333333333335	993
FBgn0010269	1019	1000	998	40	7	5.714285714285714	979
FBgn0010278	1007	1000	965	49	7	7	958
FBgn0010282	1010	1000	1010	10	2	5	1000
FBgn0010287	1012	1000	1005	19	3	6.333333333333333	993
FBgn0010288	1020	1000	1020	20	2	10	1000
FBgn0010292	1023	1000	1015	31	7	4.428571428571429	992
FBgn0010296	1042	1000	1020	64	15	4.266666666666667	978
FBgn0010300	827	791	825	38	7	5.428571428571429	789
FBgn0010303	1002	1000	976	28	9	3.111111111111111	974
FBgn0010309	1002	1000	937	67	9	7.444444444444445	935
FBgn0010313	1023	1000	1019	27	5	5.4	996
FBgn0010314	892	832	856	96	13	7.384615384615385	796
FBgn0010315	1041	1000	1021	61	12	5.083333333333333	980
FBgn0010316	1049	1000	1012	86	13	6.615384615384615	963
FBgn0010323	1009	1000	998	20	5	4	989
FBgn0010329	1014	1000	997	31	7	4.428571428571429	983
FBgn0010333	1012	1000	1011	13	4	3.25	999
FBgn0010339	1001	1000	995	7	5	1.4	994
FBgn0010340	1000	1000	994	6	2	3	994
FBgn0010350	1000	1000	1000	0	0	NA	1000
FBgn0010356	1001	1000	985	17	4	4.25	984
FBgn0010379	1036	1000	1017	55	8	6.875	981
FBgn0010380	1034	1000	971	97	10	9.7	937
FBgn0010382	1088	1000	1025	151	19	7.947368421052632	937
FBgn0010383	1032	1000	981	83	18	4.611111111111111	949
FBgn0010385	1016	1000	970	62	10	6.2	954
FBgn0010388	1013	1000	978	48	9	5.333333333333333	965
FBgn0010391	1007	1000	979	35	8	4.375	972
FBgn0010397	1002	1000	969	35	10	3.5	967
FBgn0010398	1007	1000	1006	8	3	2.6666666666666665	999
FBgn0010399	1002	1000	624	380	8	47.5	622
FBgn0010401	1000	1000	997	3	3	1	997
FBgn0010403	1063	1000	1045	81	5	16.2	982
FBgn0010406	1029	1000	915	143	13	11	886
FBgn0010409	1021	1000	1017	25	4	6.25	996
FBgn0010411	1002	1000	985	19	3	6.333333333333333	983
FBgn0010412	1009	1000	1003	15	6	2.5	994
FBgn0010414	1006	1000	1000	12	6	2	994
FBgn0010415	1002	1000	995	9	7	1.2857142857142858	993
FBgn0010416	1004	1000	995	13	4	3.25	991
FBgn0010423	1014	1000	961	67	7	9.571428571428571	947
FBgn0010424	1033	1000	981	85	10	8.5	948
FBgn0010433	1000	1000	999	1	1	1	999
FBgn0010435	1023	1000	1021	25	5	5	998
FBgn0010438	1037	1000	1025	49	15	3.2666666666666666	988
FBgn0010441	1053	1000	1013	93	11	8.454545454545455	960
FBgn0010452	1003	1000	985	21	5	4.2	982
FBgn0010453	1017	1000	1009	25	7	3.5714285714285716	992
FBgn0010470	1055	1000	1014	96	13	7.384615384615385	959
FBgn0010473	1001	1000	983	19	8	2.375	982
FBgn0010482	1069	1000	992	146	15	9.733333333333333	923
FBgn0010488	1011	1000	926	96	10	9.6	915
FBgn0010497	1028	1000	921	135	13	10.384615384615385	893
FBgn0010501	1014	1000	1006	22	4	5.5	992
FBgn0010516	1024	1000	1020	28	8	3.5	996
FBgn0010548	1029	1000	962	96	14	6.857142857142857	933
FBgn0010549	1037	1000	708	366	10	36.6	671
FBgn0010551	1042	1000	974	110	17	6.470588235294118	932
FBgn0010583	1000	1000	1000	0	0	NA	1000
FBgn0010590	1013	1000	1011	15	5	3	998
FBgn0010591	1000	1000	999	1	1	1	999
FBgn0010607	1011	1000	1002	20	3	6.666666666666667	991
FBgn0010611	1019	1000	1006	32	6	5.333333333333333	987
FBgn0010612	1005	1000	967	43	11	3.909090909090909	962
FBgn0010620	1013	1000	962	64	19	3.3684210526315788	949
FBgn0010621	1014	1000	996	32	9	3.5555555555555554	982
FBgn0010638	1010	1000	967	53	9	5.888888888888889	957
FBgn0010651	1011	1000	920	102	9	11.333333333333334	909
FBgn0010660	1022	1000	1005	39	8	4.875	983
FBgn0010747	1004	1000	1001	7	3	2.3333333333333335	997
FBgn0010750	1051	1000	544	558	9	62	493
FBgn0010768	1034	1000	887	181	20	9.05	853
FBgn0010770	881	869	878	15	4	3.75	866
FBgn0010772	1012	1000	898	126	8	15.75	886
FBgn0010786	1000	1000	991	9	1	9	991
FBgn0010803	1011	1000	960	62	4	15.5	949
FBgn0010808	1003	1000	972	34	11	3.090909090909091	969
FBgn0010812	1015	1000	1014	16	2	8	999
FBgn0010825	1016	1000	994	38	7	5.428571428571429	978
FBgn0010830	1038	1000	1025	51	10	5.1	987
FBgn0010877	1001	1000	985	17	4	4.25	984
FBgn0010905	1032	1000	1013	51	14	3.642857142857143	981
FBgn0010909	1064	1000	969	159	19	8.368421052631579	905
FBgn0010926	1008	1000	979	37	6	6.166666666666667	971
FBgn0011016	1053	1000	1035	71	9	7.888888888888889	982
FBgn0011202	1004	1000	980	28	5	5.6	976
FBgn0011204	1002	1000	983	21	4	5.25	981
FBgn0011205	1029	1000	1026	32	7	4.571428571428571	997
FBgn0011206	1007	1000	1005	9	5	1.8	998
FBgn0011211	1012	1000	1001	23	8	2.875	989
FBgn0011217	1011	1000	1000	22	6	3.6666666666666665	989
FBgn0011224	1033	1000	991	75	14	5.357142857142857	958
FBgn0011227	1000	1000	998	2	1	2	998
FBgn0011232	1015	1000	993	37	10	3.7	978
FBgn0011239	1035	1000	847	223	7	31.857142857142858	812
FBgn0011244	1039	1000	1017	61	8	7.625	978
FBgn0011260	1008	1000	1000	16	5	3.2	992
FBgn0011272	1006	1000	1005	7	2	3.5	999
FBgn0011277	1003	1000	970	36	7	5.142857142857143	967
FBgn0011278	1007	1000	991	23	6	3.8333333333333335	984
FBgn0011279	1008	1000	1004	12	2	6	996
FBgn0011280	1001	1000	913	89	9	9.88888888888889	912
FBgn0011281	1016	1000	954	78	6	13	938
FBgn0011282	817	817	813	4	2	2	813
FBgn0011283	1045	1000	1044	46	5	9.2	999
FBgn0011284	1046	1000	1030	62	14	4.428571428571429	984
FBgn0011289	1000	1000	984	16	2	8	984
FBgn0011290	1005	1000	1005	5	2	2.5	1000
FBgn0011291	1002	1000	970	34	5	6.8	968
FBgn0011293	1049	1000	1018	80	12	6.666666666666667	969
FBgn0011294	1008	1000	987	29	4	7.25	979
FBgn0011296	1004	1000	903	105	7	15	899
FBgn0011297	1037	1000	1028	46	9	5.111111111111111	991
FBgn0011305	1019	1000	990	48	14	3.4285714285714284	971
FBgn0011327	1004	1000	978	30	2	15	974
FBgn0011335	1024	1000	1005	43	7	6.142857142857143	981
FBgn0011336	1001	1000	1000	2	2	1	999
FBgn0011455	1067	1000	1028	106	14	7.571428571428571	961
FBgn0011476	1021	1000	976	66	9	7.333333333333333	955
FBgn0011481	1005	1000	989	21	9	2.3333333333333335	984
FBgn0011555	1061	1000	1009	113	11	10.272727272727273	948
FBgn0011569	1006	1000	944	68	13	5.230769230769231	938
FBgn0011570	1009	1000	995	23	7	3.2857142857142856	986
FBgn0011573	1006	1000	1005	7	4	1.75	999
FBgn0011581	1029	1000	988	70	8	8.75	959
FBgn0011582	716	706	611	115	3	38.333333333333336	601
FBgn0011584	1050	1000	994	106	17	6.235294117647059	944
FBgn0011586	1028	1000	776	280	10	28	748
FBgn0011589	1037	1000	1005	69	11	6.2727272727272725	968
FBgn0011591	846	846	776	70	9	7.777777777777778	776
FBgn0011603	1000	1000	980	20	4	5	980
FBgn0011604	1050	1000	1050	50	5	10	1000
FBgn0011606	1006	1000	1000	12	2	6	994
FBgn0011638	1053	1000	1011	95	8	11.875	958
FBgn0011640	1005	1000	1000	10	4	2.5	995
FBgn0011648	1005	1000	1003	7	3	2.3333333333333335	998
FBgn0011653	783	774	719	73	11	6.636363636363637	710
FBgn0011655	1011	1000	1007	15	8	1.875	996
FBgn0011661	939	894	770	214	21	10.19047619047619	725
FBgn0011666	1033	1000	1007	59	19	3.1052631578947367	974
FBgn0011669	750	734	695	71	7	10.142857142857142	679
FBgn0011672	1015	1000	953	77	17	4.529411764705882	938
FBgn0011676	1005	1000	976	34	5	6.8	971
FBgn0011693	907	887	899	28	6	4.666666666666667	879
FBgn0011701	1091	1000	1044	138	16	8.625	953
FBgn0011704	1040	1000	990	90	14	6.428571428571429	950
FBgn0011705	1044	1000	1017	71	14	5.071428571428571	973
FBgn0011706	1019	1000	1004	34	13	2.6153846153846154	985
FBgn0011708	1009	1000	998	20	6	3.3333333333333335	989
FBgn0011710	1035	1000	993	77	12	6.416666666666667	958
FBgn0011715	1001	1000	969	33	7	4.714285714285714	968
FBgn0011723	1034	1000	1034	34	8	4.25	1000
FBgn0011725	1034	1000	1025	43	10	4.3	991
FBgn0011737	905	904	897	9	5	1.8	896
FBgn0011739	1017	1000	1002	32	9	3.5555555555555554	985
FBgn0011740	1005	1000	1004	6	5	1.2	999
FBgn0011742	1078	1000	1066	90	12	7.5	988
FBgn0011743	1017	1000	1007	27	5	5.4	990
FBgn0011745	1001	1000	1000	2	2	1	999
FBgn0011746	1000	1000	763	237	1	237	763
FBgn0011747	1000	1000	85	915	4	228.75	85
FBgn0011754	1009	1000	994	24	8	3	985
FBgn0011758	1101	1000	1089	113	11	10.272727272727273	988
FBgn0011760	1079	1000	980	178	22	8.090909090909092	901
FBgn0011763	1003	1000	1000	6	3	2	997
FBgn0011766	969	957	940	41	8	5.125	928
FBgn0011768	1040	1000	1008	72	12	6	968
FBgn0011774	1000	1000	992	8	5	1.6	992
FBgn0011785	1009	1000	995	23	8	2.875	986
FBgn0011802	1083	1000	1075	91	15	6.066666666666666	992
FBgn0011812	796	706	728	158	12	13.166666666666666	638
FBgn0011817	1001	1000	981	21	5	4.2	980
FBgn0011818	1053	1000	1052	54	4	13.5	999
FBgn0011824	1048	1000	1045	51	7	7.285714285714286	997
FBgn0011826	1005	1000	978	32	11	2.909090909090909	973
FBgn0011836	1014	1000	1011	17	7	2.4285714285714284	997
FBgn0011837	1015	1000	929	101	15	6.733333333333333	914
FBgn0011840	1001	1000	986	16	4	4	985
FBgn0011850	909	884	881	53	15	3.533333333333333	856
FBgn0011851	1009	1000	964	54	13	4.153846153846154	955
FBgn0011858	1030	1000	1014	46	8	5.75	984
FBgn0011859	1005	1000	1003	7	4	1.75	998
FBgn0011860	1052	1000	1038	66	8	8.25	986
FBgn0011861	1001	1000	953	49	9	5.444444444444445	952
FBgn0011862	1014	1000	994	34	7	4.857142857142857	980
FBgn0011864	1032	1000	1006	58	6	9.666666666666666	974
FBgn0011866	1000	1000	881	119	3	39.666666666666664	881
FBgn0011867	1049	1000	1033	65	14	4.642857142857143	984
FBgn0011868	1005	1000	969	41	7	5.857142857142857	964
FBgn0011869	1003	1000	979	27	8	3.375	976
FBgn0011896	1005	1000	993	17	8	2.125	988
FBgn0011897	1077	1000	906	248	13	19.076923076923077	829
FBgn0011902	1102	1000	1098	106	13	8.153846153846153	996
FBgn0011906	1017	1000	1001	33	6	5.5	984
FBgn0011919	1109	1000	1042	176	20	8.8	933
FBgn0011921	1052	1000	1019	85	8	10.625	967
FBgn0011948	688	676	671	29	6	4.833333333333333	659
FBgn0011952	1031	1000	1002	60	11	5.454545454545454	971
FBgn0011955	1050	1000	1047	53	6	8.833333333333334	997
FBgn0011956	1051	1000	1032	70	11	6.363636363636363	981
FBgn0011958	1027	1000	993	61	10	6.1	966
FBgn0011959	1039	1000	1038	40	6	6.666666666666667	999
FBgn0011965	1025	1000	952	98	8	12.25	927
FBgn0011966	1028	1000	997	59	15	3.933333333333333	969
FBgn0011970	1073	1000	1057	89	16	5.5625	984
FBgn0011971	1012	1000	956	68	19	3.5789473684210527	944
FBgn0011974	1022	1000	927	117	12	9.75	905
FBgn0011982	1012	1000	945	79	13	6.076923076923077	933
FBgn0011983	1044	1000	1010	78	16	4.875	966
FBgn0011986	1027	1000	1021	33	8	4.125	994
FBgn0011994	1042	1000	1039	45	6	7.5	997
FBgn0011999	1009	1000	960	58	7	8.285714285714286	951
FBgn0012001	1022	1000	957	87	9	9.666666666666666	935
FBgn0012002	1126	1000	1056	196	22	8.909090909090908	930
FBgn0012003	1039	1000	976	102	7	14.571428571428571	937
FBgn0012004	1002	1000	996	8	5	1.6	994
FBgn0012010	1008	1000	1006	10	5	2	998
FBgn0012016	1012	1000	998	26	8	3.25	986
FBgn0012017	1002	1000	984	20	4	5	982
FBgn0012027	714	712	707	9	5	1.8	705
FBgn0012036	1009	1000	848	170	12	14.166666666666666	839
FBgn0012037	1030	1000	735	325	8	40.625	705
FBgn0012042	1047	1000	1043	51	7	7.285714285714286	996
FBgn0012051	1001	1000	953	49	4	12.25	952
FBgn0013269	1008	1000	1000	16	3	5.333333333333333	992
FBgn0013272	1093	1000	1083	103	9	11.444444444444445	990
FBgn0013305	1000	1000	1000	0	0	NA	1000
FBgn0013307	1012	1000	999	25	8	3.125	987
FBgn0013323	1006	1000	998	14	5	2.8	992
FBgn0013348	1005	1000	442	568	3	189.33333333333334	437
FBgn0013432	1009	1000	991	27	6	4.5	982
FBgn0013433	1010	1000	956	64	10	6.4	946
FBgn0013435	1019	1000	1018	20	7	2.857142857142857	999
FBgn0013469	1077	1000	1051	103	13	7.923076923076923	974
FBgn0013531	1000	1000	995	5	2	2.5	995
FBgn0013548	1014	1000	998	30	9	3.3333333333333335	984
FBgn0013563	1026	1000	1009	43	6	7.166666666666667	983
FBgn0013576	1033	1000	934	132	10	13.2	901
FBgn0013687	1000	1000	1000	0	0	NA	1000
FBgn0013702	1000	1000	1000	0	0	NA	1000
FBgn0013707	1000	1000	997	3	1	3	997
FBgn0013710	1000	1000	1000	0	0	NA	1000
FBgn0013717	1015	1000	1012	18	5	3.6	997
FBgn0013718	1004	1000	660	348	10	34.8	656
FBgn0013725	1021	1000	963	79	15	5.266666666666667	942
FBgn0013726	1017	1000	992	42	6	7	975
FBgn0013746	1000	1000	993	7	2	3.5	993
FBgn0013749	1079	1000	1041	117	23	5.086956521739131	962
FBgn0013750	1005	1000	757	253	3	84.33333333333333	752
FBgn0013751	1040	1000	1014	66	8	8.25	974
FBgn0013753	1042	1000	1008	76	8	9.5	966
FBgn0013755	1014	1000	1007	21	6	3.5	993
FBgn0013759	1031	1000	1028	34	10	3.4	997
FBgn0013762	1004	1000	995	13	3	4.333333333333333	991
FBgn0013763	1028	1000	1002	54	15	3.6	974
FBgn0013764	1009	1000	996	22	5	4.4	987
FBgn0013765	1000	1000	997	3	3	1	997
FBgn0013767	697	679	677	38	6	6.333333333333333	659
FBgn0013770	1013	1000	1011	15	3	5	998
FBgn0013773	1031	1000	962	100	13	7.6923076923076925	931
FBgn0013799	1002	1000	989	15	4	3.75	987
FBgn0013810	1021	1000	1008	34	6	5.666666666666667	987
FBgn0013811	850	843	838	19	4	4.75	831
FBgn0013812	1019	1000	1007	31	5	6.2	988
FBgn0013813	955	954	953	3	3	1	952
FBgn0013949	1017	1000	995	39	4	9.75	978
FBgn0013953	1021	1000	1010	32	9	3.5555555555555554	989
FBgn0013973	1004	1000	971	37	7	5.285714285714286	967
FBgn0013981	1042	1000	1023	61	9	6.777777777777778	981
FBgn0013983	1017	1000	946	88	4	22	929
FBgn0013987	1012	1000	998	26	7	3.7142857142857144	986
FBgn0013995	1057	1000	995	119	17	7	938
FBgn0013997	1005	1000	850	160	6	26.666666666666668	845
FBgn0014007	1007	1000	964	50	10	5	957
FBgn0014009	1004	1000	998	10	4	2.5	994
FBgn0014010	1034	1000	1027	41	6	6.833333333333333	993
FBgn0014011	1026	1000	1002	50	8	6.25	976
FBgn0014019	1018	1000	851	185	12	15.416666666666666	833
FBgn0014020	1007	1000	996	18	6	3	989
FBgn0014022	1003	1000	1003	3	2	1.5	1000
FBgn0014023	1000	1000	983	17	8	2.125	983
FBgn0014026	1016	1000	978	54	12	4.5	962
FBgn0014028	1102	1000	1039	165	17	9.705882352941176	937
FBgn0014029	1024	1000	1005	43	6	7.166666666666667	981
FBgn0014031	1016	1000	976	56	8	7	960
FBgn0014073	1056	1000	1023	89	11	8.090909090909092	967
FBgn0014075	1054	1000	1027	81	7	11.571428571428571	973
FBgn0014092	1082	1000	1074	90	12	7.5	992
FBgn0014127	1009	1000	991	27	7	3.857142857142857	982
FBgn0014133	1005	1000	989	21	5	4.2	984
FBgn0014135	1044	1000	993	95	16	5.9375	949
FBgn0014141	738	737	707	32	2	16	706
FBgn0014143	1006	1000	949	63	7	9	943
FBgn0014163	1036	1000	978	94	19	4.947368421052632	942
FBgn0014184	1012	1000	1008	16	5	3.2	996
FBgn0014189	1000	1000	993	7	4	1.75	993
FBgn0014343	1007	1000	980	34	11	3.090909090909091	973
FBgn0014366	1012	1000	994	30	7	4.285714285714286	982
FBgn0014380	1004	1000	927	81	9	9	923
FBgn0014388	1000	1000	965	35	5	7	965
FBgn0014391	1013	1000	1007	19	10	1.9	994
FBgn0014395	1013	1000	878	148	8	18.5	865
FBgn0014396	1021	1000	985	57	7	8.142857142857142	964
FBgn0014411	1000	1000	999	1	1	1	999
FBgn0014417	1019	1000	952	86	11	7.818181818181818	933
FBgn0014427	1012	1000	958	66	10	6.6	946
FBgn0014454	1004	1000	948	60	7	8.571428571428571	944
FBgn0014455	1033	1000	1018	48	5	9.6	985
FBgn0014464	1048	1000	1020	76	15	5.066666666666666	972
FBgn0014465	880	868	867	25	7	3.5714285714285716	855
FBgn0014466	1095	1000	1006	184	20	9.2	911
FBgn0014848	1016	1000	977	55	10	5.5	961
FBgn0014849	1000	1000	992	8	4	2	992
FBgn0014850	1004	1000	993	15	5	3	989
FBgn0014851	1020	1000	1001	39	14	2.7857142857142856	981
FBgn0014857	699	679	696	23	4	5.75	676
FBgn0014859	1015	1000	963	67	9	7.444444444444445	948
FBgn0014861	1066	1000	1045	87	13	6.6923076923076925	979
FBgn0014868	1058	1000	1051	65	11	5.909090909090909	993
FBgn0014869	1005	1000	1003	7	2	3.5	998
FBgn0014870	1047	1000	1012	82	8	10.25	965
FBgn0014877	1010	1000	983	37	9	4.111111111111111	973
FBgn0014879	1003	1000	995	11	3	3.6666666666666665	992
FBgn0014930	1000	1000	486	514	2	257	486
FBgn0014931	1041	1000	843	239	13	18.384615384615383	802
FBgn0014949	1014	1000	956	72	10	7.2	942
FBgn0015000	1013	1000	1010	16	5	3.2	997
FBgn0015010	1080	1000	1048	112	17	6.588235294117647	968
FBgn0015011	1009	1000	952	66	11	6	943
FBgn0015019	1044	1000	1033	55	12	4.583333333333333	989
FBgn0015025	1038	1000	999	77	9	8.555555555555555	961
FBgn0015032	1015	1000	999	31	8	3.875	984
FBgn0015033	1003	1000	978	28	4	7	975
FBgn0015035	1003	1000	972	34	4	8.5	969
FBgn0015039	1089	1000	1076	102	11	9.272727272727273	987
FBgn0015040	1018	1000	989	47	10	4.7	971
FBgn0015075	1005	1000	790	220	8	27.5	785
FBgn0015218	1008	1000	975	41	2	20.5	967
FBgn0015221	1000	1000	993	7	2	3.5	993
FBgn0015222	1021	1000	1020	22	5	4.4	999
FBgn0015229	1030	1000	957	103	14	7.357142857142857	927
FBgn0015230	1004	1000	986	22	6	3.6666666666666665	982
FBgn0015239	773	720	746	80	10	8	693
FBgn0015240	788	768	783	25	6	4.166666666666667	763
FBgn0015247	1001	1000	1001	1	1	1	1000
FBgn0015268	1015	1000	996	34	7	4.857142857142857	981
FBgn0015269	1002	1000	975	29	9	3.2222222222222223	973
FBgn0015270	1006	1000	667	345	13	26.53846153846154	661
FBgn0015271	1000	1000	998	2	2	1	998
FBgn0015279	1028	1000	987	69	18	3.8333333333333335	959
FBgn0015282	1001	1000	990	12	4	3	989
FBgn0015286	1001	1000	990	12	5	2.4	989
FBgn0015288	1135	1000	1113	157	13	12.076923076923077	978
FBgn0015295	1015	1000	968	62	13	4.769230769230769	953
FBgn0015296	1031	1000	1027	35	5	7	996
FBgn0015298	1043	1000	1000	86	11	7.818181818181818	957
FBgn0015299	1007	1000	972	42	10	4.2	965
FBgn0015300	927	917	878	59	7	8.428571428571429	868
FBgn0015321	1022	1000	711	333	7	47.57142857142857	689
FBgn0015336	1043	1000	970	116	10	11.6	927
FBgn0015338	1002	1000	1001	3	2	1.5	999
FBgn0015359	1011	1000	994	28	5	5.6	983
FBgn0015360	990	983	974	23	8	2.875	967
FBgn0015371	1037	1000	846	228	12	19	809
FBgn0015372	1004	1000	1003	5	3	1.6666666666666667	999
FBgn0015380	924	896	857	95	11	8.636363636363637	829
FBgn0015381	1015	1000	1010	20	5	4	995
FBgn0015391	1004	1000	973	35	5	7	969
FBgn0015399	1004	1000	879	129	5	25.8	875
FBgn0015402	1011	1000	934	88	9	9.777777777777779	923
FBgn0015509	1006	1000	943	69	6	11.5	937
FBgn0015513	1008	1000	986	30	6	5	978
FBgn0015519	1023	1000	960	86	9	9.555555555555555	937
FBgn0015520	1005	1000	1000	10	7	1.4285714285714286	995
FBgn0015521	1009	1000	1002	16	8	2	993
FBgn0015524	1000	1000	994	6	4	1.5	994
FBgn0015527	1012	1000	1004	20	7	2.857142857142857	992
FBgn0015544	1000	1000	1000	0	0	NA	1000
FBgn0015546	792	790	320	474	6	79	318
FBgn0015550	1034	1000	1022	46	7	6.571428571428571	988
FBgn0015553	1000	1000	992	8	2	4	992
FBgn0015558	1008	1000	1005	11	4	2.75	997
FBgn0015568	1069	1000	1022	116	13	8.923076923076923	953
FBgn0015569	1002	1000	992	12	4	3	990
FBgn0015572	912	886	869	69	7	9.857142857142858	843
FBgn0015575	946	882	908	102	19	5.368421052631579	844
FBgn0015576	1018	1000	970	66	10	6.6	952
FBgn0015582	759	745	681	92	17	5.411764705882353	667
FBgn0015585	1000	1000	968	32	4	8	968
FBgn0015591	1040	1000	1032	48	3	16	992
FBgn0015609	1059	1000	1012	106	16	6.625	953
FBgn0015615	1020	1000	996	44	11	4	976
FBgn0015618	1007	1000	664	350	6	58.333333333333336	657
FBgn0015621	1001	1000	982	20	3	6.666666666666667	981
FBgn0015623	1002	1000	979	25	4	6.25	977
FBgn0015625	1064	1000	1029	99	10	9.9	965
FBgn0015663	1059	1000	972	146	16	9.125	913
FBgn0015664	1000	1000	1000	0	0	NA	1000
FBgn0015721	714	676	699	53	10	5.3	661
FBgn0015737	1044	1000	1036	52	9	5.777777777777778	992
FBgn0015754	1013	1000	993	33	13	2.5384615384615383	980
FBgn0015756	1056	1000	1044	68	10	6.8	988
FBgn0015765	1016	1000	1012	20	4	5	996
FBgn0015766	1027	1000	999	55	11	5	972
FBgn0015770	1006	1000	995	17	7	2.4285714285714284	989
FBgn0015772	1018	1000	1017	19	2	9.5	999
FBgn0015773	1001	1000	901	101	14	7.214285714285714	900
FBgn0015776	1010	1000	999	21	6	3.5	989
FBgn0015778	1036	1000	1000	72	7	10.285714285714286	964
FBgn0015781	1000	1000	998	2	2	1	998
FBgn0015789	1018	1000	1018	18	3	6	1000
FBgn0015790	777	700	759	95	11	8.636363636363637	682
FBgn0015791	1001	1000	1001	1	1	1	1000
FBgn0015793	1005	1000	967	43	6	7.166666666666667	962
FBgn0015794	1054	1000	1022	86	13	6.615384615384615	968
FBgn0015795	1000	1000	998	2	1	2	998
FBgn0015797	1016	1000	989	43	6	7.166666666666667	973
FBgn0015801	1006	1000	962	50	5	10	956
FBgn0015803	1059	1000	1023	95	7	13.571428571428571	964
FBgn0015805	1029	1000	1019	39	12	3.25	990
FBgn0015818	1042	1000	1027	57	9	6.333333333333333	985
FBgn0015828	1019	1000	975	63	9	7	956
FBgn0015829	921	866	897	79	12	6.583333333333333	842
FBgn0015831	1029	1000	1006	52	10	5.2	977
FBgn0015872	1005	1000	954	56	16	3.5	949
FBgn0015904	1013	1000	991	35	9	3.888888888888889	978
FBgn0015905	1013	1000	984	42	8	5.25	971
FBgn0015919	1010	1000	949	71	11	6.454545454545454	939
FBgn0015924	1000	1000	997	3	2	1.5	997
FBgn0015925	1002	1000	998	6	3	2	996
FBgn0015926	1076	1000	1048	104	18	5.777777777777778	972
FBgn0015929	1003	1000	991	15	4	3.75	988
FBgn0015946	1049	1000	1016	82	6	13.666666666666666	967
FBgn0015949	1007	1000	938	76	10	7.6	931
FBgn0016013	1008	1000	993	23	8	2.875	985
FBgn0016036	1001	1000	958	44	7	6.285714285714286	957
FBgn0016038	845	800	839	51	7	7.285714285714286	794
FBgn0016047	1047	1000	1043	51	5	10.2	996
FBgn0016053	1016	1000	977	55	5	11	961
FBgn0016054	1000	1000	1000	0	0	NA	1000
FBgn0016059	1033	1000	1011	55	7	7.857142857142857	978
FBgn0016061	1014	1000	1012	16	5	3.2	998
FBgn0016070	1000	1000	991	9	4	2.25	991
FBgn0016078	1033	1000	921	145	22	6.590909090909091	888
FBgn0016081	1004	1000	961	47	9	5.222222222222222	957
FBgn0016119	1013	1000	977	49	7	7	964
FBgn0016120	1010	1000	991	29	3	9.666666666666666	981
FBgn0016123	1008	1000	969	47	15	3.1333333333333333	961
FBgn0016126	1018	1000	364	672	7	96	346
FBgn0016131	1005	1000	967	43	8	5.375	962
FBgn0016641	1004	1000	994	14	5	2.8	990
FBgn0016650	1058	1000	1041	75	11	6.818181818181818	983
FBgn0016660	1019	1000	1016	22	6	3.6666666666666665	997
FBgn0016675	1035	1000	986	84	15	5.6	951
FBgn0016685	1000	1000	975	25	2	12.5	975
FBgn0016687	1003	1000	969	37	8	4.625	966
FBgn0016694	1002	1000	930	74	11	6.7272727272727275	928
FBgn0016697	1047	1000	1047	47	6	7.833333333333333	1000
FBgn0016698	1013	1000	1009	17	7	2.4285714285714284	996
FBgn0016715	1028	1000	957	99	15	6.6	929
FBgn0016726	1022	1000	992	52	6	8.666666666666666	970
FBgn0016754	1005	1000	994	16	4	4	989
FBgn0016762	1013	1000	1000	26	8	3.25	987
FBgn0016794	741	697	721	64	11	5.818181818181818	677
FBgn0016917	781	745	779	38	5	7.6	743
FBgn0016920	1028	1000	1009	47	12	3.9166666666666665	981
FBgn0016926	1009	1000	978	40	5	8	969
FBgn0016930	1013	1000	995	31	10	3.1	982
FBgn0016970	1026	1000	1016	36	12	3	990
FBgn0016977	1006	1000	998	14	5	2.8	992
FBgn0016983	1000	1000	998	2	2	1	998
FBgn0017414	1001	1000	997	5	3	1.6666666666666667	996
FBgn0017424	988	966	955	55	12	4.583333333333333	933
FBgn0017429	1012	1000	994	30	8	3.75	982
FBgn0017430	1000	1000	950	50	2	25	950
FBgn0017448	897	878	885	31	7	4.428571428571429	866
FBgn0017457	1019	1000	1015	23	3	7.666666666666667	996
FBgn0017482	1004	1000	984	24	6	4	980
FBgn0017545	1058	1000	808	308	16	19.25	750
FBgn0017551	1016	1000	925	107	9	11.88888888888889	909
FBgn0017556	1010	1000	978	42	8	5.25	968
FBgn0017558	800	796	761	43	8	5.375	757
FBgn0017561	1048	1000	1027	69	11	6.2727272727272725	979
FBgn0017566	1056	1000	1030	82	20	4.1	974
FBgn0017567	1040	1000	993	87	8	10.875	953
FBgn0017572	1009	1000	957	61	12	5.083333333333333	948
FBgn0017577	1019	1000	1017	21	3	7	998
FBgn0017578	1012	1000	984	40	7	5.714285714285714	972
FBgn0017579	1006	1000	948	64	5	12.8	942
FBgn0017581	1001	1000	992	10	3	3.3333333333333335	991
FBgn0017590	1008	1000	985	31	10	3.1	977
FBgn0019624	1008	1000	897	119	5	23.8	889
FBgn0019637	1000	1000	988	12	3	4	988
FBgn0019644	1020	1000	1000	40	6	6.666666666666667	980
FBgn0019650	1012	1000	938	86	7	12.285714285714286	926
FBgn0019662	1025	1000	998	52	6	8.666666666666666	973
FBgn0019686	1038	1000	1020	56	10	5.6	982
FBgn0019809	1001	1000	957	45	8	5.625	956
FBgn0019830	908	868	903	45	4	11.25	863
FBgn0019890	1030	1000	718	342	8	42.75	688
FBgn0019925	1002	1000	987	17	5	3.4	985
FBgn0019928	760	758	750	12	6	2	748
FBgn0019929	1017	1000	987	47	11	4.2727272727272725	970
FBgn0019932	1002	1000	1002	2	2	1	1000
FBgn0019936	1005	1000	1002	8	4	2	997
FBgn0019938	1012	1000	984	40	5	8	972
FBgn0019949	1000	1000	1000	0	0	NA	1000
FBgn0019952	1035	1000	1002	68	14	4.857142857142857	967
FBgn0019957	1010	1000	966	54	7	7.714285714285714	956
FBgn0019960	1000	1000	988	12	2	6	988
FBgn0019972	1050	1000	1036	64	8	8	986
FBgn0019985	1024	1000	854	194	14	13.857142857142858	830
FBgn0019990	1016	1000	971	61	6	10.166666666666666	955
FBgn0020018	1004	1000	999	9	3	3	995
FBgn0020224	1028	1000	990	66	12	5.5	962
FBgn0020235	1001	1000	987	15	4	3.75	986
FBgn0020236	1062	1000	1034	90	9	10	972
FBgn0020238	1009	1000	1005	13	9	1.4444444444444444	996
FBgn0020249	1002	1000	970	34	4	8.5	968
FBgn0020251	1000	1000	987	13	4	3.25	987
FBgn0020258	1022	1000	1004	40	8	5	982
FBgn0020261	1056	1000	789	323	6	53.833333333333336	733
FBgn0020277	1014	1000	966	62	10	6.2	952
FBgn0020278	1011	1000	1003	19	7	2.7142857142857144	992
FBgn0020279	1074	1000	1070	78	9	8.666666666666666	996
FBgn0020280	1016	1000	1003	29	4	7.25	987
FBgn0020299	1027	1000	984	70	13	5.384615384615385	957
FBgn0020300	1128	1000	1102	154	16	9.625	974
FBgn0020305	1005	1000	982	28	8	3.5	977
FBgn0020306	1040	1000	1039	41	3	13.666666666666666	999
FBgn0020307	1057	1000	1010	104	12	8.666666666666666	953
FBgn0020309	1046	1000	1029	63	17	3.7058823529411766	983
FBgn0020312	1022	1000	1001	43	4	10.75	979
FBgn0020370	1005	1000	996	14	6	2.3333333333333335	991
FBgn0020371	1014	1000	984	44	6	7.333333333333333	970
FBgn0020376	1115	1000	1077	153	9	17	962
FBgn0020377	1026	1000	962	90	11	8.181818181818182	936
FBgn0020378	1020	1000	924	116	15	7.733333333333333	904
FBgn0020379	1026	1000	976	76	5	15.2	950
FBgn0020381	1002	1000	995	9	4	2.25	993
FBgn0020385	1005	1000	981	29	4	7.25	976
FBgn0020386	1039	1000	1004	74	15	4.933333333333334	965
FBgn0020407	1002	1000	1001	3	2	1.5	999
FBgn0020412	1026	946	1026	80	4	20	946
FBgn0020416	1022	1000	1015	29	10	2.9	993
FBgn0020440	1038	1000	1024	52	10	5.2	986
FBgn0020443	1033	1000	970	96	10	9.6	937
FBgn0020445	1009	1000	1001	17	4	4.25	992
FBgn0020493	1049	1000	1034	64	14	4.571428571428571	985
FBgn0020496	696	689	675	28	7	4	668
FBgn0020503	1032	1000	1005	59	9	6.555555555555555	973
FBgn0020508	1020	1000	951	89	17	5.235294117647059	931
FBgn0020509	1011	1000	989	33	7	4.714285714285714	978
FBgn0020510	1009	1000	990	28	6	4.666666666666667	981
FBgn0020521	1000	1000	981	19	4	4.75	981
FBgn0020545	1000	1000	996	4	2	2	996
FBgn0020546	1003	1000	975	31	9	3.4444444444444446	972
FBgn0020556	1017	1000	1005	29	7	4.142857142857143	988
FBgn0020616	1000	1000	984	16	2	8	984
FBgn0020617	1000	1000	827	173	6	28.833333333333332	827
FBgn0020618	1015	1000	781	249	8	31.125	766
FBgn0020620	1026	1000	991	61	9	6.777777777777778	965
FBgn0020622	849	830	811	57	8	7.125	792
FBgn0020633	1073	1000	1040	106	10	10.6	967
FBgn0020640	1053	1000	1044	62	6	10.333333333333334	991
FBgn0020642	955	932	911	67	9	7.444444444444445	888
FBgn0020647	1000	1000	997	3	2	1.5	997
FBgn0020653	1013	1000	1009	17	6	2.8333333333333335	996
FBgn0020655	1045	1000	974	116	12	9.666666666666666	929
FBgn0020765	1000	1000	981	19	4	4.75	981
FBgn0020880	1001	1000	971	31	7	4.428571428571429	970
FBgn0020887	1000	1000	971	29	3	9.666666666666666	971
FBgn0020906	1000	1000	981	19	3	6.333333333333333	981
FBgn0020907	1000	1000	984	16	3	5.333333333333333	984
FBgn0020912	1000	1000	998	2	1	2	998
FBgn0021742	1019	1000	963	75	15	5	944
FBgn0021750	1019	1000	972	66	9	7.333333333333333	953
FBgn0021761	1061	1000	1045	77	11	7	984
FBgn0021764	1015	1000	992	38	11	3.4545454545454546	977
FBgn0021765	1000	1000	88	912	4	228	88
FBgn0021767	1009	1000	964	54	11	4.909090909090909	955
FBgn0021768	1021	1000	994	48	10	4.8	973
FBgn0021795	1080	1000	815	345	12	28.75	735
FBgn0021796	1049	1000	1048	50	11	4.545454545454546	999
FBgn0021814	798	798	782	16	6	2.6666666666666665	782
FBgn0021825	1049	1000	1022	76	10	7.6	973
FBgn0021847	1036	1000	1024	48	9	5.333333333333333	988
FBgn0021856	1000	1000	30	970	1	970	30
FBgn0021874	1048	1000	1046	50	7	7.142857142857143	998
FBgn0021875	1010	1000	1009	11	5	2.2	999
FBgn0021895	1000	1000	1000	0	0	NA	1000
FBgn0021906	1004	1000	924	84	6	14	920
FBgn0021944	1007	1000	1005	9	4	2.25	998
FBgn0021967	1007	1000	998	16	6	2.6666666666666665	991
FBgn0021995	1000	1000	998	2	2	1	998
FBgn0022023	1000	1000	997	3	1	3	997
FBgn0022027	1019	1000	1010	28	7	4	991
FBgn0022029	1019	1000	1001	37	10	3.7	982
FBgn0022069	1010	1000	990	30	9	3.3333333333333335	980
FBgn0022153	1003	1000	794	212	3	70.66666666666667	791
FBgn0022160	1022	1000	1016	28	6	4.666666666666667	994
FBgn0022213	1027	1000	1018	36	6	6	991
FBgn0022224	1008	1000	686	330	7	47.142857142857146	678
FBgn0022238	1000	1000	1000	0	0	NA	1000
FBgn0022288	1000	1000	193	807	4	201.75	193
FBgn0022338	1000	1000	997	3	2	1.5	997
FBgn0022343	1011	1000	1006	16	5	3.2	995
FBgn0022344	1004	1000	967	41	11	3.727272727272727	963
FBgn0022349	1000	1000	998	2	1	2	998
FBgn0022355	1048	1000	1002	94	17	5.529411764705882	954
FBgn0022359	1003	1000	975	31	8	3.875	972
FBgn0022361	1011	1000	996	26	6	4.333333333333333	985
FBgn0022699	1010	1000	987	33	8	4.125	977
FBgn0022700	970	944	920	76	13	5.846153846153846	894
FBgn0022702	1012	1000	964	60	7	8.571428571428571	952
FBgn0022724	1007	1000	986	28	6	4.666666666666667	979
FBgn0022740	1037	1000	1003	71	6	11.833333333333334	966
FBgn0022768	1079	1000	980	178	23	7.739130434782608	901
FBgn0022770	1066	1000	693	439	16	27.4375	627
FBgn0022774	1002	1000	958	46	10	4.6	956
FBgn0022786	1023	1000	1008	38	9	4.222222222222222	985
FBgn0022787	1011	1000	1005	17	6	2.8333333333333335	994
FBgn0022800	1005	1000	992	18	8	2.25	987
FBgn0022893	1099	1000	986	212	18	11.777777777777779	887
FBgn0022935	1016	1000	992	40	10	4	976
FBgn0022936	1053	1000	900	206	24	8.583333333333334	847
FBgn0022942	1025	1000	1018	32	7	4.571428571428571	993
FBgn0022943	1032	1000	1016	48	9	5.333333333333333	984
FBgn0022981	1008	1000	807	209	8	26.125	799
FBgn0022984	1005	1000	1003	7	5	1.4	998
FBgn0022987	1016	1000	1005	27	5	5.4	989
FBgn0023000	1036	1000	993	79	15	5.266666666666667	957
FBgn0023001	1002	1000	990	14	7	2	988
FBgn0023023	1036	990	1012	70	11	6.363636363636363	966
FBgn0023076	1045	1000	1008	82	10	8.2	963
FBgn0023081	1008	1000	936	80	11	7.2727272727272725	928
FBgn0023095	1026	1000	1019	33	7	4.714285714285714	993
FBgn0023129	1002	1000	977	27	3	9	975
FBgn0023130	1020	1000	1010	30	6	5	990
FBgn0023143	1080	1000	666	494	13	38	586
FBgn0023167	1011	1000	1003	19	6	3.1666666666666665	992
FBgn0023169	1001	1000	983	19	9	2.111111111111111	982
FBgn0023170	1014	1000	994	34	9	3.7777777777777777	980
FBgn0023171	1000	1000	996	4	2	2	996
FBgn0023172	1007	1000	1002	12	4	3	995
FBgn0023174	1016	1000	973	59	10	5.9	957
FBgn0023175	1012	1000	1012	12	3	4	1000
FBgn0023177	1025	1000	1011	39	6	6.5	986
FBgn0023178	1015	1000	990	40	13	3.076923076923077	975
FBgn0023179	1000	1000	967	33	6	5.5	967
FBgn0023181	1028	1000	997	59	8	7.375	969
FBgn0023197	1033	1000	999	67	6	11.166666666666666	966
FBgn0023212	886	886	885	1	1	1	885
FBgn0023214	1047	1000	1013	81	11	7.363636363636363	966
FBgn0023215	1001	1000	1001	1	1	1	1000
FBgn0023216	1004	1000	996	12	8	1.5	992
FBgn0023388	1045	1000	932	158	19	8.31578947368421	887
FBgn0023395	1084	1000	818	350	14	25	734
FBgn0023407	1023	1000	993	53	12	4.416666666666667	970
FBgn0023415	1018	1000	973	63	5	12.6	955
FBgn0023416	1002	1000	413	591	3	197	411
FBgn0023458	1012	1000	1002	22	3	7.333333333333333	990
FBgn0023489	1001	1000	994	8	4	2	993
FBgn0023495	1042	1000	1016	68	9	7.555555555555555	974
FBgn0023496	864	850	814	64	9	7.111111111111111	800
FBgn0023506	1047	1000	942	152	19	8	895
FBgn0023507	1013	1000	967	59	10	5.9	954
FBgn0023508	1001	1000	1001	1	1	1	1000
FBgn0023509	1002	1000	991	13	3	4.333333333333333	989
FBgn0023511	1036	1000	1023	49	11	4.454545454545454	987
FBgn0023512	1002	1000	994	10	5	2	992
FBgn0023513	1000	1000	1000	0	0	NA	1000
FBgn0023514	1002	1000	974	30	3	10	972
FBgn0023515	1004	1000	1004	4	1	4	1000
FBgn0023516	1000	1000	995	5	1	5	995
FBgn0023517	1003	1000	1001	5	3	1.6666666666666667	998
FBgn0023518	1005	1000	1001	9	5	1.8	996
FBgn0023519	1000	1000	992	8	4	2	992
FBgn0023520	1007	1000	1002	12	6	2	995
FBgn0023521	1003	1000	996	10	8	1.25	993
FBgn0023523	1006	1000	983	29	6	4.833333333333333	977
FBgn0023524	846	830	792	70	9	7.777777777777778	776
FBgn0023526	1029	1000	1001	57	10	5.7	972
FBgn0023527	1000	1000	935	65	9	7.222222222222222	935
FBgn0023528	739	729	730	19	5	3.8	720
FBgn0023529	1031	1000	1016	46	7	6.571428571428571	985
FBgn0023530	1000	1000	945	55	4	13.75	945
FBgn0023531	1044	1000	978	110	10	11	934
FBgn0023534	1018	1000	954	82	8	10.25	936
FBgn0023536	1009	1000	999	19	5	3.8	990
FBgn0023537	1018	1000	944	92	9	10.222222222222221	926
FBgn0023540	1015	1000	991	39	6	6.5	976
FBgn0023542	1001	1000	996	6	3	2	995
FBgn0023545	1001	1000	498	504	2	252	497
FBgn0023549	754	712	732	64	8	8	690
FBgn0023550	1001	1000	989	13	4	3.25	988
FBgn0024177	1000	1000	992	8	3	2.6666666666666665	992
FBgn0024183	1000	1000	988	12	4	3	988
FBgn0024184	1004	1000	987	21	3	7	983
FBgn0024187	1013	1000	1001	25	9	2.7777777777777777	988
FBgn0024188	1012	1000	997	27	9	3	985
FBgn0024191	1016	1000	983	49	9	5.444444444444445	967
FBgn0024196	854	847	814	47	6	7.833333333333333	807
FBgn0024227	1050	1000	1041	59	10	5.9	991
FBgn0024230	1006	1000	990	22	4	5.5	984
FBgn0024232	1021	1000	990	52	5	10.4	969
FBgn0024236	1011	1000	785	237	6	39.5	774
FBgn0024244	916	913	914	5	2	2.5	911
FBgn0024249	1002	1000	958	46	7	6.571428571428571	956
FBgn0024250	1043	1000	986	100	12	8.333333333333334	943
FBgn0024273	1000	1000	961	39	5	7.8	961
FBgn0024277	1043	1000	1030	56	9	6.222222222222222	987
FBgn0024285	1015	1000	988	42	8	5.25	973
FBgn0024288	1005	1000	990	20	8	2.5	985
FBgn0024291	1001	1000	990	12	3	4	989
FBgn0024294	1025	1000	984	66	11	6	959
FBgn0024315	1057	1000	1007	107	20	5.35	950
FBgn0024319	719	710	676	52	5	10.4	667
FBgn0024320	1007	1000	1006	8	4	2	999
FBgn0024321	1003	1000	989	17	4	4.25	986
FBgn0024326	717	716	705	13	4	3.25	704
FBgn0024330	1000	1000	986	14	2	7	986
FBgn0024352	1019	1000	1019	19	2	9.5	1000
FBgn0024360	1001	1000	984	18	6	3	983
FBgn0024361	1005	1000	999	11	3	3.6666666666666665	994
FBgn0024362	1010	1000	947	73	12	6.083333333333333	937
FBgn0024364	1003	1000	1000	6	2	3	997
FBgn0024365	1000	1000	997	3	1	3	997
FBgn0024366	1007	1000	972	42	7	6	965
FBgn0024371	768	767	767	2	2	1	766
FBgn0024432	1008	1000	1004	12	6	2	996
FBgn0024509	1008	1000	1002	14	5	2.8	994
FBgn0024542	1007	1000	999	15	3	5	992
FBgn0024555	1000	1000	986	14	5	2.8	986
FBgn0024689	1014	1000	1007	21	4	5.25	993
FBgn0024698	1018	1000	1001	35	9	3.888888888888889	983
FBgn0024728	1053	1000	697	409	15	27.266666666666666	644
FBgn0024732	1014	1000	970	58	12	4.833333333333333	956
FBgn0024734	1017	1000	1008	26	9	2.888888888888889	991
FBgn0024740	1032	1000	1024	40	4	10	992
FBgn0024754	744	727	713	48	4	12	696
FBgn0024806	1016	1000	1011	21	5	4.2	995
FBgn0024814	1035	1000	1023	47	7	6.714285714285714	988
FBgn0024833	1017	1000	1003	31	9	3.4444444444444446	986
FBgn0024846	1005	1000	933	77	10	7.7	928
FBgn0024897	1051	1000	1037	65	5	13	986
FBgn0024909	1000	1000	957	43	1	43	957
FBgn0024921	1024	1000	916	132	6	22	892
FBgn0024941	1002	1000	978	26	8	3.25	976
FBgn0024944	1008	1000	1007	9	2	4.5	999
FBgn0024945	1000	1000	1000	0	0	NA	1000
FBgn0024947	1001	1000	991	11	5	2.2	990
FBgn0024956	1019	1000	1014	24	7	3.4285714285714284	995
FBgn0024957	1007	1000	1004	10	4	2.5	997
FBgn0024963	1037	1000	1036	38	5	7.6	999
FBgn0024973	1000	1000	951	49	6	8.166666666666666	951
FBgn0024975	1052	1000	1042	62	4	15.5	990
FBgn0024980	1013	1000	975	51	5	10.2	962
FBgn0024983	1006	1000	987	25	9	2.7777777777777777	981
FBgn0024985	1013	1000	993	33	6	5.5	980
FBgn0024986	1023	1000	985	61	12	5.083333333333333	962
FBgn0024989	1025	1000	1023	27	6	4.5	998
FBgn0024991	1003	1000	984	22	4	5.5	981
FBgn0024992	1023	1000	1009	37	7	5.285714285714286	986
FBgn0024993	1008	1000	999	17	6	2.8333333333333335	991
FBgn0024994	1016	1000	978	54	12	4.5	962
FBgn0024995	1040	1000	1002	78	16	4.875	962
FBgn0024996	1016	1000	985	47	12	3.9166666666666665	969
FBgn0024997	1066	1000	1032	100	16	6.25	966
FBgn0024998	1000	1000	947	53	9	5.888888888888889	947
FBgn0025109	1019	1000	1014	24	7	3.4285714285714284	995
FBgn0025185	1006	1000	243	769	7	109.85714285714286	237
FBgn0025334	1027	1000	1011	43	9	4.777777777777778	984
FBgn0025335	1055	1000	1045	65	6	10.833333333333334	990
FBgn0025352	1085	1000	1052	118	8	14.75	967
FBgn0025360	1032	1000	990	74	7	10.571428571428571	958
FBgn0025378	1008	1000	977	39	6	6.5	969
FBgn0025382	1006	1000	1005	7	3	2.3333333333333335	999
FBgn0025383	864	864	854	10	2	5	854
FBgn0025388	1016	1000	985	47	6	7.833333333333333	969
FBgn0025391	1004	1000	983	25	6	4.166666666666667	979
FBgn0025393	1011	1000	1007	15	5	3	996
FBgn0025394	1001	1000	977	25	7	3.5714285714285716	976
FBgn0025457	1001	1000	986	16	5	3.2	985
FBgn0025463	1011	1000	1007	15	3	5	996
FBgn0025469	1025	1000	1014	36	9	4	989
FBgn0025519	1000	1000	996	4	1	4	996
FBgn0025525	1033	1000	997	69	12	5.75	964
FBgn0025558	1003	1000	983	23	4	5.75	980
FBgn0025571	1003	1000	991	15	4	3.75	988
FBgn0025573	1007	1000	971	43	7	6.142857142857143	964
FBgn0025578	1006	1000	1006	6	2	3	1000
FBgn0025583	1047	1000	998	96	15	6.4	951
FBgn0025592	1015	1000	1014	16	6	2.6666666666666665	999
FBgn0025595	1038	1000	1001	75	9	8.333333333333334	963
FBgn0025608	1013	1000	1012	14	2	7	999
FBgn0025612	1050	995	975	130	22	5.909090909090909	920
FBgn0025615	1007	1000	997	17	6	2.8333333333333335	990
FBgn0025621	1014	1000	1008	20	6	3.3333333333333335	994
FBgn0025625	831	819	817	26	7	3.7142857142857144	805
FBgn0025627	1000	1000	1000	0	0	NA	1000
FBgn0025628	1000	1000	1000	0	0	NA	1000
FBgn0025631	1020	1000	970	70	12	5.833333333333333	950
FBgn0025632	1001	1000	1001	1	1	1	1000
FBgn0025637	1010	1000	993	27	9	3	983
FBgn0025639	1033	1000	1009	57	15	3.8	976
FBgn0025640	875	839	826	85	15	5.666666666666667	790
FBgn0025641	1000	1000	997	3	1	3	997
FBgn0025642	1003	1000	993	13	5	2.6	990
FBgn0025644	1000	1000	961	39	10	3.9	961
FBgn0025678	1022	1000	961	83	13	6.384615384615385	939
FBgn0025679	1059	1000	1015	103	13	7.923076923076923	956
FBgn0025681	1000	1000	999	1	1	1	999
FBgn0025692	692	688	671	25	8	3.125	667
FBgn0025700	1038	1000	988	88	13	6.769230769230769	950
FBgn0025702	1002	1000	1002	2	1	2	1000
FBgn0025709	1019	1000	971	67	8	8.375	952
FBgn0025716	1052	1000	1051	53	3	17.666666666666668	999
FBgn0025720	1001	1000	962	40	6	6.666666666666667	961
FBgn0025724	1004	1000	957	51	8	6.375	953
FBgn0025725	782	782	782	0	0	NA	782
FBgn0025741	1005	1000	187	823	3	274.3333333333333	182
FBgn0025743	1037	1000	1008	66	12	5.5	971
FBgn0025777	1004	1000	964	44	7	6.285714285714286	960
FBgn0025781	1011	1000	996	26	8	3.25	985
FBgn0025802	799	799	798	1	1	1	798
FBgn0025807	1021	1000	982	60	5	12	961
FBgn0025808	1000	1000	983	17	6	2.8333333333333335	983
FBgn0025814	1066	1000	971	161	21	7.666666666666667	905
FBgn0025815	1048	1000	1021	75	9	8.333333333333334	973
FBgn0025820	1011	1000	999	23	4	5.75	988
FBgn0025832	1033	1000	915	151	8	18.875	882
FBgn0025833	1024	1000	1013	35	8	4.375	989
FBgn0025835	1013	1000	828	198	6	33	815
FBgn0025836	1028	1000	856	200	13	15.384615384615385	828
FBgn0025864	1000	1000	978	22	3	7.333333333333333	978
FBgn0025865	1067	1000	1052	82	10	8.2	985
FBgn0025866	1002	1000	984	20	4	5	982
FBgn0025874	1018	1000	986	50	8	6.25	968
FBgn0025878	1022	1000	1014	30	4	7.5	992
FBgn0025885	1084	1000	1007	161	23	7	923
FBgn0026015	1006	1000	993	19	4	4.75	987
FBgn0026056	930	924	601	335	5	67	595
FBgn0026058	1007	1000	755	259	10	25.9	748
FBgn0026059	1041	1000	1023	59	11	5.363636363636363	982
FBgn0026060	1001	1000	987	15	4	3.75	986
FBgn0026079	1002	1000	989	15	8	1.875	987
FBgn0026080	1002	1000	978	26	4	6.5	976
FBgn0026083	1002	1000	1002	2	1	2	1000
FBgn0026085	1001	1000	1001	1	1	1	1000
FBgn0026088	1010	1000	1009	11	4	2.75	999
FBgn0026089	1007	1000	1006	8	3	2.6666666666666665	999
FBgn0026136	1000	1000	994	6	1	6	994
FBgn0026141	1002	1000	862	142	9	15.777777777777779	860
FBgn0026143	1002	1000	825	179	2	89.5	823
FBgn0026144	1007	1000	977	37	10	3.7	970
FBgn0026149	1006	1000	999	13	7	1.8571428571428572	993
FBgn0026150	1001	1000	991	11	2	5.5	990
FBgn0026160	1047	1000	1042	52	9	5.777777777777778	995
FBgn0026162	1063	1000	988	138	14	9.857142857142858	925
FBgn0026175	1011	1000	337	685	5	137	326
FBgn0026176	1000	1000	971	29	4	7.25	971
FBgn0026179	1012	1000	990	34	9	3.7777777777777777	978
FBgn0026181	1004	1000	980	28	8	3.5	976
FBgn0026192	1009	1000	1001	17	7	2.4285714285714284	992
FBgn0026238	1030	1000	350	710	9	78.88888888888889	320
FBgn0026239	1025	1000	1002	48	9	5.333333333333333	977
FBgn0026250	1001	1000	989	13	4	3.25	988
FBgn0026252	1008	1000	994	22	5	4.4	986
FBgn0026257	1008	1000	993	23	7	3.2857142857142856	985
FBgn0026259	1054	1000	991	117	11	10.636363636363637	937
FBgn0026261	1000	1000	995	5	1	5	995
FBgn0026263	1001	1000	986	16	6	2.6666666666666665	985
FBgn0026268	990	947	853	180	9	20	810
FBgn0026309	1058	1000	981	135	17	7.9411764705882355	923
FBgn0026313	1047	1000	1044	50	8	6.25	997
FBgn0026314	753	697	742	67	11	6.090909090909091	686
FBgn0026315	961	910	883	129	17	7.588235294117647	832
FBgn0026316	1003	1000	988	18	6	3	985
FBgn0026317	1001	1000	1000	2	2	1	999
FBgn0026319	1061	1000	1050	72	12	6	989
FBgn0026324	799	799	799	0	0	NA	799
FBgn0026326	1021	1000	1019	23	7	3.2857142857142856	998
FBgn0026369	1001	1000	998	4	4	1	997
FBgn0026371	1015	1000	991	39	11	3.5454545454545454	976
FBgn0026373	1033	1000	1022	44	4	11	989
FBgn0026374	897	887	830	77	13	5.923076923076923	820
FBgn0026378	1000	1000	987	13	4	3.25	987
FBgn0026379	1021	1000	998	44	15	2.933333333333333	977
FBgn0026380	1000	1000	975	25	6	4.166666666666667	975
FBgn0026384	1009	1000	989	29	12	2.4166666666666665	980
FBgn0026385	1018	1000	984	52	7	7.428571428571429	966
FBgn0026392	1017	1000	902	132	8	16.5	885
FBgn0026394	1016	1000	872	160	8	20	856
FBgn0026396	1014	1000	994	34	9	3.7777777777777777	980
FBgn0026398	1041	1000	1025	57	8	7.125	984
FBgn0026399	1017	1000	972	62	5	12.4	955
FBgn0026402	1041	1000	1028	54	5	10.8	987
FBgn0026404	1001	1000	938	64	8	8	937
FBgn0026411	1008	1000	997	19	7	2.7142857142857144	989
FBgn0026415	1032	1000	981	83	11	7.545454545454546	949
FBgn0026427	1008	1000	968	48	7	6.857142857142857	960
FBgn0026428	1006	1000	1005	7	2	3.5	999
FBgn0026432	744	732	706	50	9	5.555555555555555	694
FBgn0026438	1000	1000	978	22	7	3.142857142857143	978
FBgn0026439	1011	1000	1008	14	2	7	997
FBgn0026479	1056	1000	1022	90	16	5.625	966
FBgn0026533	1093	1000	1068	118	15	7.866666666666666	975
FBgn0026562	1012	1000	978	46	5	9.2	966
FBgn0026566	1048	1000	1033	63	11	5.7272727272727275	985
FBgn0026570	721	672	690	80	10	8	641
FBgn0026573	1073	1000	1056	90	15	6	983
FBgn0026575	1003	1000	998	8	3	2.6666666666666665	995
FBgn0026576	1000	1000	997	3	1	3	997
FBgn0026577	1083	1000	1034	132	20	6.6	951
FBgn0026582	1020	1000	995	45	9	5	975
FBgn0026592	1016	1000	991	41	11	3.727272727272727	975
FBgn0026593	1056	1000	1041	71	13	5.461538461538462	985
FBgn0026597	1002	1000	1002	2	2	1	1000
FBgn0026598	1009	1000	995	23	6	3.8333333333333335	986
FBgn0026602	1036	1000	1026	46	12	3.8333333333333335	990
FBgn0026616	719	708	707	23	5	4.6	696
FBgn0026619	790	781	787	12	2	6	778
FBgn0026630	1008	1000	440	576	6	96	432
FBgn0026634	1001	1000	997	5	3	1.6666666666666667	996
FBgn0026666	1007	1000	1000	14	7	2	993
FBgn0026702	1003	1000	987	19	6	3.1666666666666665	984
FBgn0026718	1022	1000	1016	28	6	4.666666666666667	994
FBgn0026722	1004	1000	1004	4	1	4	1000
FBgn0026738	994	994	968	26	5	5.2	968
FBgn0026741	1002	1000	992	12	6	2	990
FBgn0026749	1030	1000	1023	37	7	5.285714285714286	993
FBgn0026751	1001	1000	977	25	9	2.7777777777777777	976
FBgn0026754	1003	1000	648	358	9	39.77777777777778	645
FBgn0026755	1029	1000	991	67	9	7.444444444444445	962
FBgn0026756	1025	1000	1000	50	8	6.25	975
FBgn0026761	1014	1000	990	38	5	7.6	976
FBgn0026787	1029	1000	1020	38	12	3.1666666666666665	991
FBgn0026872	1001	1000	1000	2	2	1	999
FBgn0026873	1013	1000	1013	13	3	4.333333333333333	1000
FBgn0026874	1023	1000	1020	26	9	2.888888888888889	997
FBgn0026876	1020	1000	986	54	10	5.4	966
FBgn0026878	1010	1000	998	22	7	3.142857142857143	988
FBgn0026879	1023	1000	1023	23	5	4.6	1000
FBgn0027053	1016	1000	978	54	8	6.75	962
FBgn0027054	1041	1000	1024	58	6	9.666666666666666	983
FBgn0027055	1002	1000	710	294	2	147	708
FBgn0027057	1001	1000	627	375	2	187.5	626
FBgn0027074	1017	1000	988	46	15	3.066666666666667	971
FBgn0027079	1021	1000	989	53	13	4.076923076923077	968
FBgn0027081	1018	1000	1016	20	4	5	998
FBgn0027082	1001	1000	997	5	3	1.6666666666666667	996
FBgn0027084	1028	1000	1020	36	6	6	992
FBgn0027085	1017	1000	982	52	9	5.777777777777778	965
FBgn0027086	1050	1000	1023	77	13	5.923076923076923	973
FBgn0027088	1017	1000	918	116	15	7.733333333333333	901
FBgn0027090	1000	1000	990	10	2	5	990
FBgn0027093	1000	1000	992	8	5	1.6	992
FBgn0027095	1002	1000	1001	3	3	1	999
FBgn0027101	1045	1000	508	582	13	44.76923076923077	463
FBgn0027106	1051	1000	1031	71	14	5.071428571428571	980
FBgn0027107	1069	1000	1034	104	13	8	965
FBgn0027108	1066	1000	1031	101	15	6.733333333333333	965
FBgn0027109	1010	1000	1002	18	6	3	992
FBgn0027259	1032	1000	1012	52	8	6.5	980
FBgn0027280	1035	1000	1034	36	7	5.142857142857143	999
FBgn0027287	1011	1000	995	27	5	5.4	984
FBgn0027291	1012	1000	1011	13	4	3.25	999
FBgn0027330	1006	1000	967	45	8	5.625	961
FBgn0027334	1010	1000	373	647	8	80.875	363
FBgn0027338	1037	1000	1006	68	10	6.8	969
FBgn0027339	1002	1000	984	20	7	2.857142857142857	982
FBgn0027342	1033	1000	962	104	16	6.5	929
FBgn0027343	1042	1000	1023	61	9	6.777777777777778	981
FBgn0027348	1071	1000	991	151	23	6.565217391304348	920
FBgn0027356	1028	1000	946	110	13	8.461538461538462	918
FBgn0027359	1041	1000	1001	81	10	8.1	960
FBgn0027363	1053	1000	1049	57	7	8.142857142857142	996
FBgn0027364	1038	1000	1020	56	9	6.222222222222222	982
FBgn0027375	1012	1000	817	207	10	20.7	805
FBgn0027490	1048	1000	1048	48	5	9.6	1000
FBgn0027492	1058	1000	1049	67	10	6.7	991
FBgn0027494	1023	1000	986	60	6	10	963
FBgn0027495	1001	1000	982	20	3	6.666666666666667	981
FBgn0027496	1018	1000	1013	23	7	3.2857142857142856	995
FBgn0027497	1003	1000	984	22	5	4.4	981
FBgn0027499	1010	1000	1004	16	7	2.2857142857142856	994
FBgn0027503	1027	1000	1016	38	7	5.428571428571429	989
FBgn0027504	1012	1000	1009	15	4	3.75	997
FBgn0027509	1009	1000	997	21	7	3	988
FBgn0027514	1008	1000	1004	12	4	3	996
FBgn0027515	710	689	700	31	7	4.428571428571429	679
FBgn0027521	961	936	934	52	15	3.466666666666667	909
FBgn0027524	1036	1000	1013	59	13	4.538461538461538	977
FBgn0027525	1038	1000	998	78	12	6.5	960
FBgn0027526	1008	1000	1005	11	5	2.2	997
FBgn0027527	1016	1000	998	34	8	4.25	982
FBgn0027528	1002	1000	981	23	6	3.8333333333333335	979
FBgn0027535	1028	1000	1014	42	10	4.2	986
FBgn0027539	940	916	932	32	7	4.571428571428571	908
FBgn0027546	1008	1000	964	52	7	7.428571428571429	956
FBgn0027550	1032	1000	1016	48	9	5.333333333333333	984
FBgn0027552	1032	1000	1020	44	11	4	988
FBgn0027553	1009	1000	998	20	4	5	989
FBgn0027554	792	750	754	80	10	8	712
FBgn0027556	1000	1000	969	31	4	7.75	969
FBgn0027558	728	721	256	479	7	68.42857142857143	249
FBgn0027560	1000	1000	996	4	2	2	996
FBgn0027561	1005	1000	879	131	10	13.1	874
FBgn0027562	1011	1000	1000	22	7	3.142857142857143	989
FBgn0027563	1040	1000	1025	55	9	6.111111111111111	985
FBgn0027564	1000	1000	984	16	7	2.2857142857142856	984
FBgn0027565	1045	1000	1034	56	10	5.6	989
FBgn0027568	1001	1000	976	26	7	3.7142857142857144	975
FBgn0027569	748	713	729	54	9	6	694
FBgn0027575	1000	1000	1000	0	0	NA	1000
FBgn0027578	822	787	775	82	7	11.714285714285714	740
FBgn0027580	1026	1000	1002	50	11	4.545454545454546	976
FBgn0027583	1001	1000	988	14	3	4.666666666666667	987
FBgn0027584	1011	1000	955	67	11	6.090909090909091	944
FBgn0027585	1002	1000	972	32	2	16	970
FBgn0027586	1055	1000	1031	79	10	7.9	976
FBgn0027589	1004	1000	991	17	4	4.25	987
FBgn0027592	1047	1000	1024	70	10	7	977
FBgn0027596	1047	1000	973	121	17	7.117647058823529	926
FBgn0027597	1045	1000	1019	71	8	8.875	974
FBgn0027599	1002	1000	995	9	6	1.5	993
FBgn0027600	1002	1000	931	73	16	4.5625	929
FBgn0027602	735	710	712	48	6	8	687
FBgn0027608	1000	1000	973	27	4	6.75	973
FBgn0027609	1000	1000	991	9	1	9	991
FBgn0027610	1011	1000	941	81	9	9	930
FBgn0027611	1070	1000	983	157	20	7.85	913
FBgn0027616	1000	1000	1000	0	0	NA	1000
FBgn0027620	1004	1000	988	20	5	4	984
FBgn0027654	1001	1000	991	11	5	2.2	990
FBgn0027655	1008	1000	998	18	4	4.5	990
FBgn0027657	1045	1000	1040	50	9	5.555555555555555	995
FBgn0027783	1002	1000	991	13	5	2.6	989
FBgn0027784	1015	1000	996	34	7	4.857142857142857	981
FBgn0027785	1003	1000	1003	3	1	3	1000
FBgn0027786	1003	1000	978	28	5	5.6	975
FBgn0027788	1019	1000	963	75	7	10.714285714285714	944
FBgn0027790	1042	1000	985	99	10	9.9	943
FBgn0027835	1014	1000	969	59	7	8.428571428571429	955
FBgn0027836	1019	1000	434	604	14	43.142857142857146	415
FBgn0027841	1012	1000	1001	23	7	3.2857142857142856	989
FBgn0027843	1026	1000	1015	37	14	2.642857142857143	989
FBgn0027844	1028	1000	994	62	19	3.263157894736842	966
FBgn0027864	1049	1000	1000	98	11	8.909090909090908	951
FBgn0027865	1010	1000	609	411	3	137	599
FBgn0027889	1000	1000	990	10	2	5	990
FBgn0027929	1093	1000	1036	150	20	7.5	943
FBgn0027932	1000	1000	680	320	1	320	680
FBgn0027934	1006	1000	992	20	4	5	986
FBgn0027945	727	696	714	44	5	8.8	683
FBgn0027949	1024	1000	1003	45	10	4.5	979
FBgn0027950	1001	1000	989	13	3	4.333333333333333	988
FBgn0027951	1022	1000	982	62	7	8.857142857142858	960
FBgn0028325	1024	1000	1016	32	7	4.571428571428571	992
FBgn0028327	1026	1000	1020	32	9	3.5555555555555554	994
FBgn0028342	1012	1000	1006	18	7	2.5714285714285716	994
FBgn0028343	1073	1000	1045	101	10	10.1	972
FBgn0028369	1063	1000	1009	117	13	9	946
FBgn0028370	1032	1000	974	90	15	6	942
FBgn0028371	1001	1000	971	31	6	5.166666666666667	970
FBgn0028372	1007	1000	939	75	10	7.5	932
FBgn0028374	1079	1000	1056	102	13	7.846153846153846	977
FBgn0028381	1013	1000	996	30	10	3	983
FBgn0028394	1039	1000	993	85	9	9.444444444444445	954
FBgn0028398	818	799	793	44	9	4.888888888888889	774
FBgn0028399	1022	1000	964	80	18	4.444444444444445	942
FBgn0028400	1031	1000	1022	40	7	5.714285714285714	991
FBgn0028402	1044	1000	1005	83	13	6.384615384615385	961
FBgn0028406	1014	1000	1012	16	5	3.2	998
FBgn0028408	1012	1000	1012	12	3	4	1000
FBgn0028412	1008	1000	998	18	5	3.6	990
FBgn0028416	1075	1000	1028	122	8	15.25	953
FBgn0028418	1023	1000	1014	32	8	4	991
FBgn0028421	1022	1000	1005	39	6	6.5	983
FBgn0028424	1024	1000	1000	48	8	6	976
FBgn0028425	1005	1000	1003	7	3	2.3333333333333335	998
FBgn0028426	1002	1000	922	82	5	16.4	920
FBgn0028427	1004	1000	972	36	7	5.142857142857143	968
FBgn0028434	1002	1000	992	12	4	3	990
FBgn0028436	1007	1000	961	53	11	4.818181818181818	954
FBgn0028467	1033	1000	1013	53	7	7.571428571428571	980
FBgn0028468	1021	1000	1010	32	8	4	989
FBgn0028473	1021	1000	1009	33	9	3.6666666666666665	988
FBgn0028475	1001	1000	998	4	2	2	997
FBgn0028476	1047	1000	1031	63	9	7	984
FBgn0028479	1015	1000	951	79	12	6.583333333333333	936
FBgn0028480	1012	1000	997	27	7	3.857142857142857	985
FBgn0028481	1064	1000	1050	78	10	7.8	986
FBgn0028482	1066	1000	1043	89	12	7.416666666666667	977
FBgn0028484	1039	1000	1023	55	12	4.583333333333333	984
FBgn0028487	1002	1000	1002	2	1	2	1000
FBgn0028490	1149	1000	1098	200	24	8.333333333333334	949
FBgn0028491	1031	1000	1028	34	9	3.7777777777777777	997
FBgn0028496	1003	1000	989	17	7	2.4285714285714284	986
FBgn0028499	1006	1000	1004	8	2	4	998
FBgn0028504	1008	1000	963	53	10	5.3	955
FBgn0028506	1002	1000	945	59	5	11.8	943
FBgn0028507	1028	1000	718	338	10	33.8	690
FBgn0028509	1000	1000	993	7	5	1.4	993
FBgn0028513	1000	1000	953	47	8	5.875	953
FBgn0028515	1003	1000	741	265	6	44.166666666666664	738
FBgn0028520	1030	1000	1019	41	7	5.857142857142857	989
FBgn0028525	1005	1000	963	47	7	6.714285714285714	958
FBgn0028527	1031	1000	971	91	10	9.1	940
FBgn0028540	1006	1000	947	65	10	6.5	941
FBgn0028542	1018	1000	987	49	8	6.125	969
FBgn0028544	1016	1000	1010	22	3	7.333333333333333	994
FBgn0028546	1011	1000	974	48	11	4.363636363636363	963
FBgn0028550	1013	1000	1002	24	7	3.4285714285714284	989
FBgn0028552	1002	1000	998	6	3	2	996
FBgn0028554	1008	1000	980	36	13	2.769230769230769	972
FBgn0028560	1010	1000	906	114	5	22.8	896
FBgn0028562	815	815	814	1	1	1	814
FBgn0028567	1015	1000	1005	25	7	3.5714285714285716	990
FBgn0028570	1017	1000	1003	31	5	6.2	986
FBgn0028572	1013	1000	771	255	7	36.42857142857143	758
FBgn0028573	1006	1000	990	22	6	3.6666666666666665	984
FBgn0028579	1070	1000	995	145	15	9.666666666666666	925
FBgn0028582	1016	1000	1002	30	11	2.727272727272727	986
FBgn0028583	1031	1000	952	110	13	8.461538461538462	921
FBgn0028644	1057	1000	1054	60	9	6.666666666666667	997
FBgn0028645	1089	1000	1056	122	17	7.176470588235294	967
FBgn0028646	1020	1000	983	57	7	8.142857142857142	963
FBgn0028647	1001	1000	988	14	5	2.8	987
FBgn0028648	1001	1000	961	41	6	6.833333333333333	960
FBgn0028658	1000	1000	998	2	2	1	998
FBgn0028662	1009	1000	974	44	6	7.333333333333333	965
FBgn0028667	1029	1000	977	81	12	6.75	948
FBgn0028669	1001	1000	914	88	5	17.6	913
FBgn0028671	1000	1000	997	3	2	1.5	997
FBgn0028675	715	714	676	40	6	6.666666666666667	675
FBgn0028684	1000	1000	998	2	1	2	998
FBgn0028685	1000	1000	1000	0	0	NA	1000
FBgn0028686	1005	1000	993	17	7	2.4285714285714284	988
FBgn0028688	1001	1000	993	9	3	3	992
FBgn0028690	1008	1000	968	48	4	12	960
FBgn0028691	1024	1000	1023	25	6	4.166666666666667	999
FBgn0028692	1004	1000	999	9	3	3	995
FBgn0028695	1008	1000	296	720	5	144	288
FBgn0028699	1000	1000	982	18	2	9	982
FBgn0028700	1001	1000	982	20	3	6.666666666666667	981
FBgn0028703	717	702	498	234	9	26	483
FBgn0028704	1001	1000	927	75	7	10.714285714285714	926
FBgn0028707	1014	1000	1001	27	4	6.75	987
FBgn0028708	1026	1000	988	64	10	6.4	962
FBgn0028717	1031	1000	1011	51	9	5.666666666666667	980
FBgn0028734	1015	1000	1000	30	7	4.285714285714286	985
FBgn0028737	1065	1000	1022	108	15	7.2	957
FBgn0028740	1026	1000	992	60	12	5	966
FBgn0028789	1001	1000	990	12	6	2	989
FBgn0028836	1038	1000	1010	66	11	6	972
FBgn0028837	1058	1000	1006	110	11	10	948
FBgn0028844	1018	1000	992	44	7	6.285714285714286	974
FBgn0028847	1012	1000	965	59	9	6.555555555555555	953
FBgn0028850	1063	1000	857	269	6	44.833333333333336	794
FBgn0028852	1025	1000	984	66	9	7.333333333333333	959
FBgn0028853	1087	1000	1040	134	14	9.571428571428571	953
FBgn0028855	1001	1000	976	26	6	4.333333333333333	975
FBgn0028857	1025	1000	1015	35	6	5.833333333333333	990
FBgn0028858	1005	1000	991	19	7	2.7142857142857144	986
FBgn0028862	1032	1000	743	321	17	18.88235294117647	711
FBgn0028866	1016	1000	999	33	8	4.125	983
FBgn0028868	1005	1000	962	48	7	6.857142857142857	957
FBgn0028870	1028	1000	981	75	14	5.357142857142857	953
FBgn0028871	1001	1000	950	52	7	7.428571428571429	949
FBgn0028875	1021	1000	1013	29	5	5.8	992
FBgn0028878	1050	1000	1042	58	14	4.142857142857143	992
FBgn0028882	1002	1000	950	54	5	10.8	948
FBgn0028884	1022	1000	984	60	15	4	962
FBgn0028887	1028	1000	989	67	8	8.375	961
FBgn0028888	1004	1000	994	14	6	2.3333333333333335	990
FBgn0028889	1021	1000	1018	24	6	4	997
FBgn0028892	1026	1000	1014	38	8	4.75	988
FBgn0028893	1023	1000	983	63	9	7	960
FBgn0028894	1054	1000	1006	102	8	12.75	952
FBgn0028895	1007	1000	992	22	7	3.142857142857143	985
FBgn0028897	1026	1000	1001	51	8	6.375	975
FBgn0028900	1032	1000	1008	56	8	7	976
FBgn0028903	1005	1000	989	21	8	2.625	984
FBgn0028909	1043	1000	981	105	18	5.833333333333333	938
FBgn0028912	1011	1000	951	71	10	7.1	940
FBgn0028913	1000	1000	990	10	4	2.5	990
FBgn0028919	1000	1000	999	1	1	1	999
FBgn0028920	1005	1000	995	15	6	2.5	990
FBgn0028926	1019	1000	972	66	9	7.333333333333333	953
FBgn0028935	1027	1000	1009	45	6	7.5	982
FBgn0028936	1000	1000	981	19	3	6.333333333333333	981
FBgn0028938	1050	1000	1007	93	15	6.2	957
FBgn0028939	786	746	759	67	12	5.583333333333333	719
FBgn0028940	1007	1000	983	31	8	3.875	976
FBgn0028941	695	693	660	37	6	6.166666666666667	658
FBgn0028942	1004	1000	970	38	9	4.222222222222222	966
FBgn0028945	1006	1000	915	97	9	10.777777777777779	909
FBgn0028946	1014	1000	980	48	5	9.6	966
FBgn0028947	1052	1000	1022	82	10	8.2	970
FBgn0028948	1038	1000	1007	69	10	6.9	969
FBgn0028949	753	690	731	85	12	7.083333333333333	668
FBgn0028950	800	798	794	8	4	2	792
FBgn0028952	1009	1000	1000	18	7	2.5714285714285716	991
FBgn0028962	1001	1000	1001	1	1	1	1000
FBgn0028965	1072	1000	1053	91	10	9.1	981
FBgn0028968	1010	1000	974	46	14	3.2857142857142856	964
FBgn0028978	1058	1000	1050	66	9	7.333333333333333	992
FBgn0028980	1002	1000	764	240	4	60	762
FBgn0028981	1046	1000	1013	79	15	5.266666666666667	967
FBgn0028982	1029	1000	1008	50	15	3.3333333333333335	979
FBgn0028983	1011	1000	1002	20	6	3.3333333333333335	991
FBgn0028987	1041	1000	998	84	8	10.5	957
FBgn0028992	1026	1000	1022	30	6	5	996
FBgn0028996	1087	1000	1058	116	14	8.285714285714286	971
FBgn0028997	715	702	673	55	9	6.111111111111111	660
FBgn0028999	1002	1000	988	16	6	2.6666666666666665	986
FBgn0029002	1030	1000	1002	58	12	4.833333333333333	972
FBgn0029003	1000	1000	981	19	4	4.75	981
FBgn0029006	1001	1000	971	31	5	6.2	970
FBgn0029067	1022	1000	1018	26	5	5.2	996
FBgn0029079	1005	1000	997	13	7	1.8571428571428572	992
FBgn0029088	1004	1000	1001	7	4	1.75	997
FBgn0029094	1008	1000	913	103	8	12.875	905
FBgn0029105	1025	1000	1002	48	5	9.6	977
FBgn0029113	1047	1000	1032	62	10	6.2	985
FBgn0029114	1022	1000	993	51	9	5.666666666666667	971
FBgn0029117	1002	1000	998	6	3	2	996
FBgn0029118	1000	1000	995	5	2	2.5	995
FBgn0029121	1014	1000	1011	17	2	8.5	997
FBgn0029123	1000	1000	968	32	5	6.4	968
FBgn0029133	1009	1000	991	27	6	4.5	982
FBgn0029134	1064	1000	1050	78	11	7.090909090909091	986
FBgn0029137	1018	1000	1016	20	4	5	998
FBgn0029147	1017	1000	994	40	7	5.714285714285714	977
FBgn0029152	1051	1000	969	133	26	5.115384615384615	918
FBgn0029157	1001	1000	987	15	3	5	986
FBgn0029158	1038	1000	1022	54	9	6	984
FBgn0029167	1103	1000	1055	151	12	12.583333333333334	952
FBgn0029172	1089	1000	1069	109	21	5.190476190476191	980
FBgn0029502	927	927	193	734	4	183.5	193
FBgn0029503	1015	1000	984	46	7	6.571428571428571	969
FBgn0029504	1002	1000	965	39	9	4.333333333333333	963
FBgn0029506	1060	1000	957	163	16	10.1875	897
FBgn0029507	1071	1000	994	148	15	9.866666666666667	923
FBgn0029508	1039	1000	994	84	14	6	955
FBgn0029512	1004	1000	977	31	4	7.75	973
FBgn0029514	1000	1000	717	283	3	94.33333333333333	717
FBgn0029518	1072	1000	1037	107	16	6.6875	965
FBgn0029522	1018	1000	790	246	5	49.2	772
FBgn0029529	1047	1000	1040	54	10	5.4	993
FBgn0029531	839	837	835	6	5	1.2	833
FBgn0029532	1004	1000	968	40	10	4	964
FBgn0029535	1047	1000	1034	60	10	6	987
FBgn0029539	1023	1000	1019	27	3	9	996
FBgn0029552	1020	1000	995	45	7	6.428571428571429	975
FBgn0029568	857	855	846	13	7	1.8571428571428572	844
FBgn0029573	1015	1000	967	63	3	21	952
FBgn0029587	1001	1000	980	22	5	4.4	979
FBgn0029588	1031	1000	1023	39	7	5.571428571428571	992
FBgn0029594	1026	1000	1025	27	5	5.4	999
FBgn0029603	1034	1000	986	82	6	13.666666666666666	952
FBgn0029606	1017	1000	1011	23	5	4.6	994
FBgn0029608	1000	1000	939	61	11	5.545454545454546	939
FBgn0029639	1056	1000	1024	88	15	5.866666666666666	968
FBgn0029649	1032	1000	909	155	14	11.071428571428571	877
FBgn0029657	1077	1000	980	174	13	13.384615384615385	903
FBgn0029659	1047	1000	1004	90	17	5.294117647058823	957
FBgn0029662	1008	1000	849	167	12	13.916666666666666	841
FBgn0029663	1014	1000	992	36	12	3	978
FBgn0029665	1092	1000	1059	125	12	10.416666666666666	967
FBgn0029667	1019	1000	967	71	9	7.888888888888889	948
FBgn0029681	1033	1000	997	69	12	5.75	964
FBgn0029686	1038	1000	1020	56	8	7	982
FBgn0029690	1045	1000	1032	58	12	4.833333333333333	987
FBgn0029693	1040	1000	949	131	9	14.555555555555555	909
FBgn0029694	1016	1000	968	64	11	5.818181818181818	952
FBgn0029696	1009	1000	997	21	9	2.3333333333333335	988
FBgn0029697	1009	1000	1001	17	8	2.125	992
FBgn0029700	1033	1000	1025	41	10	4.1	992
FBgn0029701	1019	1000	830	208	9	23.11111111111111	811
FBgn0029702	1029	1000	1014	44	9	4.888888888888889	985
FBgn0029703	1005	1000	729	281	12	23.416666666666668	724
FBgn0029705	1023	1000	983	63	16	3.9375	960
FBgn0029708	1008	1000	980	36	11	3.272727272727273	972
FBgn0029709	1001	1000	987	15	7	2.142857142857143	986
FBgn0029712	1001	1000	987	15	6	2.5	986
FBgn0029714	1000	1000	993	7	2	3.5	993
FBgn0029716	1054	1000	987	121	19	6.368421052631579	933
FBgn0029718	1003	1000	944	62	13	4.769230769230769	941
FBgn0029719	1042	1000	974	110	16	6.875	932
FBgn0029720	1034	1000	991	77	13	5.923076923076923	957
FBgn0029725	1027	1000	1008	46	11	4.181818181818182	981
FBgn0029726	1005	1000	960	50	8	6.25	955
FBgn0029727	1057	1000	984	130	12	10.833333333333334	927
FBgn0029729	1034	1000	973	95	13	7.3076923076923075	939
FBgn0029733	1033	1000	995	71	10	7.1	962
FBgn0029736	1010	1000	963	57	17	3.3529411764705883	953
FBgn0029737	1001	1000	975	27	9	3	974
FBgn0029747	1062	1000	974	150	16	9.375	912
FBgn0029750	709	702	649	67	11	6.090909090909091	642
FBgn0029752	1011	1000	794	228	9	25.333333333333332	783
FBgn0029754	1006	1000	975	37	4	9.25	969
FBgn0029756	1009	1000	982	36	13	2.769230769230769	973
FBgn0029762	1021	1000	932	110	17	6.470588235294118	911
FBgn0029763	1013	1000	715	311	13	23.923076923076923	702
FBgn0029768	1008	1000	928	88	20	4.4	920
FBgn0029769	1026	1000	988	64	17	3.764705882352941	962
FBgn0029770	1015	1000	932	98	10	9.8	917
FBgn0029771	1018	1000	953	83	8	10.375	935
FBgn0029778	1007	1000	982	32	10	3.2	975
FBgn0029783	1003	1000	946	60	6	10	943
FBgn0029785	1054	1000	1031	77	11	7	977
FBgn0029798	1015	1000	1007	23	4	5.75	992
FBgn0029799	702	694	634	76	8	9.5	626
FBgn0029801	1011	1000	995	27	5	5.4	984
FBgn0029804	1068	1000	1001	135	12	11.25	933
FBgn0029807	1018	1000	969	67	11	6.090909090909091	951
FBgn0029809	1000	1000	990	10	6	1.6666666666666667	990
FBgn0029810	1000	1000	998	2	2	1	998
FBgn0029811	1037	1000	976	98	15	6.533333333333333	939
FBgn0029813	1029	1000	1009	49	9	5.444444444444445	980
FBgn0029816	1003	1000	895	111	9	12.333333333333334	892
FBgn0029819	1036	1000	1003	69	17	4.0588235294117645	967
FBgn0029820	1003	1000	1000	6	3	2	997
FBgn0029821	1004	1000	944	64	12	5.333333333333333	940
FBgn0029823	1024	1000	1014	34	8	4.25	990
FBgn0029824	1036	1000	994	78	15	5.2	958
FBgn0029827	1020	1000	966	74	13	5.6923076923076925	946
FBgn0029828	1029	1000	942	116	15	7.733333333333333	913
FBgn0029830	1001	1000	948	54	8	6.75	947
FBgn0029831	1030	1000	999	61	12	5.083333333333333	969
FBgn0029834	1018	1000	1001	35	10	3.5	983
FBgn0029835	1003	1000	977	29	9	3.2222222222222223	974
FBgn0029836	1013	1000	863	163	10	16.3	850
FBgn0029838	1010	1000	998	22	10	2.2	988
FBgn0029839	1063	1000	1013	113	10	11.3	950
FBgn0029848	1004	1000	979	29	7	4.142857142857143	975
FBgn0029851	1040	1000	1009	71	9	7.888888888888889	969
FBgn0029853	1033	1000	982	84	12	7	949
FBgn0029857	1000	1000	999	1	1	1	999
FBgn0029858	1003	1000	1000	6	3	2	997
FBgn0029860	1000	1000	991	9	2	4.5	991
FBgn0029861	1015	1000	978	52	11	4.7272727272727275	963
FBgn0029863	1003	1000	961	45	14	3.2142857142857144	958
FBgn0029864	1017	1000	959	75	16	4.6875	942
FBgn0029867	1045	1000	1011	79	7	11.285714285714286	966
FBgn0029870	1008	1000	946	70	5	14	938
FBgn0029873	1047	1000	995	99	16	6.1875	948
FBgn0029874	1033	1000	1026	40	8	5	993
FBgn0029877	986	986	916	70	11	6.363636363636363	916
FBgn0029881	765	750	724	56	12	4.666666666666667	709
FBgn0029882	1013	1000	997	29	10	2.9	984
FBgn0029885	1016	1000	998	34	5	6.8	982
FBgn0029887	1025	1000	1000	50	6	8.333333333333334	975
FBgn0029888	1031	1000	998	64	19	3.3684210526315788	967
FBgn0029892	1004	1000	580	428	5	85.6	576
FBgn0029894	1077	1000	1060	94	11	8.545454545454545	983
FBgn0029895	1077	1000	1060	94	11	8.545454545454545	983
FBgn0029896	1010	1000	983	37	9	4.111111111111111	973
FBgn0029898	1004	1000	951	57	10	5.7	947
FBgn0029903	1017	1000	1005	29	4	7.25	988
FBgn0029905	1007	1000	998	16	2	8	991
FBgn0029906	1006	1000	997	15	2	7.5	991
FBgn0029909	1051	1000	1012	90	11	8.181818181818182	961
FBgn0029911	1021	1000	1013	29	8	3.625	992
FBgn0029912	1043	1000	1021	65	15	4.333333333333333	978
FBgn0029913	1013	1000	1007	19	5	3.8	994
FBgn0029914	1013	1000	1010	16	5	3.2	997
FBgn0029915	1015	1000	1009	21	7	3	994
FBgn0029922	1037	1000	987	87	21	4.142857142857143	950
FBgn0029924	1023	1000	996	50	9	5.555555555555555	973
FBgn0029925	1000	1000	972	28	13	2.1538461538461537	972
FBgn0029928	1013	1000	991	35	4	8.75	978
FBgn0029929	1006	1000	1001	11	3	3.6666666666666665	995
FBgn0029930	1001	1000	986	16	6	2.6666666666666665	985
FBgn0029931	1001	1000	823	179	6	29.833333333333332	822
FBgn0029932	1060	1000	1029	91	15	6.066666666666666	969
FBgn0029935	730	719	636	105	13	8.076923076923077	625
FBgn0029936	1038	1000	1023	53	14	3.7857142857142856	985
FBgn0029937	1025	1000	1021	29	8	3.625	996
FBgn0029939	1021	1000	964	78	12	6.5	943
FBgn0029940	1026	1000	932	120	11	10.909090909090908	906
FBgn0029942	1001	1000	958	44	11	4	957
FBgn0029944	1008	1000	968	48	9	5.333333333333333	960
FBgn0029945	1005	1000	964	46	11	4.181818181818182	959
FBgn0029947	1031	1000	900	162	13	12.461538461538462	869
FBgn0029948	1004	1000	1002	6	3	2	998
FBgn0029950	1009	1000	992	26	9	2.888888888888889	983
FBgn0029951	1012	1000	979	45	6	7.5	967
FBgn0029952	1022	1000	1002	42	5	8.4	980
FBgn0029955	1000	1000	981	19	7	2.7142857142857144	981
FBgn0029957	1009	1000	1009	9	2	4.5	1000
FBgn0029958	1002	1000	995	9	6	1.5	993
FBgn0029959	1031	1000	1020	42	6	7	989
FBgn0029961	1000	1000	997	3	3	1	997
FBgn0029962	1011	1000	981	41	8	5.125	970
FBgn0029963	1017	1000	1005	29	9	3.2222222222222223	988
FBgn0029964	1041	1000	849	233	13	17.923076923076923	808
FBgn0029965	1021	1000	1021	21	2	10.5	1000
FBgn0029966	783	753	737	76	9	8.444444444444445	707
FBgn0029968	1037	1000	1030	44	7	6.285714285714286	993
FBgn0029970	1045	1000	996	94	9	10.444444444444445	951
FBgn0029974	1017	1000	1009	25	9	2.7777777777777777	992
FBgn0029975	1021	1000	1015	27	8	3.375	994
FBgn0029977	1001	1000	997	5	4	1.25	996
FBgn0029986	1003	1000	931	75	11	6.818181818181818	928
FBgn0029987	1009	1000	954	64	10	6.4	945
FBgn0029990	1009	1000	962	56	14	4	953
FBgn0029992	1016	1000	1011	21	8	2.625	995
FBgn0029993	1009	1000	1003	15	5	3	994
FBgn0029994	1026	1000	962	90	17	5.294117647058823	936
FBgn0029995	1036	1000	1009	63	11	5.7272727272727275	973
FBgn0029996	1036	1000	1033	39	7	5.571428571428571	997
FBgn0029997	1021	1000	1008	34	8	4.25	987
FBgn0029999	1025	1000	1019	31	6	5.166666666666667	994
FBgn0030001	1003	1000	990	16	2	8	987
FBgn0030003	1012	1000	842	182	9	20.22222222222222	830
FBgn0030005	1044	1000	970	118	19	6.2105263157894735	926
FBgn0030007	1006	1000	1000	12	4	3	994
FBgn0030008	1006	1000	1000	12	4	3	994
FBgn0030013	1003	1000	1003	3	2	1.5	1000
FBgn0030014	1017	1000	941	93	15	6.2	924
FBgn0030015	1006	1000	920	92	13	7.076923076923077	914
FBgn0030016	1014	1000	917	111	14	7.928571428571429	903
FBgn0030017	1022	1000	941	103	17	6.0588235294117645	919
FBgn0030018	1015	1000	900	130	16	8.125	885
FBgn0030025	1026	1000	1017	35	12	2.9166666666666665	991
FBgn0030026	1013	1000	978	48	8	6	965
FBgn0030027	1056	1000	1030	82	20	4.1	974
FBgn0030028	1094	1000	1083	105	10	10.5	989
FBgn0030029	1014	1000	997	31	4	7.75	983
FBgn0030030	1017	1000	1009	25	6	4.166666666666667	992
FBgn0030033	1044	1000	964	124	17	7.294117647058823	920
FBgn0030034	1007	1000	926	88	10	8.8	919
FBgn0030037	1013	1000	988	38	9	4.222222222222222	975
FBgn0030038	1004	1000	1004	4	1	4	1000
FBgn0030040	1013	1000	955	71	11	6.454545454545454	942
FBgn0030048	1015	1000	1014	16	5	3.2	999
FBgn0030049	1011	1000	998	24	6	4	987
FBgn0030054	1067	1000	986	148	19	7.7894736842105265	919
FBgn0030055	1001	1000	995	7	4	1.75	994
FBgn0030056	1006	989	968	55	17	3.235294117647059	951
FBgn0030057	1003	1000	909	97	2	48.5	906
FBgn0030058	1009	1000	889	129	13	9.923076923076923	880
FBgn0030060	1001	1000	1001	1	1	1	1000
FBgn0030061	1080	1000	1067	93	10	9.3	987
FBgn0030063	1002	1000	993	11	3	3.6666666666666665	991
FBgn0030065	1037	1000	940	134	13	10.307692307692308	903
FBgn0030066	1032	1000	993	71	16	4.4375	961
FBgn0030067	1017	1000	997	37	10	3.7	980
FBgn0030071	1044	1000	1022	66	9	7.333333333333333	978
FBgn0030077	1046	1000	982	110	14	7.857142857142857	936
FBgn0030081	1005	1000	998	12	3	4	993
FBgn0030082	1000	1000	995	5	1	5	995
FBgn0030087	749	732	743	23	8	2.875	726
FBgn0030090	1007	1000	992	22	8	2.75	985
FBgn0030091	1064	1000	1005	123	13	9.461538461538462	941
FBgn0030092	1000	1000	995	5	1	5	995
FBgn0030093	1000	1000	989	11	4	2.75	989
FBgn0030096	1012	1000	963	61	10	6.1	951
FBgn0030097	1042	1000	924	160	18	8.88888888888889	882
FBgn0030098	1042	1000	922	162	18	9	880
FBgn0030102	1052	1000	954	150	20	7.5	902
FBgn0030103	1040	1000	972	108	19	5.684210526315789	932
FBgn0030107	1015	1000	981	49	8	6.125	966
FBgn0030121	1044	1000	987	101	9	11.222222222222221	943
FBgn0030136	1026	1000	1019	33	10	3.3	993
FBgn0030141	1022	1000	995	49	10	4.9	973
FBgn0030148	1030	1000	959	101	11	9.181818181818182	929
FBgn0030151	1003	1000	982	24	8	3	979
FBgn0030156	1058	1000	1024	92	13	7.076923076923077	966
FBgn0030157	1007	1000	970	44	12	3.6666666666666665	963
FBgn0030158	719	682	687	69	9	7.666666666666667	650
FBgn0030160	1030	1000	950	110	13	8.461538461538462	920
FBgn0030162	1005	1000	926	84	10	8.4	921
FBgn0030167	1000	1000	994	6	3	2	994
FBgn0030174	1034	1000	975	93	15	6.2	941
FBgn0030178	1001	1000	994	8	4	2	993
FBgn0030181	1064	1000	1047	81	16	5.0625	983
FBgn0030183	1012	1000	1011	13	5	2.6	999
FBgn0030186	1009	1000	936	82	13	6.3076923076923075	927
FBgn0030187	1005	1000	961	49	12	4.083333333333333	956
FBgn0030191	1023	1000	861	185	8	23.125	838
FBgn0030196	1019	1000	995	43	8	5.375	976
FBgn0030204	1038	1000	996	80	4	20	958
FBgn0030206	1010	1000	1003	17	7	2.4285714285714284	993
FBgn0030207	1030	1000	998	62	13	4.769230769230769	968
FBgn0030208	1008	1000	733	283	5	56.6	725
FBgn0030217	1016	1000	997	35	9	3.888888888888889	981
FBgn0030218	1024	1000	1023	25	8	3.125	999
FBgn0030224	1027	1000	999	55	7	7.857142857142857	972
FBgn0030228	1018	1000	966	70	11	6.363636363636363	948
FBgn0030230	1072	1000	1041	103	17	6.0588235294117645	969
FBgn0030237	1022	1000	796	248	14	17.714285714285715	774
FBgn0030242	1017	1000	966	68	12	5.666666666666667	949
FBgn0030243	1000	1000	956	44	4	11	956
FBgn0030244	1029	1000	931	127	14	9.071428571428571	902
FBgn0030251	1074	1000	1010	138	20	6.9	936
FBgn0030257	1030	1000	989	71	13	5.461538461538462	959
FBgn0030258	1007	1000	971	43	7	6.142857142857143	964
FBgn0030259	1042	1000	1008	76	14	5.428571428571429	966
FBgn0030260	1030	1000	995	65	10	6.5	965
FBgn0030262	1023	1000	976	70	9	7.777777777777778	953
FBgn0030266	1014	1000	1011	17	7	2.4285714285714284	997
FBgn0030268	1031	1000	1026	36	5	7.2	995
FBgn0030269	1026	1000	1020	32	5	6.4	994
FBgn0030270	1006	1000	948	64	12	5.333333333333333	942
FBgn0030271	1008	1000	933	83	15	5.533333333333333	925
FBgn0030272	754	740	702	66	16	4.125	688
FBgn0030276	1079	1000	1025	133	19	7	946
FBgn0030277	1014	1000	965	63	12	5.25	951
FBgn0030278	1036	1000	999	73	14	5.214285714285714	963
FBgn0030283	1013	1000	984	42	8	5.25	971
FBgn0030286	1007	1000	960	54	9	6	953
FBgn0030289	1012	1000	981	43	9	4.777777777777778	969
FBgn0030290	1011	1000	1007	15	3	5	996
FBgn0030296	1001	1000	962	40	11	3.6363636363636362	961
FBgn0030300	1075	1000	995	155	22	7.045454545454546	920
FBgn0030301	1026	1000	971	81	14	5.785714285714286	945
FBgn0030311	1040	1000	966	114	13	8.76923076923077	926
FBgn0030313	1011	1000	995	27	5	5.4	984
FBgn0030316	846	843	826	23	9	2.5555555555555554	823
FBgn0030317	1005	1000	1001	9	2	4.5	996
FBgn0030319	1016	1000	1011	21	6	3.5	995
FBgn0030320	1014	1000	983	45	9	5	969
FBgn0030321	1007	1000	805	209	11	19	798
FBgn0030323	1006	1000	990	22	7	3.142857142857143	984
FBgn0030329	1002	1000	997	7	3	2.3333333333333335	995
FBgn0030332	1029	1000	955	103	12	8.583333333333334	926
FBgn0030334	1007	1000	942	72	12	6	935
FBgn0030336	1004	1000	957	51	10	5.1	953
FBgn0030338	1065	1000	980	150	20	7.5	915
FBgn0030339	1042	1000	986	98	26	3.769230769230769	944
FBgn0030342	1002	1000	993	11	3	3.6666666666666665	991
FBgn0030343	1011	1000	1001	21	6	3.5	990
FBgn0030344	1016	1000	1003	29	5	5.8	987
FBgn0030345	1004	1000	1004	4	2	2	1000
FBgn0030346	1017	1000	991	43	12	3.5833333333333335	974
FBgn0030347	1018	1000	1011	25	8	3.125	993
FBgn0030348	1015	1000	1000	30	9	3.3333333333333335	985
FBgn0030349	1002	1000	996	8	4	2	994
FBgn0030350	1043	1000	1021	65	13	5	978
FBgn0030357	1003	1000	979	27	10	2.7	976
FBgn0030358	1002	1000	960	44	11	4	958
FBgn0030359	741	728	715	39	8	4.875	702
FBgn0030360	1043	1000	989	97	14	6.928571428571429	946
FBgn0030361	1022	1000	901	143	8	17.875	879
FBgn0030362	1004	1000	965	43	3	14.333333333333334	961
FBgn0030367	1005	1000	565	445	9	49.44444444444444	560
FBgn0030370	1041	1000	1014	68	12	5.666666666666667	973
FBgn0030373	1065	1000	1032	98	14	7	967
FBgn0030375	1032	1000	992	72	13	5.538461538461538	960
FBgn0030377	1031	1000	949	113	12	9.416666666666666	918
FBgn0030384	1012	1000	982	42	13	3.230769230769231	970
FBgn0030385	1006	1000	995	17	7	2.4285714285714284	989
FBgn0030391	1008	1000	983	33	11	3	975
FBgn0030394	1025	1000	998	52	12	4.333333333333333	973
FBgn0030398	1012	1000	946	78	13	6	934
FBgn0030400	1014	1000	998	30	11	2.727272727272727	984
FBgn0030403	1000	1000	710	290	7	41.42857142857143	710
FBgn0030407	1015	1000	994	36	6	6	979
FBgn0030408	1050	978	1021	101	18	5.611111111111111	949
FBgn0030409	1018	1000	850	186	17	10.941176470588236	832
FBgn0030410	1000	1000	990	10	1	10	990
FBgn0030411	1000	1000	990	10	1	10	990
FBgn0030412	724	710	688	50	10	5	674
FBgn0030417	1019	1000	904	134	18	7.444444444444445	885
FBgn0030418	1115	1000	1088	142	19	7.473684210526316	973
FBgn0030425	1042	1000	962	122	22	5.545454545454546	920
FBgn0030431	780	760	725	75	10	7.5	705
FBgn0030432	1002	1000	939	65	8	8.125	937
FBgn0030433	1002	1000	935	69	8	8.625	933
FBgn0030434	1096	1000	1052	140	12	11.666666666666666	956
FBgn0030435	1001	1000	748	254	4	63.5	747
FBgn0030437	1069	1000	1054	84	16	5.25	985
FBgn0030438	785	764	741	65	7	9.285714285714286	720
FBgn0030439	1063	1000	1040	86	12	7.166666666666667	977
FBgn0030440	1037	1000	994	80	13	6.153846153846154	957
FBgn0030443	1076	1000	1023	129	19	6.7894736842105265	947
FBgn0030447	920	920	895	25	7	3.5714285714285716	895
FBgn0030451	1020	1000	979	61	9	6.777777777777778	959
FBgn0030457	1000	1000	997	3	1	3	997
FBgn0030459	1024	1000	970	78	15	5.2	946
FBgn0030465	1014	1000	993	35	9	3.888888888888889	979
FBgn0030467	1032	1000	1020	44	10	4.4	988
FBgn0030468	1054	1000	993	115	15	7.666666666666667	939
FBgn0030474	1001	1000	459	543	5	108.6	458
FBgn0030477	1004	1000	970	38	12	3.1666666666666665	966
FBgn0030479	1019	1000	1003	35	7	5	984
FBgn0030480	1022	1000	993	51	11	4.636363636363637	971
FBgn0030481	1016	1000	1002	30	9	3.3333333333333335	986
FBgn0030484	1002	1000	993	11	4	2.75	991
FBgn0030485	1017	1000	1000	34	6	5.666666666666667	983
FBgn0030486	1027	1000	1005	49	8	6.125	978
FBgn0030492	1097	1000	1084	110	11	10	987
FBgn0030493	1026	1000	991	61	12	5.083333333333333	965
FBgn0030494	1046	1000	1020	72	10	7.2	974
FBgn0030495	1042	1000	995	89	13	6.846153846153846	953
FBgn0030500	1000	1000	991	9	1	9	991
FBgn0030501	1009	1000	1009	9	2	4.5	1000
FBgn0030502	1029	1000	996	62	13	4.769230769230769	967
FBgn0030503	1028	1000	995	61	13	4.6923076923076925	967
FBgn0030504	1063	1000	1049	77	11	7	986
FBgn0030505	1059	1000	1049	69	9	7.666666666666667	990
FBgn0030507	1005	1000	1001	9	2	4.5	996
FBgn0030509	1039	1000	996	82	13	6.3076923076923075	957
FBgn0030511	1058	1000	1021	95	24	3.9583333333333335	963
FBgn0030512	897	890	650	254	11	23.09090909090909	643
FBgn0030514	1014	1000	1014	14	1	14	1000
FBgn0030518	1001	1000	973	29	3	9.666666666666666	972
FBgn0030519	695	673	671	46	11	4.181818181818182	649
FBgn0030521	1013	1000	1012	14	3	4.666666666666667	999
FBgn0030522	1017	1000	1007	27	6	4.5	990
FBgn0030528	1001	1000	994	8	2	4	993
FBgn0030530	817	783	715	136	12	11.333333333333334	681
FBgn0030536	1118	1000	1071	165	19	8.68421052631579	953
FBgn0030537	1052	1000	1040	64	13	4.923076923076923	988
FBgn0030538	1004	1000	531	477	8	59.625	527
FBgn0030539	1005	1000	917	93	16	5.8125	912
FBgn0030540	1007	1000	1001	13	4	3.25	994
FBgn0030541	1032	1000	989	75	14	5.357142857142857	957
FBgn0030542	1004	1000	965	43	9	4.777777777777778	961
FBgn0030543	1018	1000	911	125	11	11.363636363636363	893
FBgn0030544	1025	1000	979	71	7	10.142857142857142	954
FBgn0030551	1005	1000	989	21	7	3	984
FBgn0030552	1005	1000	972	38	7	5.428571428571429	967
FBgn0030554	1001	1000	999	3	3	1	998
FBgn0030555	1014	1000	1006	22	8	2.75	992
FBgn0030559	1010	1000	957	63	13	4.846153846153846	947
FBgn0030562	1016	1000	965	67	11	6.090909090909091	949
FBgn0030569	1027	1000	941	113	10	11.3	914
FBgn0030570	1000	1000	979	21	5	4.2	979
FBgn0030571	1051	1000	936	166	17	9.764705882352942	885
FBgn0030574	1030	1000	1009	51	14	3.642857142857143	979
FBgn0030575	1061	1000	1033	89	14	6.357142857142857	972
FBgn0030577	1006	1000	864	148	12	12.333333333333334	858
FBgn0030578	786	782	291	499	8	62.375	287
FBgn0030582	1004	1000	488	520	5	104	484
FBgn0030583	983	939	933	94	14	6.714285714285714	889
FBgn0030586	1055	1000	1037	73	9	8.11111111111111	982
FBgn0030587	1024	1000	1003	45	12	3.75	979
FBgn0030588	1039	1000	986	92	13	7.076923076923077	947
FBgn0030589	1023	1000	998	48	7	6.857142857142857	975
FBgn0030590	1078	1000	1055	101	11	9.181818181818182	977
FBgn0030592	1069	1000	1059	79	10	7.9	990
FBgn0030593	1027	1000	1000	54	12	4.5	973
FBgn0030595	1042	997	1038	49	11	4.454545454545454	993
FBgn0030597	820	809	817	14	5	2.8	806
FBgn0030598	1004	1000	937	71	17	4.176470588235294	933
FBgn0030599	1003	1000	864	142	4	35.5	861
FBgn0030600	1001	1000	998	4	4	1	997
FBgn0030605	1002	1000	996	8	5	1.6	994
FBgn0030607	1054	1000	1037	71	12	5.916666666666667	983
FBgn0030611	1046	1000	1006	86	17	5.0588235294117645	960
FBgn0030612	1007	1000	1001	13	4	3.25	994
FBgn0030613	1044	1000	992	96	12	8	948
FBgn0030614	1008	1000	974	42	10	4.2	966
FBgn0030615	1074	1000	1047	101	14	7.214285714285714	973
FBgn0030616	1051	1000	1032	70	8	8.75	981
FBgn0030617	1039	1000	1012	66	10	6.6	973
FBgn0030620	1037	1000	1003	71	9	7.888888888888889	966
FBgn0030622	1014	1000	977	51	11	4.636363636363637	963
FBgn0030624	1038	1000	1023	53	9	5.888888888888889	985
FBgn0030625	1007	1000	828	186	9	20.666666666666668	821
FBgn0030628	1035	1000	1022	48	9	5.333333333333333	987
FBgn0030629	901	889	257	656	7	93.71428571428571	245
FBgn0030630	1024	1000	933	115	20	5.75	909
FBgn0030631	1012	1000	670	354	8	44.25	658
FBgn0030634	1044	1000	1006	82	11	7.454545454545454	962
FBgn0030638	1012	993	971	60	11	5.454545454545454	952
FBgn0030643	1036	1000	987	85	10	8.5	951
FBgn0030653	1067	1000	994	140	15	9.333333333333334	927
FBgn0030657	1010	1000	1000	20	3	6.666666666666667	990
FBgn0030659	1016	1000	991	41	7	5.857142857142857	975
FBgn0030660	1037	1000	1016	58	6	9.666666666666666	979
FBgn0030661	1007	1000	974	40	4	10	967
FBgn0030662	1043	1000	1007	79	16	4.9375	964
FBgn0030663	1012	1000	903	121	12	10.083333333333334	891
FBgn0030664	1035	1000	978	92	11	8.363636363636363	943
FBgn0030666	1025	1000	971	79	17	4.647058823529412	946
FBgn0030667	1030	1000	752	308	21	14.666666666666666	722
FBgn0030670	1011	1000	965	57	5	11.4	954
FBgn0030671	1006	1000	970	42	10	4.2	964
FBgn0030672	1041	1000	1023	59	9	6.555555555555555	982
FBgn0030673	1006	1000	974	38	9	4.222222222222222	968
FBgn0030675	1017	1000	1003	31	9	3.4444444444444446	986
FBgn0030676	1000	1000	667	333	5	66.6	667
FBgn0030678	1020	1000	990	50	3	16.666666666666668	970
FBgn0030679	1020	1000	998	42	2	21	978
FBgn0030684	1003	1000	932	74	9	8.222222222222221	929
FBgn0030685	1014	1000	990	38	6	6.333333333333333	976
FBgn0030686	1016	1000	990	42	8	5.25	974
FBgn0030688	1000	1000	972	28	3	9.333333333333334	972
FBgn0030699	1000	1000	997	3	1	3	997
FBgn0030700	1005	1000	943	67	7	9.571428571428571	938
FBgn0030701	896	848	880	64	7	9.142857142857142	832
FBgn0030703	1000	1000	752	248	4	62	752
FBgn0030706	1039	1000	1016	62	13	4.769230769230769	977
FBgn0030707	1048	1000	1002	94	18	5.222222222222222	954
FBgn0030710	1000	1000	974	26	7	3.7142857142857144	974
FBgn0030711	871	841	842	59	6	9.833333333333334	812
FBgn0030716	1058	1000	963	153	14	10.928571428571429	905
FBgn0030717	1047	1000	952	142	12	11.833333333333334	905
FBgn0030718	1004	1000	994	14	7	2	990
FBgn0030720	1003	1000	997	9	7	1.2857142857142858	994
FBgn0030721	1030	1000	1024	36	11	3.272727272727273	994
FBgn0030722	1082	1000	1048	116	12	9.666666666666666	966
FBgn0030723	1082	1000	1047	117	11	10.636363636363637	965
FBgn0030725	1033	1000	990	76	15	5.066666666666666	957
FBgn0030729	953	943	947	16	2	8	937
FBgn0030731	1001	1000	938	64	10	6.4	937
FBgn0030733	1032	1000	1026	38	9	4.222222222222222	994
FBgn0030734	1000	1000	1000	0	0	NA	1000
FBgn0030735	1018	1000	998	38	6	6.333333333333333	980
FBgn0030738	1002	1000	976	28	7	4	974
FBgn0030739	1004	1000	979	29	9	3.2222222222222223	975
FBgn0030740	1033	1000	1023	43	8	5.375	990
FBgn0030742	838	802	821	53	16	3.3125	785
FBgn0030743	1003	1000	999	7	5	1.4	996
FBgn0030746	1001	1000	911	91	14	6.5	910
FBgn0030747	1037	1000	948	126	14	9	911
FBgn0030749	1003	1000	1001	5	2	2.5	998
FBgn0030752	1023	1000	988	58	15	3.8666666666666667	965
FBgn0030753	1015	1000	997	33	7	4.714285714285714	982
FBgn0030759	1053	1000	1047	59	9	6.555555555555555	994
FBgn0030766	1052	1000	1040	64	8	8	988
FBgn0030768	1019	1000	1013	25	7	3.5714285714285716	994
FBgn0030769	1013	1000	967	59	13	4.538461538461538	954
FBgn0030770	1019	1000	956	82	5	16.4	937
FBgn0030773	764	713	703	112	13	8.615384615384615	652
FBgn0030775	1003	1000	945	61	6	10.166666666666666	942
FBgn0030777	1038	1000	1001	75	10	7.5	963
FBgn0030786	1033	1000	961	105	11	9.545454545454545	928
FBgn0030789	1035	1000	986	84	12	7	951
FBgn0030790	1035	1000	984	86	13	6.615384615384615	949
FBgn0030791	1003	1000	983	23	6	3.8333333333333335	980
FBgn0030792	1004	1000	944	64	12	5.333333333333333	940
FBgn0030793	1013	1000	959	67	3	22.333333333333332	946
FBgn0030795	795	787	747	56	11	5.090909090909091	739
FBgn0030796	1009	1000	966	52	6	8.666666666666666	957
FBgn0030798	1003	1000	630	376	9	41.77777777777778	627
FBgn0030799	1009	1000	994	24	12	2	985
FBgn0030800	1056	1000	1035	77	11	7	979
FBgn0030801	1057	1000	1056	58	7	8.285714285714286	999
FBgn0030805	709	701	676	41	6	6.833333333333333	668
FBgn0030806	1023	1000	938	108	14	7.714285714285714	915
FBgn0030807	1019	1000	1002	36	6	6	983
FBgn0030808	1019	1000	911	127	10	12.7	892
FBgn0030813	1014	1000	685	343	12	28.583333333333332	671
FBgn0030814	1000	1000	947	53	9	5.888888888888889	947
FBgn0030815	1014	1000	935	93	18	5.166666666666667	921
FBgn0030823	1006	1000	977	35	5	7	971
FBgn0030824	1014	1000	985	43	5	8.6	971
FBgn0030826	1023	1000	997	49	6	8.166666666666666	974
FBgn0030828	1004	1000	972	36	6	6	968
FBgn0030829	1055	1000	1049	61	4	15.25	994
FBgn0030830	1009	1000	976	42	5	8.4	967
FBgn0030834	1014	1000	996	32	6	5.333333333333333	982
FBgn0030837	1027	1000	1005	49	9	5.444444444444445	978
FBgn0030838	1030	1000	951	109	7	15.571428571428571	921
FBgn0030839	1008	1000	1008	8	1	8	1000
FBgn0030841	1021	1000	942	100	11	9.090909090909092	921
FBgn0030844	1023	1000	994	52	13	4	971
FBgn0030847	799	725	775	98	9	10.88888888888889	701
FBgn0030853	1045	1000	1039	51	8	6.375	994
FBgn0030854	1012	1000	1005	19	6	3.1666666666666665	993
FBgn0030855	1016	1000	1013	19	6	3.1666666666666665	997
FBgn0030858	1035	1000	1014	56	11	5.090909090909091	979
FBgn0030859	1051	1000	1035	67	11	6.090909090909091	984
FBgn0030863	1003	1000	999	7	5	1.4	996
FBgn0030864	1004	1000	987	21	7	3	983
FBgn0030868	1052	1000	1009	95	12	7.916666666666667	957
FBgn0030870	1031	1000	982	80	8	10	951
FBgn0030872	1000	1000	931	69	3	23	931
FBgn0030873	1001	1000	992	10	3	3.3333333333333335	991
FBgn0030874	1004	1000	1004	4	2	2	1000
FBgn0030876	1019	1000	1016	22	9	2.4444444444444446	997
FBgn0030877	1016	1000	997	35	5	7	981
FBgn0030878	1016	1000	1003	29	7	4.142857142857143	987
FBgn0030880	1008	1000	966	50	9	5.555555555555555	958
FBgn0030881	1017	1000	1004	30	7	4.285714285714286	987
FBgn0030883	1034	1000	1031	37	7	5.285714285714286	997
FBgn0030884	1052	1000	1021	83	13	6.384615384615385	969
FBgn0030887	1019	1000	1002	36	7	5.142857142857143	983
FBgn0030889	1016	1000	1005	27	6	4.5	989
FBgn0030890	701	699	683	20	5	4	681
FBgn0030891	1017	1000	1004	30	11	2.727272727272727	987
FBgn0030894	1007	1000	1005	9	5	1.8	998
FBgn0030897	1003	1000	980	26	6	4.333333333333333	977
FBgn0030898	1004	1000	958	50	10	5	954
FBgn0030899	1025	1000	986	64	11	5.818181818181818	961
FBgn0030900	1005	1000	928	82	12	6.833333333333333	923
FBgn0030904	1014	1000	983	45	8	5.625	969
FBgn0030905	1025	1000	984	66	11	6	959
FBgn0030911	1011	1000	957	65	10	6.5	946
FBgn0030912	1017	1000	984	50	14	3.5714285714285716	967
FBgn0030914	1007	1000	923	91	16	5.6875	916
FBgn0030915	1006	1000	1005	7	3	2.3333333333333335	999
FBgn0030921	1006	1000	951	61	10	6.1	945
FBgn0030925	892	876	858	50	11	4.545454545454546	842
FBgn0030926	781	726	776	60	8	7.5	721
FBgn0030928	1038	1000	966	110	12	9.166666666666666	928
FBgn0030929	1010	1000	965	55	12	4.583333333333333	955
FBgn0030930	1007	1000	1007	7	3	2.3333333333333335	1000
FBgn0030931	1005	1000	1002	8	5	1.6	997
FBgn0030933	1018	1000	976	60	14	4.285714285714286	958
FBgn0030936	1018	1000	806	230	10	23	788
FBgn0030937	1006	1000	897	115	6	19.166666666666668	891
FBgn0030941	1035	1000	1005	65	17	3.823529411764706	970
FBgn0030945	954	894	920	94	8	11.75	860
FBgn0030946	1043	1000	1020	66	9	7.333333333333333	977
FBgn0030947	1000	1000	948	52	4	13	948
FBgn0030951	1017	1000	965	69	13	5.3076923076923075	948
FBgn0030952	1024	1000	1013	35	9	3.888888888888889	989
FBgn0030961	980	945	944	71	10	7.1	909
FBgn0030963	1035	1000	968	102	4	25.5	933
FBgn0030964	941	881	863	138	14	9.857142857142858	803
FBgn0030966	1046	1000	1034	58	7	8.285714285714286	988
FBgn0030968	1052	1000	987	117	14	8.357142857142858	935
FBgn0030969	1047	1000	1002	92	12	7.666666666666667	955
FBgn0030970	1005	1000	996	14	4	3.5	991
FBgn0030973	1002	1000	959	45	8	5.625	957
FBgn0030976	1024	1000	979	69	10	6.9	955
FBgn0030979	1076	1000	1014	138	16	8.625	938
FBgn0030980	1043	1000	1009	77	14	5.5	966
FBgn0030981	1008	1000	971	45	14	3.2142857142857144	963
FBgn0030982	1012	1000	827	197	9	21.88888888888889	815
FBgn0030984	1019	1000	521	517	7	73.85714285714286	502
FBgn0030985	743	737	726	23	8	2.875	720
FBgn0030990	1032	1000	1000	64	9	7.111111111111111	968
FBgn0030991	1032	1000	1004	60	8	7.5	972
FBgn0030992	1007	1000	928	86	11	7.818181818181818	921
FBgn0030995	1032	1000	1005	59	9	6.555555555555555	973
FBgn0030997	894	892	794	102	10	10.2	792
FBgn0030998	1016	1000	863	169	14	12.071428571428571	847
FBgn0030999	1016	1000	941	91	15	6.066666666666666	925
FBgn0031000	791	706	779	97	10	9.7	694
FBgn0031002	1024	1000	937	111	14	7.928571428571429	913
FBgn0031004	1013	1000	925	101	13	7.769230769230769	912
FBgn0031005	1035	1000	995	75	20	3.75	960
FBgn0031006	1046	1000	1012	80	13	6.153846153846154	966
FBgn0031008	1000	1000	987	13	5	2.6	987
FBgn0031010	1030	1000	995	65	13	5	965
FBgn0031011	1053	1000	1020	86	11	7.818181818181818	967
FBgn0031012	1036	1000	969	103	15	6.866666666666666	933
FBgn0031018	1010	1000	839	181	4	45.25	829
FBgn0031020	1003	1000	1002	4	2	2	999
FBgn0031021	1001	1000	658	344	6	57.333333333333336	657
FBgn0031026	1020	1000	946	94	17	5.529411764705882	926
FBgn0031030	1032	1000	992	72	12	6	960
FBgn0031036	1000	1000	652	348	6	58	652
FBgn0031040	1020	1000	995	45	8	5.625	975
FBgn0031043	1006	1000	996	16	5	3.2	990
FBgn0031044	1010	1000	995	25	7	3.5714285714285716	985
FBgn0031045	1027	1000	932	122	26	4.6923076923076925	905
FBgn0031047	1023	1000	953	93	11	8.454545454545455	930
FBgn0031048	1036	1000	979	93	20	4.65	943
FBgn0031049	1039	1000	993	85	12	7.083333333333333	954
FBgn0031050	1009	1000	774	244	7	34.857142857142854	765
FBgn0031051	1027	1000	1018	36	8	4.5	991
FBgn0031052	1008	1000	987	29	5	5.8	979
FBgn0031053	1025	1000	1001	49	10	4.9	976
FBgn0031054	1025	1000	998	52	11	4.7272727272727275	973
FBgn0031057	1008	1000	1006	10	3	3.3333333333333335	998
FBgn0031061	1000	1000	999	1	1	1	999
FBgn0031062	1000	1000	991	9	3	3	991
FBgn0031064	1015	1000	962	68	7	9.714285714285714	947
FBgn0031065	1059	1000	887	231	8	28.875	828
FBgn0031069	1011	918	1001	103	11	9.363636363636363	908
FBgn0031070	1016	1000	894	138	12	11.5	878
FBgn0031077	1020	1000	1004	36	5	7.2	984
FBgn0031078	1016	1000	1006	26	7	3.7142857142857144	990
FBgn0031082	1036	1000	957	115	9	12.777777777777779	921
FBgn0031086	1020	1000	562	478	7	68.28571428571429	542
FBgn0031091	1049	1000	687	411	7	58.714285714285715	638
FBgn0031092	1039	1000	522	556	5	111.2	483
FBgn0031093	1000	1000	979	21	3	7	979
FBgn0031094	1000	1000	980	20	2	10	980
FBgn0031097	1025	1000	934	116	11	10.545454545454545	909
FBgn0031098	1031	1000	1022	40	8	5	991
FBgn0031099	1004	1000	911	97	11	8.818181818181818	907
FBgn0031100	1040	1000	1005	75	11	6.818181818181818	965
FBgn0031101	1005	1000	929	81	14	5.785714285714286	924
FBgn0031104	1010	1000	736	284	7	40.57142857142857	726
FBgn0031109	1005	1000	953	57	11	5.181818181818182	948
FBgn0031111	1014	1000	930	98	12	8.166666666666666	916
FBgn0031114	1053	1000	823	283	12	23.583333333333332	770
FBgn0031115	1007	1000	977	37	8	4.625	970
FBgn0031116	1038	1000	883	193	15	12.866666666666667	845
FBgn0031117	1053	1000	910	196	18	10.88888888888889	857
FBgn0031126	1023	1000	991	55	10	5.5	968
FBgn0031128	1023	1000	1017	29	9	3.2222222222222223	994
FBgn0031129	1007	1000	980	34	5	6.8	973
FBgn0031130	1045	1000	1028	62	9	6.888888888888889	983
FBgn0031135	1024	1000	999	49	9	5.444444444444445	975
FBgn0031146	1085	1000	1033	137	14	9.785714285714286	948
FBgn0031148	1151	1000	1034	268	20	13.4	883
FBgn0031149	1066	1000	1062	70	6	11.666666666666666	996
FBgn0031150	1001	1000	985	17	4	4.25	984
FBgn0031161	1015	1000	980	50	9	5.555555555555555	965
FBgn0031170	1024	1000	947	101	7	14.428571428571429	923
FBgn0031171	1006	1000	1002	10	3	3.3333333333333335	996
FBgn0031174	1033	1000	1003	63	11	5.7272727272727275	970
FBgn0031176	1033	1000	997	69	10	6.9	964
FBgn0031184	1000	1000	657	343	2	171.5	657
FBgn0031187	1055	1000	998	112	11	10.181818181818182	943
FBgn0031190	1007	1000	997	17	5	3.4	990
FBgn0031191	1031	1000	979	83	18	4.611111111111111	948
FBgn0031209	1007	1000	996	18	10	1.8	989
FBgn0031213	868	861	815	60	11	5.454545454545454	808
FBgn0031216	1014	1000	670	358	8	44.75	656
FBgn0031227	1037	1000	1029	45	10	4.5	992
FBgn0031228	1014	1000	1008	20	6	3.3333333333333335	994
FBgn0031231	1019	1000	1000	38	11	3.4545454545454546	981
FBgn0031232	1001	1000	998	4	2	2	997
FBgn0031233	1029	1000	1012	46	11	4.181818181818182	983
FBgn0031235	1014	1000	1006	22	8	2.75	992
FBgn0031240	1037	1000	1011	63	6	10.5	974
FBgn0031245	1012	1000	997	27	7	3.857142857142857	985
FBgn0031247	1012	1000	997	27	7	3.857142857142857	985
FBgn0031248	1025	1000	999	51	7	7.285714285714286	974
FBgn0031249	1001	1000	976	26	3	8.666666666666666	975
FBgn0031250	1007	1000	1005	9	4	2.25	998
FBgn0031251	1004	1000	981	27	4	6.75	977
FBgn0031252	1008	1000	1003	13	5	2.6	995
FBgn0031253	1000	1000	979	21	5	4.2	979
FBgn0031254	1005	1000	985	25	9	2.7777777777777777	980
FBgn0031256	1013	1000	1000	26	9	2.888888888888889	987
FBgn0031258	1038	1000	1013	63	9	7	975
FBgn0031263	1001	1000	952	50	7	7.142857142857143	951
FBgn0031264	1026	1000	980	72	8	9	954
FBgn0031265	1067	1000	1042	92	12	7.666666666666667	975
FBgn0031266	1044	1000	1042	46	5	9.2	998
FBgn0031267	1002	1000	1001	3	2	1.5	999
FBgn0031268	1006	1000	1005	7	2	3.5	999
FBgn0031270	1011	1000	979	43	14	3.0714285714285716	968
FBgn0031275	1025	1000	987	63	12	5.25	962
FBgn0031277	1007	1000	974	40	6	6.666666666666667	967
FBgn0031281	1000	1000	1000	0	0	NA	1000
FBgn0031282	1000	1000	1000	0	0	NA	1000
FBgn0031284	1002	1000	982	22	5	4.4	980
FBgn0031286	1002	1000	987	17	4	4.25	985
FBgn0031287	1001	1000	978	24	6	4	977
FBgn0031288	1005	953	914	143	10	14.3	862
FBgn0031292	1029	1000	1001	57	14	4.071428571428571	972
FBgn0031294	1024	1000	977	71	13	5.461538461538462	953
FBgn0031296	1066	1000	1046	86	13	6.615384615384615	980
FBgn0031299	1054	1000	1032	76	10	7.6	978
FBgn0031301	1006	1000	999	13	3	4.333333333333333	993
FBgn0031304	1034	1000	1006	62	10	6.2	972
FBgn0031305	1011	1000	922	100	9	11.11111111111111	911
FBgn0031306	1011	1000	1000	22	8	2.75	989
FBgn0031309	1001	1000	991	11	3	3.6666666666666665	990
FBgn0031310	1001	1000	993	9	2	4.5	992
FBgn0031312	1008	1000	938	78	6	13	930
FBgn0031314	1037	1000	892	182	11	16.545454545454547	855
FBgn0031317	1003	1000	971	35	7	5	968
FBgn0031318	1004	1000	999	9	4	2.25	995
FBgn0031320	1001	1000	998	4	2	2	997
FBgn0031321	1002	1000	1002	2	1	2	1000
FBgn0031327	1000	1000	958	42	5	8.4	958
FBgn0031331	1030	1000	1017	43	8	5.375	987
FBgn0031335	1017	1000	972	62	9	6.888888888888889	955
FBgn0031337	1000	1000	959	41	6	6.833333333333333	959
FBgn0031344	1010	1000	979	41	4	10.25	969
FBgn0031347	1001	1000	1001	1	1	1	1000
FBgn0031351	1001	1000	985	17	6	2.8333333333333335	984
FBgn0031356	1022	1000	986	58	6	9.666666666666666	964
FBgn0031357	1008	1000	1006	10	6	1.6666666666666667	998
FBgn0031359	967	952	944	38	13	2.923076923076923	929
FBgn0031361	1007	1000	1007	7	2	3.5	1000
FBgn0031364	1013	1000	1004	22	5	4.4	991
FBgn0031365	1009	1000	976	42	10	4.2	967
FBgn0031367	1065	1000	1054	76	9	8.444444444444445	989
FBgn0031372	1029	1000	999	59	3	19.666666666666668	970
FBgn0031373	1000	1000	247	753	4	188.25	247
FBgn0031374	1032	1000	290	774	6	129	258
FBgn0031375	1003	1000	975	31	6	5.166666666666667	972
FBgn0031377	1008	1000	1006	10	2	5	998
FBgn0031378	1008	1000	1006	10	2	5	998
FBgn0031381	1000	1000	991	9	4	2.25	991
FBgn0031388	1088	1000	1084	92	7	13.142857142857142	996
FBgn0031389	1019	1000	995	43	8	5.375	976
FBgn0031390	726	712	715	25	8	3.125	701
FBgn0031391	1010	1000	1003	17	7	2.4285714285714284	993
FBgn0031393	855	855	820	35	8	4.375	820
FBgn0031399	1025	1000	1021	29	4	7.25	996
FBgn0031406	1076	1000	1048	104	8	13	972
FBgn0031407	1019	1000	975	63	10	6.3	956
FBgn0031409	1008	1000	992	24	7	3.4285714285714284	984
FBgn0031410	915	912	802	116	3	38.666666666666664	799
FBgn0031412	1001	1000	849	153	7	21.857142857142858	848
FBgn0031413	1028	1000	1015	41	7	5.857142857142857	987
FBgn0031414	1008	1000	979	37	9	4.111111111111111	971
FBgn0031417	993	985	980	21	7	3	972
FBgn0031419	1049	1000	1043	55	9	6.111111111111111	994
FBgn0031423	1026	1000	1014	38	6	6.333333333333333	988
FBgn0031428	1034	1000	1023	45	8	5.625	989
FBgn0031430	1022	1000	1001	43	6	7.166666666666667	979
FBgn0031431	1049	1000	1035	63	10	6.3	986
FBgn0031434	1045	1000	962	128	10	12.8	917
FBgn0031436	1000	1000	982	18	3	6	982
FBgn0031437	1037	1000	1008	66	7	9.428571428571429	971
FBgn0031440	1036	1000	1022	50	8	6.25	986
FBgn0031442	1000	1000	983	17	3	5.666666666666667	983
FBgn0031444	1006	1000	983	29	6	4.833333333333333	977
FBgn0031446	1016	1000	976	56	12	4.666666666666667	960
FBgn0031449	1014	1000	983	45	10	4.5	969
FBgn0031451	1001	1000	931	71	3	23.666666666666668	930
FBgn0031452	1000	1000	976	24	2	12	976
FBgn0031453	1025	1000	1018	32	7	4.571428571428571	993
FBgn0031456	1012	1000	1007	17	4	4.25	995
FBgn0031457	1001	1000	966	36	3	12	965
FBgn0031458	1001	1000	963	39	5	7.8	962
FBgn0031459	1008	1000	993	23	5	4.6	985
FBgn0031461	1042	1000	1002	82	11	7.454545454545454	960
FBgn0031462	685	677	632	61	4	15.25	624
FBgn0031466	1061	1000	1055	67	6	11.166666666666666	994
FBgn0031467	1005	1000	999	11	3	3.6666666666666665	994
FBgn0031468	713	670	692	64	8	8	649
FBgn0031471	1000	1000	686	314	1	314	686
FBgn0031472	1044	1000	770	318	8	39.75	726
FBgn0031473	1000	1000	990	10	4	2.5	990
FBgn0031476	1005	1000	998	12	5	2.4	993
FBgn0031478	1003	1000	964	42	7	6	961
FBgn0031479	1026	1000	1023	29	7	4.142857142857143	997
FBgn0031483	1000	1000	984	16	2	8	984
FBgn0031484	1000	1000	994	6	2	3	994
FBgn0031485	894	887	842	59	12	4.916666666666667	835
FBgn0031489	1111	1000	1111	111	8	13.875	1000
FBgn0031491	1000	1000	1000	0	0	NA	1000
FBgn0031492	1001	1000	1001	1	1	1	1000
FBgn0031493	1002	1000	1002	2	2	1	1000
FBgn0031494	1001	1000	989	13	2	6.5	988
FBgn0031497	1001	1000	997	5	3	1.6666666666666667	996
FBgn0031498	1000	1000	1000	0	0	NA	1000
FBgn0031500	1001	1000	1001	1	1	1	1000
FBgn0031504	1013	1000	708	318	7	45.42857142857143	695
FBgn0031505	1004	1000	843	165	12	13.75	839
FBgn0031513	825	790	811	49	7	7	776
FBgn0031514	1020	1000	996	44	6	7.333333333333333	976
FBgn0031519	1007	1000	999	15	5	3	992
FBgn0031520	1002	1000	996	8	4	2	994
FBgn0031526	1003	1000	793	213	9	23.666666666666668	790
FBgn0031529	1001	1000	998	4	3	1.3333333333333333	997
FBgn0031530	1068	1000	1044	92	8	11.5	976
FBgn0031531	1021	1000	977	65	9	7.222222222222222	956
FBgn0031533	1025	1000	975	75	10	7.5	950
FBgn0031534	1008	1000	996	20	6	3.3333333333333335	988
FBgn0031535	900	898	859	43	5	8.6	857
FBgn0031536	1020	1000	1016	24	6	4	996
FBgn0031540	1020	1000	1008	32	2	16	988
FBgn0031542	1000	1000	989	11	4	2.75	989
FBgn0031544	1002	1000	998	6	4	1.5	996
FBgn0031545	1013	1000	1004	22	5	4.4	991
FBgn0031546	1000	1000	993	7	2	3.5	993
FBgn0031547	1003	1000	939	67	11	6.090909090909091	936
FBgn0031548	1000	1000	940	60	9	6.666666666666667	940
FBgn0031549	1037	1000	999	75	14	5.357142857142857	962
FBgn0031550	1019	1000	908	130	10	13	889
FBgn0031554	1000	1000	989	11	4	2.75	989
FBgn0031561	741	714	722	46	4	11.5	695
FBgn0031562	724	713	680	55	9	6.111111111111111	669
FBgn0031563	1010	1000	978	42	8	5.25	968
FBgn0031564	711	711	562	149	5	29.8	562
FBgn0031566	1008	1000	998	18	4	4.5	990
FBgn0031568	1001	1000	989	13	6	2.1666666666666665	988
FBgn0031571	842	823	812	49	10	4.9	793
FBgn0031573	1026	1000	997	55	13	4.230769230769231	971
FBgn0031574	1039	1000	956	122	18	6.777777777777778	917
FBgn0031580	675	670	656	24	7	3.4285714285714284	651
FBgn0031585	1024	1000	984	64	12	5.333333333333333	960
FBgn0031589	1019	1000	970	68	10	6.8	951
FBgn0031590	1019	1000	966	72	14	5.142857142857143	947
FBgn0031592	1006	1000	990	22	8	2.75	984
FBgn0031596	1000	1000	969	31	6	5.166666666666667	969
FBgn0031600	1001	1000	757	245	2	122.5	756
FBgn0031603	1026	1000	1010	42	9	4.666666666666667	984
FBgn0031604	1002	1000	998	6	2	3	996
FBgn0031607	872	872	867	5	2	2.5	867
FBgn0031608	1002	1000	944	60	6	10	942
FBgn0031609	1017	1000	931	103	2	51.5	914
FBgn0031619	1012	1000	984	40	11	3.6363636363636362	972
FBgn0031620	1042	1000	823	261	16	16.3125	781
FBgn0031623	1083	1000	1074	92	11	8.363636363636363	991
FBgn0031626	1034	1000	999	69	6	11.5	965
FBgn0031627	1007	1000	984	30	9	3.3333333333333335	977
FBgn0031628	1004	1000	987	21	7	3	983
FBgn0031631	1079	1000	1011	147	8	18.375	932
FBgn0031632	1026	1000	1010	42	6	7	984
FBgn0031635	1005	1000	991	19	7	2.7142857142857144	986
FBgn0031636	1005	1000	1003	7	3	2.3333333333333335	998
FBgn0031637	1019	1000	1010	28	10	2.8	991
FBgn0031638	1015	1000	1006	24	8	3	991
FBgn0031639	1000	1000	1000	0	0	NA	1000
FBgn0031640	1000	1000	1000	0	0	NA	1000
FBgn0031643	1000	1000	991	9	4	2.25	991
FBgn0031644	1058	1000	992	124	16	7.75	934
FBgn0031645	974	924	838	186	17	10.941176470588236	788
FBgn0031646	1048	1000	998	98	17	5.764705882352941	950
FBgn0031649	1047	1000	993	101	12	8.416666666666666	946
FBgn0031650	1005	1000	968	42	7	6	963
FBgn0031651	1012	1000	1009	15	3	5	997
FBgn0031653	1042	1000	933	151	18	8.38888888888889	891
FBgn0031657	1003	1000	963	43	3	14.333333333333334	960
FBgn0031659	1024	1000	1018	30	9	3.3333333333333335	994
FBgn0031661	1004	1000	1002	6	5	1.2	998
FBgn0031662	1004	1000	1002	6	5	1.2	998
FBgn0031664	1012	1000	1000	24	6	4	988
FBgn0031670	1009	1000	997	21	7	3	988
FBgn0031673	1113	1000	1064	162	13	12.461538461538462	951
FBgn0031676	1000	1000	997	3	1	3	997
FBgn0031681	1046	1000	1032	60	7	8.571428571428571	986
FBgn0031682	1047	1000	1026	68	10	6.8	979
FBgn0031683	1013	1000	718	308	6	51.333333333333336	705
FBgn0031684	1003	1000	987	19	6	3.1666666666666665	984
FBgn0031688	1001	1000	886	116	9	12.88888888888889	885
FBgn0031689	1072	1000	1049	95	15	6.333333333333333	977
FBgn0031692	1001	1000	959	43	4	10.75	958
FBgn0031696	1009	1000	975	43	7	6.142857142857143	966
FBgn0031697	1049	1000	1012	86	17	5.0588235294117645	963
FBgn0031698	1002	1000	1001	3	3	1	999
FBgn0031700	1027	1000	990	64	9	7.111111111111111	963
FBgn0031701	1027	1000	989	65	10	6.5	962
FBgn0031702	1014	1000	984	44	8	5.5	970
FBgn0031707	1036	1000	989	83	15	5.533333333333333	953
FBgn0031708	1001	1000	963	39	9	4.333333333333333	962
FBgn0031710	1024	1000	929	119	3	39.666666666666664	905
FBgn0031711	1000	1000	790	210	3	70	790
FBgn0031713	1005	1000	1000	10	4	2.5	995
FBgn0031715	717	701	685	48	13	3.6923076923076925	669
FBgn0031717	1022	1000	982	62	10	6.2	960
FBgn0031718	1063	1000	1039	87	16	5.4375	976
FBgn0031719	1063	1000	1039	87	16	5.4375	976
FBgn0031720	1002	1000	967	37	4	9.25	965
FBgn0031721	1005	1000	1003	7	2	3.5	998
FBgn0031722	1028	1000	999	57	8	7.125	971
FBgn0031723	1065	1000	1044	86	12	7.166666666666667	979
FBgn0031724	1059	1000	1054	64	10	6.4	995
FBgn0031725	1020	1000	949	91	11	8.272727272727273	929
FBgn0031726	1060	1000	1042	78	12	6.5	982
FBgn0031728	1001	1000	949	53	8	6.625	948
FBgn0031729	1000	1000	993	7	1	7	993
FBgn0031730	1006	1000	995	17	8	2.125	989
FBgn0031731	1010	1000	955	65	8	8.125	945
FBgn0031732	1016	1000	1008	24	4	6	992
FBgn0031733	1012	1000	1005	19	9	2.111111111111111	993
FBgn0031734	1022	1000	966	78	9	8.666666666666666	944
FBgn0031737	1045	1000	992	98	11	8.909090909090908	947
FBgn0031739	1004	1000	782	226	3	75.33333333333333	778
FBgn0031740	1009	1000	867	151	5	30.2	858
FBgn0031741	1050	1000	985	115	14	8.214285714285714	935
FBgn0031745	1009	1000	950	68	10	6.8	941
FBgn0031749	1006	1000	1001	11	2	5.5	995
FBgn0031751	1009	1000	995	23	11	2.090909090909091	986
FBgn0031752	1056	1000	1022	90	19	4.7368421052631575	966
FBgn0031756	1008	1000	982	34	11	3.090909090909091	974
FBgn0031757	1008	1000	992	24	11	2.1818181818181817	984
FBgn0031759	1037	1000	998	76	13	5.846153846153846	961
FBgn0031760	1036	1000	996	76	13	5.846153846153846	960
FBgn0031762	922	916	869	59	7	8.428571428571429	863
FBgn0031763	1003	1000	999	7	5	1.4	996
FBgn0031764	1024	1000	768	280	8	35	744
FBgn0031766	1017	1000	1013	21	6	3.5	996
FBgn0031768	1000	1000	1000	0	0	NA	1000
FBgn0031770	1002	1000	999	5	3	1.6666666666666667	997
FBgn0031771	947	930	936	28	7	4	919
FBgn0031772	1001	1000	990	12	6	2	989
FBgn0031773	1000	1000	991	9	3	3	991
FBgn0031774	1009	1000	1009	9	1	9	1000
FBgn0031775	1035	1000	1005	65	13	5	970
FBgn0031776	1035	1000	1012	58	11	5.2727272727272725	977
FBgn0031777	1065	1000	1018	112	15	7.466666666666667	953
FBgn0031779	1019	1000	941	97	13	7.461538461538462	922
FBgn0031782	1000	1000	866	134	1	134	866
FBgn0031784	1009	1000	979	39	9	4.333333333333333	970
FBgn0031785	1024	1000	1019	29	7	4.142857142857143	995
FBgn0031786	1006	1000	942	70	12	5.833333333333333	936
FBgn0031792	1002	1000	1001	3	3	1	999
FBgn0031799	1009	1000	1002	16	5	3.2	993
FBgn0031800	1032	1000	1014	50	10	5	982
FBgn0031801	1045	1000	966	124	17	7.294117647058823	921
FBgn0031802	1011	1000	1001	21	3	7	990
FBgn0031803	1011	1000	995	27	4	6.75	984
FBgn0031808	1020	1000	976	64	8	8	956
FBgn0031811	1000	1000	965	35	7	5	965
FBgn0031813	1035	1000	935	135	13	10.384615384615385	900
FBgn0031814	1025	1000	1024	26	4	6.5	999
FBgn0031815	1002	1000	991	13	4	3.25	989
FBgn0031816	891	854	857	71	6	11.833333333333334	820
FBgn0031820	1011	1000	1010	12	3	4	999
FBgn0031822	1004	1000	999	9	2	4.5	995
FBgn0031824	1002	1000	1001	3	2	1.5	999
FBgn0031826	990	987	956	37	5	7.4	953
FBgn0031829	1007	1000	1003	11	3	3.6666666666666665	996
FBgn0031830	1010	1000	989	31	11	2.8181818181818183	979
FBgn0031832	1000	1000	980	20	4	5	980
FBgn0031834	1023	1000	870	176	13	13.538461538461538	847
FBgn0031835	1022	1000	988	56	8	7	966
FBgn0031836	1050	1000	1018	82	16	5.125	968
FBgn0031837	1052	1000	990	114	15	7.6	938
FBgn0031844	1001	1000	980	22	5	4.4	979
FBgn0031848	1007	1000	997	17	7	2.4285714285714284	990
FBgn0031850	1024	1000	1018	30	9	3.3333333333333335	994
FBgn0031851	1023	1000	967	79	17	4.647058823529412	944
FBgn0031853	1005	1000	991	19	9	2.111111111111111	986
FBgn0031854	1011	1000	950	72	9	8	939
FBgn0031855	1066	1000	1027	105	16	6.5625	961
FBgn0031857	1068	1000	1049	87	8	10.875	981
FBgn0031858	1060	1000	1039	81	8	10.125	979
FBgn0031860	1014	1000	959	69	8	8.625	945
FBgn0031861	1000	1000	973	27	6	4.5	973
FBgn0031865	953	945	918	43	7	6.142857142857143	910
FBgn0031868	1066	1000	1047	85	7	12.142857142857142	981
FBgn0031869	1008	1000	994	22	7	3.142857142857143	986
FBgn0031873	1005	1000	990	20	3	6.666666666666667	985
FBgn0031874	1004	1000	1003	5	2	2.5	999
FBgn0031875	1026	1000	998	54	11	4.909090909090909	972
FBgn0031876	1000	1000	993	7	2	3.5	993
FBgn0031877	1009	1000	1009	9	1	9	1000
FBgn0031878	1007	1000	1005	9	4	2.25	998
FBgn0031881	1009	1000	981	37	5	7.4	972
FBgn0031885	1036	1000	1007	65	9	7.222222222222222	971
FBgn0031893	1051	1000	1029	73	13	5.615384615384615	978
FBgn0031894	1022	1000	958	86	12	7.166666666666667	936
FBgn0031895	992	967	973	44	11	4	948
FBgn0031896	1006	1000	998	14	7	2	992
FBgn0031900	1044	1000	996	92	10	9.2	952
FBgn0031903	1003	1000	998	8	5	1.6	995
FBgn0031904	1008	1000	1004	12	4	3	996
FBgn0031905	1009	1000	984	34	9	3.7777777777777777	975
FBgn0031906	1054	1000	1045	63	5	12.6	991
FBgn0031907	1077	1000	1056	98	11	8.909090909090908	979
FBgn0031909	1020	1000	955	85	16	5.3125	935
FBgn0031910	1019	1000	972	66	11	6	953
FBgn0031913	1009	1000	991	27	8	3.375	982
FBgn0031918	1029	1000	1027	31	6	5.166666666666667	998
FBgn0031920	1000	1000	997	3	1	3	997
FBgn0031925	1081	1000	1011	151	21	7.190476190476191	930
FBgn0031926	912	890	887	47	11	4.2727272727272725	865
FBgn0031930	1050	1000	1042	58	5	11.6	992
FBgn0031936	792	732	786	66	8	8.25	726
FBgn0031937	1047	1000	1021	73	13	5.615384615384615	974
FBgn0031940	1011	1000	1002	20	6	3.3333333333333335	991
FBgn0031941	1007	1000	989	25	12	2.0833333333333335	982
FBgn0031942	1006	1000	970	42	8	5.25	964
FBgn0031945	1010	1000	994	26	8	3.25	984
FBgn0031948	1074	1000	1060	88	20	4.4	986
FBgn0031950	1020	1000	997	43	5	8.6	977
FBgn0031951	1001	1000	999	3	3	1	998
FBgn0031952	1105	1000	1084	126	13	9.692307692307692	979
FBgn0031954	1055	1000	840	270	12	22.5	785
FBgn0031955	1013	1000	1003	23	5	4.6	990
FBgn0031957	1024	1000	947	101	9	11.222222222222221	923
FBgn0031959	1003	1000	981	25	5	5	978
FBgn0031970	1013	1000	950	76	21	3.619047619047619	937
FBgn0031971	1013	1000	949	77	19	4.052631578947368	936
FBgn0031973	1036	1000	1005	67	11	6.090909090909091	969
FBgn0031976	1006	1000	941	71	11	6.454545454545454	935
FBgn0031977	1048	1000	856	240	6	40	808
FBgn0031979	1031	1000	932	130	16	8.125	901
FBgn0031980	1017	1000	979	55	9	6.111111111111111	962
FBgn0031981	1017	1000	981	53	8	6.625	964
FBgn0031985	1014	1000	1014	14	2	7	1000
FBgn0031986	1014	1000	1012	16	3	5.333333333333333	998
FBgn0031987	1004	1000	993	15	7	2.142857142857143	989
FBgn0031988	1009	1000	1008	10	3	3.3333333333333335	999
FBgn0031990	1011	1000	992	30	6	5	981
FBgn0031992	1019	1000	955	83	8	10.375	936
FBgn0031995	1001	1000	989	13	3	4.333333333333333	988
FBgn0031999	968	872	937	127	12	10.583333333333334	841
FBgn0032000	1032	1000	977	87	10	8.7	945
FBgn0032001	1000	1000	999	1	1	1	999
FBgn0032003	861	800	796	126	15	8.4	735
FBgn0032005	848	807	823	66	12	5.5	782
FBgn0032010	1029	1000	984	74	12	6.166666666666667	955
FBgn0032013	1010	1000	968	52	14	3.7142857142857144	958
FBgn0032015	1004	1000	1004	4	1	4	1000
FBgn0032016	1004	1000	1004	4	1	4	1000
FBgn0032017	1027	1000	936	118	10	11.8	909
FBgn0032018	1013	1000	1011	15	4	3.75	998
FBgn0032020	1040	1000	1014	66	15	4.4	974
FBgn0032021	1078	1000	1043	113	15	7.533333333333333	965
FBgn0032022	1024	1000	982	66	15	4.4	958
FBgn0032023	1013	1000	963	63	12	5.25	950
FBgn0032024	1022	1000	1003	41	16	2.5625	981
FBgn0032025	1043	1000	962	124	17	7.294117647058823	919
FBgn0032026	1097	1000	1084	110	14	7.857142857142857	987
FBgn0032029	764	738	746	44	6	7.333333333333333	720
FBgn0032031	1000	1000	989	11	3	3.6666666666666665	989
FBgn0032032	1000	1000	990	10	2	5	990
FBgn0032033	867	866	816	52	2	26	815
FBgn0032034	1001	1000	908	94	4	23.5	907
FBgn0032036	835	835	829	6	1	6	829
FBgn0032039	1050	1000	1026	74	11	6.7272727272727275	976
FBgn0032040	1015	1000	971	59	15	3.933333333333333	956
FBgn0032042	1005	1000	782	228	5	45.6	777
FBgn0032047	779	765	688	105	7	15	674
FBgn0032048	1027	1000	1008	46	9	5.111111111111111	981
FBgn0032050	739	726	471	281	4	70.25	458
FBgn0032051	1004	1000	1000	8	4	2	996
FBgn0032052	1016	1000	1011	21	7	3	995
FBgn0032053	1014	1000	1010	18	5	3.6	996
FBgn0032054	795	795	787	8	2	4	787
FBgn0032057	1053	1000	1020	86	13	6.615384615384615	967
FBgn0032059	1001	1000	977	25	5	5	976
FBgn0032065	1023	1000	1004	42	12	3.5	981
FBgn0032074	1004	1000	965	43	7	6.142857142857143	961
FBgn0032075	1018	1000	892	144	11	13.090909090909092	874
FBgn0032077	678	676	663	17	4	4.25	661
FBgn0032078	1029	1000	896	162	23	7.043478260869565	867
FBgn0032079	1023	1000	934	112	9	12.444444444444445	911
FBgn0032080	1003	1000	988	18	7	2.5714285714285716	985
FBgn0032083	1045	1000	1037	53	8	6.625	992
FBgn0032086	1009	1000	961	57	15	3.8	952
FBgn0032087	1088	1000	1063	113	11	10.272727272727273	975
FBgn0032088	979	943	927	88	12	7.333333333333333	891
FBgn0032089	1023	1000	999	47	10	4.7	976
FBgn0032094	1038	1000	999	77	9	8.555555555555555	961
FBgn0032095	1031	1000	1008	54	12	4.5	977
FBgn0032096	1000	1000	999	1	1	1	999
FBgn0032100	1007	1000	956	58	11	5.2727272727272725	949
FBgn0032101	1015	1000	981	49	12	4.083333333333333	966
FBgn0032105	1116	1000	1082	150	17	8.823529411764707	966
FBgn0032110	1060	1000	1036	84	10	8.4	976
FBgn0032116	1013	1000	995	31	11	2.8181818181818183	982
FBgn0032117	1005	1000	984	26	7	3.7142857142857144	979
FBgn0032120	1023	1000	1016	30	9	3.3333333333333335	993
FBgn0032124	1014	1000	1004	24	10	2.4	990
FBgn0032125	1059	1000	1017	101	15	6.733333333333333	958
FBgn0032126	693	692	682	12	3	4	681
FBgn0032127	1060	1000	1029	91	14	6.5	969
FBgn0032129	1041	1000	1027	55	10	5.5	986
FBgn0032130	1074	1000	1041	107	13	8.23076923076923	967
FBgn0032131	1015	1000	1010	20	5	4	995
FBgn0032132	1014	1000	926	102	6	17	912
FBgn0032135	811	787	800	35	4	8.75	776
FBgn0032136	1039	1000	1033	45	8	5.625	994
FBgn0032138	1032	1000	993	71	9	7.888888888888889	961
FBgn0032139	1006	1000	992	20	3	6.666666666666667	986
FBgn0032140	1026	1000	990	62	11	5.636363636363637	964
FBgn0032143	1000	1000	997	3	2	1.5	997
FBgn0032147	1017	1000	984	50	12	4.166666666666667	967
FBgn0032150	1019	1000	994	44	9	4.888888888888889	975
FBgn0032151	1026	1000	978	74	15	4.933333333333334	952
FBgn0032153	894	894	876	18	3	6	876
FBgn0032157	1014	1000	992	36	7	5.142857142857143	978
FBgn0032160	1035	1000	998	72	10	7.2	963
FBgn0032163	1024	1000	1015	33	6	5.5	991
FBgn0032167	1062	1000	1028	96	14	6.857142857142857	966
FBgn0032168	1018	1000	997	39	7	5.571428571428571	979
FBgn0032169	1002	1000	987	17	4	4.25	985
FBgn0032170	968	955	925	56	4	14	912
FBgn0032171	1000	1000	1000	0	0	NA	1000
FBgn0032175	1005	1000	993	17	5	3.4	988
FBgn0032176	1021	1000	1008	34	10	3.4	987
FBgn0032178	1027	1000	939	115	14	8.214285714285714	912
FBgn0032187	1009	1000	967	51	10	5.1	958
FBgn0032188	1007	1000	953	61	15	4.066666666666666	946
FBgn0032189	1001	1000	1001	1	1	1	1000
FBgn0032193	1015	1000	971	59	9	6.555555555555555	956
FBgn0032194	1017	1000	941	93	8	11.625	924
FBgn0032202	1016	1000	989	43	9	4.777777777777778	973
FBgn0032216	1003	1000	971	35	7	5	968
FBgn0032217	1001	1000	989	13	4	3.25	988
FBgn0032218	1002	1000	991	13	5	2.6	989
FBgn0032219	1031	1000	995	67	17	3.9411764705882355	964
FBgn0032221	1009	1000	1003	15	4	3.75	994
FBgn0032222	1028	1000	1009	47	9	5.222222222222222	981
FBgn0032228	1000	1000	999	1	1	1	999
FBgn0032229	1015	1000	970	60	13	4.615384615384615	955
FBgn0032233	1016	1000	1013	19	3	6.333333333333333	997
FBgn0032234	932	932	932	0	0	NA	932
FBgn0032236	1046	1000	1025	67	11	6.090909090909091	979
FBgn0032242	1019	1000	999	39	12	3.25	980
FBgn0032243	1010	1000	993	27	9	3	983
FBgn0032244	770	764	758	18	7	2.5714285714285716	752
FBgn0032246	1067	1000	1059	75	11	6.818181818181818	992
FBgn0032247	1002	1000	993	11	6	1.8333333333333333	991
FBgn0032248	1011	1000	1010	12	4	3	999
FBgn0032249	1013	1000	989	37	4	9.25	976
FBgn0032250	1002	1000	978	26	3	8.666666666666666	976
FBgn0032253	1038	1000	982	94	17	5.529411764705882	944
FBgn0032256	1036	1000	966	106	10	10.6	930
FBgn0032258	1017	1000	989	45	6	7.5	972
FBgn0032259	1006	1000	990	22	2	11	984
FBgn0032260	887	876	848	50	8	6.25	837
FBgn0032262	1015	1000	998	32	7	4.571428571428571	983
FBgn0032264	1045	1000	1034	56	8	7	989
FBgn0032266	764	745	739	44	7	6.285714285714286	720
FBgn0032269	1018	1000	967	69	7	9.857142857142858	949
FBgn0032271	1001	1000	999	3	3	1	998
FBgn0032280	1019	1000	1005	33	8	4.125	986
FBgn0032282	1025	1000	939	111	9	12.333333333333334	914
FBgn0032283	1013	1000	993	33	9	3.6666666666666665	980
FBgn0032284	1016	1000	959	73	9	8.11111111111111	943
FBgn0032285	1011	1000	966	56	11	5.090909090909091	955
FBgn0032286	1008	1000	1002	14	7	2	994
FBgn0032287	1006	1000	971	41	8	5.125	965
FBgn0032289	1031	1000	1004	58	7	8.285714285714286	973
FBgn0032292	930	920	740	200	4	50	730
FBgn0032293	1005	1000	821	189	3	63	816
FBgn0032294	1019	1000	1006	32	4	8	987
FBgn0032295	1025	1000	1021	29	4	7.25	996
FBgn0032296	1000	1000	988	12	5	2.4	988
FBgn0032297	1061	1000	1053	69	8	8.625	992
FBgn0032303	1042	1000	1033	51	5	10.2	991
FBgn0032305	841	784	827	71	11	6.454545454545454	770
FBgn0032311	1006	1000	982	30	10	3	976
FBgn0032312	1032	1000	986	78	16	4.875	954
FBgn0032313	1007	1000	798	216	6	36	791
FBgn0032315	1019	1000	932	106	11	9.636363636363637	913
FBgn0032318	1025	1000	954	96	15	6.4	929
FBgn0032321	1031	1000	1031	31	3	10.333333333333334	1000
FBgn0032330	1020	1000	1013	27	7	3.857142857142857	993
FBgn0032335	1010	1000	990	30	9	3.3333333333333335	980
FBgn0032336	1010	1000	989	31	9	3.4444444444444446	979
FBgn0032337	1029	1000	1005	53	7	7.571428571428571	976
FBgn0032338	1064	1000	1053	75	14	5.357142857142857	989
FBgn0032339	1011	1000	985	37	12	3.0833333333333335	974
FBgn0032341	1002	1000	1000	4	3	1.3333333333333333	998
FBgn0032343	1082	1000	1011	153	16	9.5625	929
FBgn0032345	1022	1000	1002	42	5	8.4	980
FBgn0032346	1014	1000	1014	14	3	4.666666666666667	1000
FBgn0032348	1045	1000	1023	67	9	7.444444444444445	978
FBgn0032350	1023	1000	1008	38	10	3.8	985
FBgn0032354	1024	1000	972	76	11	6.909090909090909	948
FBgn0032358	837	834	778	62	8	7.75	775
FBgn0032360	1017	1000	1016	18	3	6	999
FBgn0032363	1045	1000	1006	84	9	9.333333333333334	961
FBgn0032364	1046	1000	1022	70	9	7.777777777777778	976
FBgn0032368	1003	1000	986	20	7	2.857142857142857	983
FBgn0032369	1000	1000	991	9	3	3	991
FBgn0032370	1002	1000	998	6	3	2	996
FBgn0032371	1021	1000	1020	22	4	5.5	999
FBgn0032372	1010	1000	1000	20	5	4	990
FBgn0032373	1004	1000	956	52	6	8.666666666666666	952
FBgn0032374	1071	1000	1020	122	14	8.714285714285714	949
FBgn0032377	1041	1000	1039	43	5	8.6	998
FBgn0032378	1020	1000	1017	23	8	2.875	997
FBgn0032381	1022	1000	1011	33	9	3.6666666666666665	989
FBgn0032382	856	842	676	194	6	32.333333333333336	662
FBgn0032385	1002	1000	1002	2	1	2	1000
FBgn0032387	1047	1000	1040	54	7	7.714285714285714	993
FBgn0032388	1050	1000	998	102	9	11.333333333333334	948
FBgn0032390	1004	1000	1003	5	3	1.6666666666666667	999
FBgn0032395	1032	1000	1002	62	12	5.166666666666667	970
FBgn0032400	1018	1000	1004	32	6	5.333333333333333	986
FBgn0032401	1030	1000	1002	58	12	4.833333333333333	972
FBgn0032402	1016	1000	988	44	10	4.4	972
FBgn0032404	1012	1000	992	32	8	4	980
FBgn0032406	1062	1000	1043	81	9	9	981
FBgn0032407	1101	1000	1071	131	14	9.357142857142858	970
FBgn0032408	1001	1000	998	4	2	2	997
FBgn0032414	1014	1000	999	29	8	3.625	985
FBgn0032416	1041	1000	1026	56	11	5.090909090909091	985
FBgn0032419	1050	1000	1036	64	9	7.111111111111111	986
FBgn0032420	1016	1000	846	186	9	20.666666666666668	830
FBgn0032421	1023	1000	598	448	5	89.6	575
FBgn0032422	1000	1000	909	91	12	7.583333333333333	909
FBgn0032428	1038	1000	982	94	11	8.545454545454545	944
FBgn0032429	1000	1000	708	292	3	97.33333333333333	708
FBgn0032430	1004	1000	823	185	6	30.833333333333332	819
FBgn0032431	1025	1000	976	74	9	8.222222222222221	951
FBgn0032434	1028	1000	983	73	12	6.083333333333333	955
FBgn0032435	1023	1000	936	110	8	13.75	913
FBgn0032436	1021	1000	901	141	9	15.666666666666666	880
FBgn0032437	1012	1000	648	376	5	75.2	636
FBgn0032439	1000	1000	841	159	5	31.8	841
FBgn0032442	1016	1000	1003	29	9	3.2222222222222223	987
FBgn0032444	1022	1000	1015	29	5	5.8	993
FBgn0032445	1004	1000	985	23	6	3.8333333333333335	981
FBgn0032446	1003	1000	996	10	4	2.5	993
FBgn0032447	1010	1000	1009	11	2	5.5	999
FBgn0032448	1000	1000	1000	0	0	NA	1000
FBgn0032449	1025	1000	865	185	8	23.125	840
FBgn0032450	1079	1000	1059	99	7	14.142857142857142	980
FBgn0032451	1024	1000	1023	25	3	8.333333333333334	999
FBgn0032453	1000	1000	585	415	5	83	585
FBgn0032456	1057	1000	1006	108	22	4.909090909090909	949
FBgn0032457	1008	1000	989	27	9	3	981
FBgn0032462	1019	1000	985	53	11	4.818181818181818	966
FBgn0032464	745	716	739	35	8	4.375	710
FBgn0032465	779	776	745	37	2	18.5	742
FBgn0032470	1000	1000	986	14	4	3.5	986
FBgn0032471	1001	1000	825	177	4	44.25	824
FBgn0032474	1000	1000	997	3	1	3	997
FBgn0032475	1021	1000	1021	21	2	10.5	1000
FBgn0032479	1007	1000	1003	11	5	2.2	996
FBgn0032480	1001	1000	979	23	9	2.5555555555555554	978
FBgn0032481	1052	1000	965	139	13	10.692307692307692	913
FBgn0032482	1038	1000	989	87	10	8.7	951
FBgn0032485	1017	1000	1017	17	1	17	1000
FBgn0032486	1004	1000	985	23	6	3.8333333333333335	981
FBgn0032487	1001	1000	983	19	4	4.75	982
FBgn0032488	1000	1000	986	14	2	7	986
FBgn0032490	1005	1000	980	30	10	3	975
FBgn0032491	1008	1000	982	34	8	4.25	974
FBgn0032492	1008	1000	889	127	9	14.11111111111111	881
FBgn0032493	1007	1000	992	22	6	3.6666666666666665	985
FBgn0032494	832	805	832	27	4	6.75	805
FBgn0032495	1063	1000	1048	78	10	7.8	985
FBgn0032503	1008	1000	1002	14	7	2	994
FBgn0032505	1013	1000	945	81	11	7.363636363636363	932
FBgn0032506	1060	1000	1045	75	21	3.5714285714285716	985
FBgn0032507	1047	1000	1024	70	7	10	977
FBgn0032509	1010	1000	992	28	8	3.5	982
FBgn0032512	1003	1000	988	18	5	3.6	985
FBgn0032513	1013	1000	1004	22	4	5.5	991
FBgn0032514	1018	1000	974	62	8	7.75	956
FBgn0032516	1003	1000	990	16	5	3.2	987
FBgn0032517	1004	1000	1002	6	3	2	998
FBgn0032521	1067	1000	1037	97	8	12.125	970
FBgn0032522	1017	1000	993	41	8	5.125	976
FBgn0032524	1009	1000	973	45	9	5	964
FBgn0032533	1006	1000	659	353	7	50.42857142857143	653
FBgn0032536	1040	1000	1004	76	10	7.6	964
FBgn0032538	1010	1000	941	79	13	6.076923076923077	931
FBgn0032549	1030	1000	1020	40	7	5.714285714285714	990
FBgn0032553	1036	1000	1025	47	8	5.875	989
FBgn0032554	1031	1000	1016	46	6	7.666666666666667	985
FBgn0032563	1028	1000	1014	42	4	10.5	986
FBgn0032577	1010	1000	989	31	6	5.166666666666667	979
FBgn0032585	1058	1000	993	123	8	15.375	935
FBgn0032586	1000	1000	241	759	1	759	241
FBgn0032587	1035	1000	1025	45	9	5	990
FBgn0032588	1003	1000	988	18	5	3.6	985
FBgn0032593	1011	1000	1008	14	4	3.5	997
FBgn0032596	1002	1000	965	39	7	5.571428571428571	963
FBgn0032597	1002	1000	956	48	10	4.8	954
FBgn0032598	1004	1000	985	23	4	5.75	981
FBgn0032600	1043	1000	1035	51	7	7.285714285714286	992
FBgn0032601	1019	1000	1011	27	6	4.5	992
FBgn0032602	1019	1000	1005	33	6	5.5	986
FBgn0032603	1022	1000	986	58	8	7.25	964
FBgn0032612	758	757	698	61	6	10.166666666666666	697
FBgn0032615	1021	1000	1004	38	12	3.1666666666666665	983
FBgn0032624	1011	1000	908	114	11	10.363636363636363	897
FBgn0032625	1017	1000	996	38	6	6.333333333333333	979
FBgn0032626	1000	1000	991	9	4	2.25	991
FBgn0032629	1039	1000	946	132	13	10.153846153846153	907
FBgn0032631	1051	1000	1036	66	10	6.6	985
FBgn0032632	1002	1000	989	15	7	2.142857142857143	987
FBgn0032633	1033	1000	1007	59	10	5.9	974
FBgn0032634	1008	1000	1003	13	6	2.1666666666666665	995
FBgn0032635	1017	1000	1013	21	5	4.2	996
FBgn0032636	1017	1000	769	265	8	33.125	752
FBgn0032638	853	838	412	456	13	35.07692307692308	397
FBgn0032640	1058	1000	940	176	22	8	882
FBgn0032642	1014	1000	1014	14	2	7	1000
FBgn0032643	1036	1000	995	77	7	11	959
FBgn0032644	1003	1000	967	39	3	13	964
FBgn0032646	1017	1000	1013	21	3	7	996
FBgn0032647	1000	1000	994	6	2	3	994
FBgn0032649	1009	1000	887	131	9	14.555555555555555	878
FBgn0032651	1003	1000	977	29	6	4.833333333333333	974
FBgn0032652	1015	1000	995	35	3	11.666666666666666	980
FBgn0032654	1020	1000	1006	34	8	4.25	986
FBgn0032656	1079	1000	1041	117	12	9.75	962
FBgn0032658	1040	1000	1033	47	9	5.222222222222222	993
FBgn0032664	1001	1000	988	14	5	2.8	987
FBgn0032666	1017	1000	999	35	9	3.888888888888889	982
FBgn0032668	1097	1000	1041	153	12	12.75	944
FBgn0032677	1014	1000	952	76	10	7.6	938
FBgn0032680	1027	1000	1019	35	4	8.75	992
FBgn0032681	1036	1000	1020	52	8	6.5	984
FBgn0032682	1036	1000	1020	52	8	6.5	984
FBgn0032683	1007	1000	957	57	7	8.142857142857142	950
FBgn0032684	1008	1000	961	55	9	6.111111111111111	953
FBgn0032685	1002	1000	995	9	5	1.8	993
FBgn0032688	1016	1000	998	34	7	4.857142857142857	982
FBgn0032689	1023	1000	1015	31	11	2.8181818181818183	992
FBgn0032692	1044	1000	830	258	13	19.846153846153847	786
FBgn0032693	1007	1000	999	15	7	2.142857142857143	992
FBgn0032699	1016	1000	997	35	8	4.375	981
FBgn0032700	1016	1000	1010	22	6	3.6666666666666665	994
FBgn0032701	834	828	834	6	3	2	828
FBgn0032702	1019	1000	993	45	13	3.4615384615384617	974
FBgn0032703	1012	1000	980	44	12	3.6666666666666665	968
FBgn0032704	848	829	815	52	6	8.666666666666666	796
FBgn0032705	1030	1000	996	64	7	9.142857142857142	966
FBgn0032706	1060	1000	1041	79	11	7.181818181818182	981
FBgn0032707	1057	1000	1002	112	9	12.444444444444445	945
FBgn0032709	1015	1000	970	60	10	6	955
FBgn0032713	1041	999	951	132	18	7.333333333333333	909
FBgn0032719	1023	1000	978	68	15	4.533333333333333	955
FBgn0032723	1031	1000	1020	42	7	6	989
FBgn0032724	1020	1000	1018	22	6	3.6666666666666665	998
FBgn0032727	1005	988	993	29	7	4.142857142857143	976
FBgn0032728	1021	1000	1013	29	4	7.25	992
FBgn0032729	1001	1000	978	24	3	8	977
FBgn0032730	1005	1000	985	25	3	8.333333333333334	980
FBgn0032731	1026	1000	1020	32	5	6.4	994
FBgn0032732	1025	1000	1009	41	7	5.857142857142857	984
FBgn0032733	1009	1000	1008	10	2	5	999
FBgn0032734	1009	1000	1006	12	3	4	997
FBgn0032741	1014	1000	1009	19	4	4.75	995
FBgn0032744	1010	1000	1004	16	5	3.2	994
FBgn0032746	983	979	929	58	9	6.444444444444445	925
FBgn0032749	1023	1000	948	98	13	7.538461538461538	925
FBgn0032752	1010	1000	888	132	12	11	878
FBgn0032754	1007	1000	995	19	6	3.1666666666666665	988
FBgn0032769	1001	1000	801	201	4	50.25	800
FBgn0032771	1030	1000	1017	43	8	5.375	987
FBgn0032772	1006	1000	994	18	9	2	988
FBgn0032785	1002	1000	955	49	12	4.083333333333333	953
FBgn0032787	1002	1000	1001	3	2	1.5	999
FBgn0032788	1002	1000	1001	3	2	1.5	999
FBgn0032789	1064	1000	1022	106	17	6.235294117647059	958
FBgn0032790	1032	1000	1004	60	6	10	972
FBgn0032791	1003	1000	975	31	4	7.75	972
FBgn0032793	1009	1000	1005	13	4	3.25	996
FBgn0032797	821	787	776	79	12	6.583333333333333	742
FBgn0032799	1011	1000	987	35	9	3.888888888888889	976
FBgn0032800	1014	1000	989	39	12	3.25	975
FBgn0032801	1024	1000	961	87	15	5.8	937
FBgn0032804	984	977	947	44	5	8.8	940
FBgn0032809	898	880	824	92	4	23	806
FBgn0032811	983	980	968	18	5	3.6	965
FBgn0032815	1015	1000	1014	16	3	5.333333333333333	999
FBgn0032818	1006	1000	1003	9	2	4.5	997
FBgn0032819	1000	1000	997	3	1	3	997
FBgn0032820	1055	1000	1041	69	11	6.2727272727272725	986
FBgn0032821	1035	1000	1015	55	11	5	980
FBgn0032822	1012	1000	993	31	8	3.875	981
FBgn0032827	1002	1000	993	11	7	1.5714285714285714	991
FBgn0032833	1000	1000	947	53	6	8.833333333333334	947
FBgn0032834	1012	1000	1012	12	2	6	1000
FBgn0032835	1002	1000	994	10	5	2	992
FBgn0032840	1013	1000	931	95	10	9.5	918
FBgn0032843	1000	1000	976	24	6	4	976
FBgn0032845	1002	1000	946	58	5	11.6	944
FBgn0032846	1000	1000	961	39	6	6.5	961
FBgn0032847	1007	1000	986	28	6	4.666666666666667	979
FBgn0032848	860	860	856	4	1	4	856
FBgn0032849	1000	1000	955	45	7	6.428571428571429	955
FBgn0032850	1022	1000	1000	44	6	7.333333333333333	978
FBgn0032853	1027	1000	993	61	11	5.545454545454546	966
FBgn0032856	1009	1000	967	51	9	5.666666666666667	958
FBgn0032858	1022	1000	938	106	6	17.666666666666668	916
FBgn0032860	1026	1000	1019	33	7	4.714285714285714	993
FBgn0032867	1024	1000	989	59	8	7.375	965
FBgn0032870	1000	1000	996	4	2	2	996
FBgn0032873	1005	1000	992	18	6	3	987
FBgn0032876	1004	1000	968	40	8	5	964
FBgn0032877	1004	1000	995	13	5	2.6	991
FBgn0032878	1026	1000	942	110	12	9.166666666666666	916
FBgn0032879	718	717	714	5	3	1.6666666666666667	713
FBgn0032880	1052	1000	1040	64	15	4.266666666666667	988
FBgn0032881	1024	1000	1004	44	6	7.333333333333333	980
FBgn0032882	1037	1000	1028	46	8	5.75	991
FBgn0032883	1003	1000	957	49	6	8.166666666666666	954
FBgn0032884	1020	1000	1002	38	6	6.333333333333333	982
FBgn0032889	1022	1000	998	46	6	7.666666666666667	976
FBgn0032895	1032	1000	979	85	15	5.666666666666667	947
FBgn0032896	1013	1000	994	32	8	4	981
FBgn0032897	1012	1000	990	34	8	4.25	978
FBgn0032898	1000	1000	429	571	5	114.2	429
FBgn0032908	1013	1000	940	86	7	12.285714285714286	927
FBgn0032911	1016	1000	988	44	6	7.333333333333333	972
FBgn0032913	1057	1000	1005	109	10	10.9	948
FBgn0032916	1002	1000	965	39	7	5.571428571428571	963
FBgn0032919	1000	1000	262	738	4	184.5	262
FBgn0032921	1004	1000	989	19	5	3.8	985
FBgn0032922	1025	1000	988	62	7	8.857142857142858	963
FBgn0032923	1000	1000	932	68	6	11.333333333333334	932
FBgn0032935	1079	1000	1030	128	18	7.111111111111111	951
FBgn0032940	1019	1000	944	94	14	6.714285714285714	925
FBgn0032957	790	780	745	55	15	3.6666666666666665	735
FBgn0032961	1008	1000	710	306	7	43.714285714285715	702
FBgn0032965	1031	1000	976	86	16	5.375	945
FBgn0032967	1028	1000	994	62	8	7.75	966
FBgn0032968	1000	1000	967	33	7	4.714285714285714	967
FBgn0032969	1027	1000	946	108	16	6.75	919
FBgn0032971	1056	1000	967	145	17	8.529411764705882	911
FBgn0032973	1019	1000	637	401	17	23.58823529411765	618
FBgn0032981	1007	1000	310	704	3	234.66666666666666	303
FBgn0032988	1028	1000	371	685	10	68.5	343
FBgn0033010	1000	1000	148	852	1	852	148
FBgn0033028	1031	1000	620	442	15	29.466666666666665	589
FBgn0033038	1012	1000	663	361	4	90.25	651
FBgn0033043	1008	1000	1002	14	6	2.3333333333333335	994
FBgn0033054	1026	1000	946	106	14	7.571428571428571	920
FBgn0033055	1051	1000	689	413	13	31.76923076923077	638
FBgn0033056	1003	1000	964	42	8	5.25	961
FBgn0033058	1009	1000	993	25	5	5	984
FBgn0033060	1002	1000	541	463	4	115.75	539
FBgn0033061	765	761	758	11	4	2.75	754
FBgn0033063	1034	1000	1007	61	12	5.083333333333333	973
FBgn0033067	885	883	878	9	4	2.25	876
FBgn0033076	1000	1000	978	22	4	5.5	978
FBgn0033081	1043	1000	756	330	6	55	713
FBgn0033085	775	772	774	4	3	1.3333333333333333	771
FBgn0033087	1008	1000	1007	9	4	2.25	999
FBgn0033088	1015	1000	1005	25	8	3.125	990
FBgn0033093	994	923	964	101	10	10.1	893
FBgn0033096	834	833	294	541	2	270.5	293
FBgn0033097	1015	1000	816	214	7	30.571428571428573	801
FBgn0033108	1039	1000	1013	65	9	7.222222222222222	974
FBgn0033113	934	906	934	28	2	14	906
FBgn0033127	1002	1000	591	413	11	37.54545454545455	589
FBgn0033128	1002	1000	929	75	13	5.769230769230769	927
FBgn0033129	681	671	675	16	3	5.333333333333333	665
FBgn0033134	1046	1000	1015	77	9	8.555555555555555	969
FBgn0033135	1006	999	996	17	6	2.8333333333333335	989
FBgn0033136	836	797	817	58	10	5.8	778
FBgn0033138	1014	1000	985	43	10	4.3	971
FBgn0033139	1014	1000	978	50	10	5	964
FBgn0033140	1004	1000	877	131	4	32.75	873
FBgn0033141	1032	1000	979	85	6	14.166666666666666	947
FBgn0033145	1066	1000	1059	73	9	8.11111111111111	993
FBgn0033153	1044	1000	1032	56	7	8	988
FBgn0033154	1021	1000	985	57	9	6.333333333333333	964
FBgn0033155	1000	1000	999	1	1	1	999
FBgn0033158	1034	1000	1001	67	6	11.166666666666666	967
FBgn0033159	1000	1000	936	64	6	10.666666666666666	936
FBgn0033160	1005	1000	998	12	4	3	993
FBgn0033164	1118	1000	1020	216	14	15.428571428571429	902
FBgn0033166	1005	1000	489	521	8	65.125	484
FBgn0033167	1016	1000	960	72	8	9	944
FBgn0033168	924	902	906	40	6	6.666666666666667	884
FBgn0033169	1004	1000	639	369	3	123	635
FBgn0033174	1034	1000	973	95	10	9.5	939
FBgn0033177	1001	1000	1001	1	1	1	1000
FBgn0033178	1001	1000	978	24	7	3.4285714285714284	977
FBgn0033186	1014	1000	1004	24	8	3	990
FBgn0033187	1014	1000	998	30	10	3	984
FBgn0033191	1030	1000	920	140	10	14	890
FBgn0033192	1011	1000	987	35	5	7	976
FBgn0033194	1000	1000	978	22	4	5.5	978
FBgn0033195	1006	1000	1004	8	3	2.6666666666666665	998
FBgn0033196	1017	1000	990	44	9	4.888888888888889	973
FBgn0033199	1000	1000	1000	0	0	NA	1000
FBgn0033205	760	703	702	115	13	8.846153846153847	645
FBgn0033206	1039	1000	257	821	6	136.83333333333334	218
FBgn0033207	1003	1000	977	29	6	4.833333333333333	974
FBgn0033208	1000	1000	992	8	3	2.6666666666666665	992
FBgn0033209	1017	1000	1017	17	2	8.5	1000
FBgn0033210	1011	1000	992	30	5	6	981
FBgn0033212	1013	1000	1003	23	4	5.75	990
FBgn0033214	1069	1000	1037	101	10	10.1	968
FBgn0033215	682	677	629	58	8	7.25	624
FBgn0033216	808	802	780	34	8	4.25	774
FBgn0033221	1009	1000	976	42	7	6	967
FBgn0033224	1006	1000	984	28	8	3.5	978
FBgn0033225	1042	1000	1019	65	11	5.909090909090909	977
FBgn0033226	1054	1000	1044	64	12	5.333333333333333	990
FBgn0033232	1045	1000	1010	80	15	5.333333333333333	965
FBgn0033234	1047	1000	1014	80	10	8	967
FBgn0033236	1040	1000	973	107	13	8.23076923076923	933
FBgn0033240	1020	1000	1006	34	9	3.7777777777777777	986
FBgn0033243	1004	1000	998	10	4	2.5	994
FBgn0033244	1065	1000	990	140	11	12.727272727272727	925
FBgn0033247	1012	1000	985	39	10	3.9	973
FBgn0033248	705	692	680	38	7	5.428571428571429	667
FBgn0033249	1019	1000	976	62	11	5.636363636363637	957
FBgn0033250	1050	1000	863	237	14	16.928571428571427	813
FBgn0033252	1019	1000	996	42	9	4.666666666666667	977
FBgn0033258	1014	1000	1001	27	9	3	987
FBgn0033259	1012	1000	988	36	7	5.142857142857143	976
FBgn0033261	1000	1000	986	14	2	7	986
FBgn0033265	1003	1000	996	10	3	3.3333333333333335	993
FBgn0033266	1010	1000	1009	11	3	3.6666666666666665	999
FBgn0033268	1110	1000	1027	193	24	8.041666666666666	917
FBgn0033275	1004	1000	991	17	5	3.4	987
FBgn0033277	1007	1000	943	71	6	11.833333333333334	936
FBgn0033285	1002	1000	943	61	9	6.777777777777778	941
FBgn0033289	1015	1000	994	36	4	9	979
FBgn0033294	1003	1000	988	18	5	3.6	985
FBgn0033297	1000	1000	992	8	1	8	992
FBgn0033301	1000	1000	585	415	4	103.75	585
FBgn0033302	1008	1000	990	26	6	4.333333333333333	982
FBgn0033303	1054	1000	902	206	18	11.444444444444445	848
FBgn0033307	1000	1000	987	13	3	4.333333333333333	987
FBgn0033308	1014	1000	974	54	7	7.714285714285714	960
FBgn0033309	1038	1000	670	406	5	81.2	632
FBgn0033312	1008	1000	952	64	9	7.111111111111111	944
FBgn0033313	1010	1000	952	68	10	6.8	942
FBgn0033315	1022	1000	947	97	6	16.166666666666668	925
FBgn0033317	1056	1000	1016	96	13	7.384615384615385	960
FBgn0033323	1000	1000	989	11	1	11	989
FBgn0033327	1023	1000	1008	38	6	6.333333333333333	985
FBgn0033330	1000	1000	993	7	3	2.3333333333333335	993
FBgn0033337	1047	1000	1014	80	12	6.666666666666667	967
FBgn0033340	1003	1000	1003	3	1	3	1000
FBgn0033341	1005	1000	978	32	8	4	973
FBgn0033344	831	830	829	3	2	1.5	828
FBgn0033348	1000	1000	1000	0	0	NA	1000
FBgn0033349	1000	1000	988	12	2	6	988
FBgn0033350	974	967	962	19	6	3.1666666666666665	955
FBgn0033351	1001	1000	1000	2	2	1	999
FBgn0033352	1000	1000	990	10	2	5	990
FBgn0033357	1015	1000	1007	23	6	3.8333333333333335	992
FBgn0033358	1065	1000	987	143	16	8.9375	922
FBgn0033362	985	979	974	17	3	5.666666666666667	968
FBgn0033363	1013	1000	1005	21	4	5.25	992
FBgn0033364	1013	1000	1005	21	4	5.25	992
FBgn0033365	1073	1000	1049	97	13	7.461538461538462	976
FBgn0033367	1002	1000	996	8	3	2.6666666666666665	994
FBgn0033372	1000	1000	1000	0	0	NA	1000
FBgn0033376	1000	1000	1000	0	0	NA	1000
FBgn0033379	1015	1000	1015	15	4	3.75	1000
FBgn0033380	1015	1000	1015	15	4	3.75	1000
FBgn0033382	1009	1000	986	32	12	2.6666666666666665	977
FBgn0033387	1011	1000	981	41	5	8.2	970
FBgn0033388	1007	1000	980	34	6	5.666666666666667	973
FBgn0033389	1007	1000	980	34	6	5.666666666666667	973
FBgn0033392	1005	1000	993	17	5	3.4	988
FBgn0033395	1038	1000	972	104	19	5.473684210526316	934
FBgn0033400	1000	1000	882	118	2	59	882
FBgn0033401	1057	1000	1014	100	7	14.285714285714286	957
FBgn0033402	1007	1000	1000	14	5	2.8	993
FBgn0033404	1041	1000	1030	52	12	4.333333333333333	989
FBgn0033412	1000	1000	981	19	5	3.8	981
FBgn0033413	1000	1000	979	21	6	3.5	979
FBgn0033421	1002	1000	947	57	11	5.181818181818182	945
FBgn0033422	1018	1000	990	46	10	4.6	972
FBgn0033427	1000	1000	983	17	2	8.5	983
FBgn0033428	1043	1000	1038	48	6	8	995
FBgn0033431	1006	1000	1005	7	4	1.75	999
FBgn0033438	1164	1000	1074	254	20	12.7	910
FBgn0033442	1003	1000	489	517	9	57.44444444444444	486
FBgn0033443	1034	1000	926	142	13	10.923076923076923	892
FBgn0033446	1007	1000	1000	14	5	2.8	993
FBgn0033447	1018	1000	996	40	8	5	978
FBgn0033448	1000	1000	1000	0	0	NA	1000
FBgn0033449	1000	1000	990	10	3	3.3333333333333335	990
FBgn0033450	1029	1000	1020	38	4	9.5	991
FBgn0033451	1029	1000	1020	38	4	9.5	991
FBgn0033453	1008	1000	1001	15	6	2.5	993
FBgn0033454	1012	1000	1011	13	4	3.25	999
FBgn0033457	1000	1000	995	5	4	1.25	995
FBgn0033460	1021	1000	1013	29	9	3.2222222222222223	992
FBgn0033461	1000	1000	997	3	1	3	997
FBgn0033463	1055	1000	1026	84	8	10.5	971
FBgn0033464	1039	1000	1017	61	11	5.545454545454546	978
FBgn0033467	1004	1000	990	18	8	2.25	986
FBgn0033469	1040	1000	842	238	9	26.444444444444443	802
FBgn0033474	1001	1000	977	25	5	5	976
FBgn0033475	1002	1000	984	20	6	3.3333333333333335	982
FBgn0033479	764	721	744	63	9	7	701
FBgn0033480	1020	1000	970	70	5	14	950
FBgn0033481	1002	1000	1002	2	1	2	1000
FBgn0033482	1045	1000	1037	53	11	4.818181818181818	992
FBgn0033483	1011	1000	967	55	7	7.857142857142857	956
FBgn0033484	1012	1000	970	54	12	4.5	958
FBgn0033485	1028	1000	1024	32	5	6.4	996
FBgn0033486	819	818	819	1	1	1	818
FBgn0033490	1000	1000	997	3	2	1.5	997
FBgn0033494	1007	1000	970	44	10	4.4	963
FBgn0033498	1016	1000	965	67	6	11.166666666666666	949
FBgn0033499	1035	1000	1017	53	7	7.571428571428571	982
FBgn0033501	1018	1000	981	55	9	6.111111111111111	963
FBgn0033502	1023	1000	986	60	9	6.666666666666667	963
FBgn0033507	1001	1000	784	218	3	72.66666666666667	783
FBgn0033508	1074	1000	1058	90	10	9	984
FBgn0033523	1034	1000	989	79	11	7.181818181818182	955
FBgn0033524	1078	1000	1066	90	12	7.5	988
FBgn0033526	1004	1000	995	13	5	2.6	991
FBgn0033527	1002	1000	1002	2	1	2	1000
FBgn0033528	1044	1000	1028	60	4	15	984
FBgn0033529	1005	1000	1002	8	2	4	997
FBgn0033538	1009	1000	986	32	8	4	977
FBgn0033539	1005	1000	993	17	4	4.25	988
FBgn0033540	1005	1000	1003	7	4	1.75	998
FBgn0033542	1026	1000	990	62	7	8.857142857142858	964
FBgn0033543	1000	1000	808	192	6	32	808
FBgn0033544	1004	1000	992	16	7	2.2857142857142856	988
FBgn0033547	1015	1000	1007	23	9	2.5555555555555554	992
FBgn0033548	1000	1000	975	25	3	8.333333333333334	975
FBgn0033550	1002	1000	994	10	6	1.6666666666666667	992
FBgn0033551	1004	1000	1003	5	2	2.5	999
FBgn0033555	693	692	666	28	4	7	665
FBgn0033556	1003	1000	1001	5	4	1.25	998
FBgn0033557	1011	1000	998	24	6	4	987
FBgn0033558	1013	1000	988	38	10	3.8	975
FBgn0033564	1001	1000	992	10	3	3.3333333333333335	991
FBgn0033569	1021	1000	1005	37	9	4.111111111111111	984
FBgn0033571	1090	1000	958	222	16	13.875	868
FBgn0033572	1001	1000	989	13	4	3.25	988
FBgn0033574	1032	1000	1020	44	11	4	988
FBgn0033578	1002	1000	977	27	10	2.7	975
FBgn0033579	1043	1000	1000	86	16	5.375	957
FBgn0033580	1053	1000	1005	101	17	5.9411764705882355	952
FBgn0033582	1004	1000	982	26	5	5.2	978
FBgn0033584	1042	1000	1021	63	11	5.7272727272727275	979
FBgn0033587	1003	1000	1001	5	2	2.5	998
FBgn0033588	1008	1000	1005	11	3	3.6666666666666665	997
FBgn0033589	867	841	847	46	7	6.571428571428571	821
FBgn0033591	700	672	649	79	4	19.75	621
FBgn0033592	1000	1000	940	60	7	8.571428571428571	940
FBgn0033593	1049	1000	1030	68	9	7.555555555555555	981
FBgn0033594	1017	1000	980	54	9	6	963
FBgn0033597	1007	1000	996	18	2	9	989
FBgn0033598	1028	1000	1018	38	8	4.75	990
FBgn0033600	1013	1000	990	36	8	4.5	977
FBgn0033601	1004	1000	825	183	5	36.6	821
FBgn0033602	1000	1000	902	98	3	32.666666666666664	902
FBgn0033603	1001	1000	991	11	6	1.8333333333333333	990
FBgn0033605	1000	1000	1000	0	0	NA	1000
FBgn0033607	1001	1000	991	11	3	3.6666666666666665	990
FBgn0033608	1001	1000	993	9	3	3	992
FBgn0033614	1006	1000	1002	10	4	2.5	996
FBgn0033616	1010	1000	866	154	8	19.25	856
FBgn0033623	964	963	941	24	2	12	940
FBgn0033627	1003	1000	974	32	4	8	971
FBgn0033628	1037	1000	991	83	17	4.882352941176471	954
FBgn0033629	1002	1000	861	143	9	15.88888888888889	859
FBgn0033631	952	946	915	43	12	3.5833333333333335	909
FBgn0033635	1024	1000	1005	43	6	7.166666666666667	981
FBgn0033638	1027	1000	1010	44	7	6.285714285714286	983
FBgn0033639	754	750	744	14	3	4.666666666666667	740
FBgn0033640	1014	1000	975	53	12	4.416666666666667	961
FBgn0033645	1022	1000	1015	29	10	2.9	993
FBgn0033648	1004	1000	999	9	3	3	995
FBgn0033651	1026	1000	1013	39	10	3.9	987
FBgn0033652	1020	1000	1000	40	7	5.714285714285714	980
FBgn0033653	1011	1000	1006	16	6	2.6666666666666665	995
FBgn0033654	1031	1000	843	219	7	31.285714285714285	812
FBgn0033658	1020	1000	1008	32	5	6.4	988
FBgn0033661	1033	1000	1021	45	8	5.625	988
FBgn0033667	1000	1000	999	1	1	1	999
FBgn0033668	1020	1000	1005	35	9	3.888888888888889	985
FBgn0033669	1051	1000	1012	90	11	8.181818181818182	961
FBgn0033672	1005	1000	989	21	6	3.5	984
FBgn0033673	1005	1000	995	15	5	3	990
FBgn0033677	964	964	957	7	3	2.3333333333333335	957
FBgn0033679	1018	1000	971	65	12	5.416666666666667	953
FBgn0033680	1008	1000	956	60	12	5	948
FBgn0033685	1040	1000	952	128	18	7.111111111111111	912
FBgn0033686	1040	1000	941	139	19	7.315789473684211	901
FBgn0033688	1037	1000	1031	43	11	3.909090909090909	994
FBgn0033696	1000	1000	990	10	3	3.3333333333333335	990
FBgn0033697	1000	1000	995	5	2	2.5	995
FBgn0033699	1026	1000	1004	48	8	6	978
FBgn0033701	1008	1000	883	133	12	11.083333333333334	875
FBgn0033702	1020	1000	1004	36	8	4.5	984
FBgn0033703	1050	1000	1028	72	16	4.5	978
FBgn0033705	1023	1000	1005	41	8	5.125	982
FBgn0033706	1054	1000	956	152	12	12.666666666666666	902
FBgn0033708	1050	1000	930	170	14	12.142857142857142	880
FBgn0033710	1036	1000	966	106	9	11.777777777777779	930
FBgn0033713	1003	1000	1001	5	4	1.25	998
FBgn0033717	1030	1000	1024	36	3	12	994
FBgn0033720	772	760	752	32	7	4.571428571428571	740
FBgn0033723	1018	1000	1000	36	9	4	982
FBgn0033724	1013	1000	987	39	11	3.5454545454545454	974
FBgn0033725	1058	1000	1048	68	8	8.5	990
FBgn0033727	1003	1000	993	13	6	2.1666666666666665	990
FBgn0033728	1076	1000	1047	105	7	15	971
FBgn0033729	1014	1000	987	41	7	5.857142857142857	973
FBgn0033730	1010	1000	978	42	5	8.4	968
FBgn0033732	1001	1000	995	7	3	2.3333333333333335	994
FBgn0033733	1018	1000	992	44	10	4.4	974
FBgn0033734	1010	1000	991	29	5	5.8	981
FBgn0033737	1012	1000	951	73	12	6.083333333333333	939
FBgn0033738	1008	1000	1005	11	4	2.75	997
FBgn0033740	1000	1000	1000	0	0	NA	1000
FBgn0033741	1006	1000	993	19	8	2.375	987
FBgn0033749	1040	1000	1035	45	9	5	995
FBgn0033751	1006	1000	1004	8	3	2.6666666666666665	998
FBgn0033752	1012	1000	1005	19	3	6.333333333333333	993
FBgn0033753	1058	1000	1005	111	16	6.9375	947
FBgn0033757	1005	1000	989	21	5	4.2	984
FBgn0033760	1030	1000	695	365	7	52.142857142857146	665
FBgn0033761	1002	1000	983	21	5	4.2	981
FBgn0033762	1001	1000	986	16	4	4	985
FBgn0033766	1021	1000	997	45	4	11.25	976
FBgn0033767	1003	1000	1003	3	1	3	1000
FBgn0033769	1012	1000	734	290	11	26.363636363636363	722
FBgn0033770	1029	1000	1004	54	17	3.176470588235294	975
FBgn0033774	1015	1000	1000	30	2	15	985
FBgn0033775	1004	1000	950	58	8	7.25	946
FBgn0033777	1052	1000	959	145	14	10.357142857142858	907
FBgn0033781	847	846	845	3	3	1	844
FBgn0033783	706	706	704	2	1	2	704
FBgn0033784	1020	1000	999	41	9	4.555555555555555	979
FBgn0033785	1017	1000	1012	22	4	5.5	995
FBgn0033787	1014	1000	931	97	17	5.705882352941177	917
FBgn0033788	1016	1000	966	66	10	6.6	950
FBgn0033789	1011	1000	1002	20	9	2.2222222222222223	991
FBgn0033791	1038	1000	1007	69	9	7.666666666666667	969
FBgn0033794	1051	1000	1012	90	11	8.181818181818182	961
FBgn0033806	1017	1000	992	42	7	6	975
FBgn0033807	1010	1000	1006	14	5	2.8	996
FBgn0033810	1019	1000	968	70	11	6.363636363636363	949
FBgn0033812	1006	1000	986	26	9	2.888888888888889	980
FBgn0033813	1006	1000	985	27	9	3	979
FBgn0033814	1019	1000	963	75	16	4.6875	944
FBgn0033815	1039	1000	976	102	17	6	937
FBgn0033816	1015	1000	999	31	8	3.875	984
FBgn0033817	1002	1000	1001	3	2	1.5	999
FBgn0033826	1075	1000	1060	90	10	9	985
FBgn0033827	1001	1000	959	43	2	21.5	958
FBgn0033828	1000	1000	994	6	4	1.5	994
FBgn0033830	1049	1000	986	112	26	4.3076923076923075	937
FBgn0033834	1046	1000	1023	69	10	6.9	977
FBgn0033842	1020	1000	1020	20	4	5	1000
FBgn0033844	1022	1000	1020	24	2	12	998
FBgn0033845	1031	1000	957	105	16	6.5625	926
FBgn0033848	1032	1000	1026	38	9	4.222222222222222	994
FBgn0033850	1012	1000	950	74	9	8.222222222222221	938
FBgn0033851	1018	1000	921	115	19	6.052631578947368	903
FBgn0033853	1003	1000	965	41	8	5.125	962
FBgn0033856	1013	1000	967	59	10	5.9	954
FBgn0033859	1005	1000	999	11	6	1.8333333333333333	994
FBgn0033861	1006	1000	961	51	10	5.1	955
FBgn0033862	1046	1000	1032	60	6	10	986
FBgn0033866	1027	1000	996	58	13	4.461538461538462	969
FBgn0033867	1019	1000	913	125	14	8.928571428571429	894
FBgn0033868	1034	1000	1027	41	7	5.857142857142857	993
FBgn0033869	1024	1000	1007	41	8	5.125	983
FBgn0033871	1015	1000	988	42	10	4.2	973
FBgn0033872	1022	939	983	122	17	7.176470588235294	900
FBgn0033873	1055	1000	1029	81	9	9	974
FBgn0033874	1057	1000	1031	83	11	7.545454545454546	974
FBgn0033875	875	834	826	90	7	12.857142857142858	785
FBgn0033876	1024	1000	1012	36	5	7.2	988
FBgn0033883	1001	1000	994	8	3	2.6666666666666665	993
FBgn0033884	1053	1000	1050	56	3	18.666666666666668	997
FBgn0033885	1001	1000	973	29	10	2.9	972
FBgn0033886	1015	1000	1003	27	6	4.5	988
FBgn0033888	875	818	852	80	10	8	795
FBgn0033890	1005	1000	1003	7	3	2.3333333333333335	998
FBgn0033891	1000	1000	1000	0	0	NA	1000
FBgn0033897	1000	1000	1000	0	0	NA	1000
FBgn0033899	730	728	712	20	6	3.3333333333333335	710
FBgn0033900	1013	1000	1011	15	3	5	998
FBgn0033901	1003	1000	984	22	5	4.4	981
FBgn0033902	1003	1000	991	15	7	2.142857142857143	988
FBgn0033903	1001	1000	981	21	8	2.625	980
FBgn0033907	1001	1000	999	3	3	1	998
FBgn0033912	1059	1000	856	262	19	13.789473684210526	797
FBgn0033913	1008	1000	973	43	10	4.3	965
FBgn0033915	1001	1000	991	11	3	3.6666666666666665	990
FBgn0033916	1002	1000	992	12	3	4	990
FBgn0033918	1089	1000	1081	97	6	16.166666666666668	992
FBgn0033919	1041	1000	1017	65	6	10.833333333333334	976
FBgn0033921	1014	1000	744	284	9	31.555555555555557	730
FBgn0033924	765	730	750	50	9	5.555555555555555	715
FBgn0033925	1173	1000	1153	193	15	12.866666666666667	980
FBgn0033927	1026	1000	890	162	5	32.4	864
FBgn0033931	1008	1000	1005	11	6	1.8333333333333333	997
FBgn0033932	1011	1000	994	28	7	4	983
FBgn0033933	1006	1000	983	29	9	3.2222222222222223	977
FBgn0033936	1078	1000	1028	128	9	14.222222222222221	950
FBgn0033942	1004	1000	1001	7	5	1.4	997
FBgn0033943	1016	1000	969	63	10	6.3	953
FBgn0033950	1052	1000	987	117	9	13	935
FBgn0033951	1021	1000	952	90	15	6	931
FBgn0033952	1015	1000	990	40	9	4.444444444444445	975
FBgn0033954	1008	1000	983	33	8	4.125	975
FBgn0033955	1003	1000	981	25	7	3.5714285714285716	978
FBgn0033958	1025	1000	990	60	11	5.454545454545454	965
FBgn0033960	791	791	766	25	2	12.5	766
FBgn0033961	1000	1000	982	18	4	4.5	982
FBgn0033963	1003	1000	984	22	7	3.142857142857143	981
FBgn0033968	1045	1000	1004	86	10	8.6	959
FBgn0033969	1020	1000	1011	29	7	4.142857142857143	991
FBgn0033970	1013	1000	980	46	11	4.181818181818182	967
FBgn0033972	1052	1000	1009	95	10	9.5	957
FBgn0033973	1052	1000	1006	98	11	8.909090909090908	954
FBgn0033983	1010	1000	996	24	7	3.4285714285714284	986
FBgn0033984	1010	1000	960	60	9	6.666666666666667	950
FBgn0033985	1059	1000	1036	82	11	7.454545454545454	977
FBgn0033987	1000	1000	987	13	3	4.333333333333333	987
FBgn0033990	1043	1000	1000	86	11	7.818181818181818	957
FBgn0033993	1008	1000	1007	9	3	3	999
FBgn0033994	1000	1000	985	15	3	5	985
FBgn0033995	1025	1000	990	60	8	7.5	965
FBgn0033996	1003	1000	993	13	3	4.333333333333333	990
FBgn0033998	704	697	677	34	11	3.090909090909091	670
FBgn0033999	1000	1000	1000	0	0	NA	1000
FBgn0034000	1000	1000	1000	0	0	NA	1000
FBgn0034008	1030	1000	1015	45	9	5	985
FBgn0034009	1002	1000	916	88	4	22	914
FBgn0034011	1007	1000	969	45	10	4.5	962
FBgn0034012	1003	1000	990	16	4	4	987
FBgn0034013	1076	1000	1037	115	19	6.052631578947368	961
FBgn0034021	1025	1000	959	91	10	9.1	934
FBgn0034022	1038	1000	1004	72	11	6.545454545454546	966
FBgn0034023	1009	1000	1006	12	3	4	997
FBgn0034025	1054	1000	1029	79	14	5.642857142857143	975
FBgn0034030	1024	1000	1016	32	5	6.4	992
FBgn0034032	785	772	635	163	8	20.375	622
FBgn0034045	1011	1000	971	51	16	3.1875	960
FBgn0034049	696	696	676	20	6	3.3333333333333335	676
FBgn0034050	1005	1000	998	12	4	3	993
FBgn0034052	1007	1000	965	49	6	8.166666666666666	958
FBgn0034053	1007	1000	997	17	5	3.4	990
FBgn0034054	1001	1000	997	5	3	1.6666666666666667	996
FBgn0034058	1000	1000	999	1	1	1	999
FBgn0034059	1001	1000	995	7	2	3.5	994
FBgn0034060	1008	1000	1000	16	7	2.2857142857142856	992
FBgn0034062	1000	1000	997	3	2	1.5	997
FBgn0034065	1013	1000	1000	26	7	3.7142857142857144	987
FBgn0034066	1011	1000	877	145	14	10.357142857142858	866
FBgn0034067	1013	1000	910	116	11	10.545454545454545	897
FBgn0034068	1001	1000	995	7	2	3.5	994
FBgn0034069	1000	1000	987	13	4	3.25	987
FBgn0034072	815	805	813	12	3	4	803
FBgn0034073	1001	1000	990	12	2	6	989
FBgn0034075	1016	1000	997	35	8	4.375	981
FBgn0034081	1016	1000	1005	27	8	3.375	989
FBgn0034082	1053	1000	1008	98	16	6.125	955
FBgn0034083	1007	1000	998	16	4	4	991
FBgn0034085	1002	1000	997	7	5	1.4	995
FBgn0034086	1000	1000	981	19	7	2.7142857142857144	981
FBgn0034087	1011	1000	974	48	10	4.8	963
FBgn0034092	690	669	674	37	8	4.625	653
FBgn0034093	1000	1000	1000	0	0	NA	1000
FBgn0034094	1065	1000	986	144	18	8	921
FBgn0034099	1025	1000	987	63	15	4.2	962
FBgn0034103	1041	1000	994	88	15	5.866666666666666	953
FBgn0034109	1010	1000	1005	15	5	3	995
FBgn0034110	1010	1000	1006	14	5	2.8	996
FBgn0034114	1002	1000	999	5	4	1.25	997
FBgn0034117	1004	1000	1000	8	3	2.6666666666666665	996
FBgn0034118	1024	1000	1014	34	7	4.857142857142857	990
FBgn0034121	1010	1000	922	98	9	10.88888888888889	912
FBgn0034122	1005	1000	961	49	4	12.25	956
FBgn0034126	1008	1000	997	19	6	3.1666666666666665	989
FBgn0034127	1009	1000	973	45	7	6.428571428571429	964
FBgn0034128	1073	1000	1062	84	11	7.636363636363637	989
FBgn0034129	1011	1000	993	29	11	2.6363636363636362	982
FBgn0034131	1008	1000	891	125	12	10.416666666666666	883
FBgn0034132	1015	1000	974	56	11	5.090909090909091	959
FBgn0034135	1010	1000	1003	17	7	2.4285714285714284	993
FBgn0034136	1054	1000	1040	68	11	6.181818181818182	986
FBgn0034137	1054	1000	1047	61	8	7.625	993
FBgn0034138	1050	1000	1003	97	17	5.705882352941177	953
FBgn0034139	1050	1000	999	101	18	5.611111111111111	949
FBgn0034143	1028	1000	965	91	10	9.1	937
FBgn0034144	1017	1000	998	36	8	4.5	981
FBgn0034151	1027	1000	1024	30	4	7.5	997
FBgn0034156	1022	1000	979	65	12	5.416666666666667	957
FBgn0034157	993	971	975	40	10	4	953
FBgn0034158	871	794	835	113	14	8.071428571428571	758
FBgn0034159	1002	1000	996	8	3	2.6666666666666665	994
FBgn0034160	1030	1000	1001	59	13	4.538461538461538	971
FBgn0034166	1006	1000	958	54	6	9	952
FBgn0034168	1024	1000	1018	30	8	3.75	994
FBgn0034173	1066	1000	1040	92	9	10.222222222222221	974
FBgn0034176	1000	1000	1000	0	0	NA	1000
FBgn0034177	1000	1000	1000	0	0	NA	1000
FBgn0034179	1047	1000	1034	60	7	8.571428571428571	987
FBgn0034180	1041	1000	1028	54	10	5.4	987
FBgn0034181	1060	1000	644	476	13	36.61538461538461	584
FBgn0034186	1015	1000	979	51	9	5.666666666666667	964
FBgn0034187	1002	1000	1001	3	3	1	999
FBgn0034191	1003	1000	895	111	5	22.2	892
FBgn0034194	1017	1000	1011	23	7	3.2857142857142856	994
FBgn0034196	1029	1000	992	66	7	9.428571428571429	963
FBgn0034197	1000	1000	1000	0	0	NA	1000
FBgn0034201	1002	1000	985	19	6	3.1666666666666665	983
FBgn0034204	1002	1000	979	25	5	5	977
FBgn0034205	1059	1000	1030	88	11	8	971
FBgn0034210	1018	1000	992	44	7	6.285714285714286	974
FBgn0034214	1019	1000	1014	24	5	4.8	995
FBgn0034215	1019	1000	1016	22	4	5.5	997
FBgn0034217	1008	1000	994	22	7	3.142857142857143	986
FBgn0034223	1016	1000	990	42	9	4.666666666666667	974
FBgn0034224	1075	1000	1007	143	16	8.9375	932
FBgn0034225	1030	1000	967	93	18	5.166666666666667	937
FBgn0034231	1008	1000	1004	12	4	3	996
FBgn0034232	1000	1000	1000	0	0	NA	1000
FBgn0034237	1002	1000	984	20	4	5	982
FBgn0034240	1012	1000	1010	14	3	4.666666666666667	998
FBgn0034243	1001	1000	994	8	4	2	993
FBgn0034245	1000	1000	985	15	5	3	985
FBgn0034247	1003	1000	927	79	11	7.181818181818182	924
FBgn0034249	1001	1000	979	23	4	5.75	978
FBgn0034253	1033	1000	977	89	11	8.090909090909092	944
FBgn0034258	1009	1000	1004	14	7	2	995
FBgn0034259	1053	1000	1051	55	6	9.166666666666666	998
FBgn0034261	1001	1000	978	24	3	8	977
FBgn0034262	908	874	901	41	6	6.833333333333333	867
FBgn0034263	1009	1000	988	30	8	3.75	979
FBgn0034265	1000	1000	998	2	1	2	998
FBgn0034270	1004	1000	979	29	2	14.5	975
FBgn0034271	1004	1000	978	30	3	10	974
FBgn0034274	1052	1000	1031	73	9	8.11111111111111	979
FBgn0034276	1037	1000	1003	71	6	11.833333333333334	966
FBgn0034281	1017	965	946	123	20	6.15	894
FBgn0034282	1004	1000	973	35	7	5	969
FBgn0034283	1038	1000	1032	44	5	8.8	994
FBgn0034286	1015	1000	993	37	8	4.625	978
FBgn0034288	1011	1000	976	46	8	5.75	965
FBgn0034292	1002	1000	993	11	4	2.75	991
FBgn0034295	1011	1000	1002	20	6	3.3333333333333335	991
FBgn0034296	869	849	826	63	7	9	806
FBgn0034299	1000	1000	998	2	2	1	998
FBgn0034300	1000	1000	999	1	1	1	999
FBgn0034301	1016	1000	991	41	11	3.727272727272727	975
FBgn0034304	1038	1000	1032	44	6	7.333333333333333	994
FBgn0034307	1000	1000	988	12	3	4	988
FBgn0034310	1001	1000	998	4	2	2	997
FBgn0034315	721	695	708	39	8	4.875	682
FBgn0034317	1009	1000	948	70	6	11.666666666666666	939
FBgn0034321	1016	1000	929	103	12	8.583333333333334	913
FBgn0034331	1047	1000	999	95	16	5.9375	952
FBgn0034335	1060	1000	1048	72	13	5.538461538461538	988
FBgn0034345	1009	1000	1007	11	6	1.8333333333333333	998
FBgn0034346	1006	973	999	40	5	8	966
FBgn0034351	1003	1000	861	145	4	36.25	858
FBgn0034352	1056	1000	1032	80	15	5.333333333333333	976
FBgn0034354	1006	1000	921	91	10	9.1	915
FBgn0034356	1013	1000	1005	21	7	3	992
FBgn0034360	1022	1000	841	203	7	29	819
FBgn0034361	1004	1000	975	33	5	6.6	971
FBgn0034362	850	850	847	3	1	3	847
FBgn0034364	1002	1000	983	21	4	5.25	981
FBgn0034365	1012	1000	982	42	5	8.4	970
FBgn0034366	1000	1000	939	61	3	20.333333333333332	939
FBgn0034368	786	776	738	58	8	7.25	728
FBgn0034379	1003	1000	979	27	7	3.857142857142857	976
FBgn0034380	1098	1000	1089	107	17	6.294117647058823	991
FBgn0034381	1001	1000	995	7	4	1.75	994
FBgn0034383	1001	1000	987	15	5	3	986
FBgn0034387	1001	1000	986	16	8	2	985
FBgn0034390	1038	1000	1008	68	10	6.8	970
FBgn0034391	1005	1000	912	98	4	24.5	907
FBgn0034392	830	800	816	44	9	4.888888888888889	786
FBgn0034396	1019	1000	1006	32	10	3.2	987
FBgn0034397	1003	1000	977	29	9	3.2222222222222223	974
FBgn0034398	1009	1000	554	464	6	77.33333333333333	545
FBgn0034401	1019	1000	1012	26	7	3.7142857142857144	993
FBgn0034402	1018	1000	1014	22	5	4.4	996
FBgn0034408	1004	1000	980	28	7	4	976
FBgn0034411	820	776	786	78	16	4.875	742
FBgn0034413	1014	1000	983	45	8	5.625	969
FBgn0034415	1010	1000	918	102	4	25.5	908
FBgn0034416	1042	1000	1022	62	9	6.888888888888889	980
FBgn0034417	1038	1000	1031	45	7	6.428571428571429	993
FBgn0034418	1015	1000	1001	29	6	4.833333333333333	986
FBgn0034419	1019	1000	1016	22	8	2.75	997
FBgn0034422	1000	1000	994	6	3	2	994
FBgn0034423	1024	1000	952	96	17	5.647058823529412	928
FBgn0034430	1029	1000	1021	37	11	3.3636363636363638	992
FBgn0034432	957	919	926	69	12	5.75	888
FBgn0034433	1004	1000	993	15	6	2.5	989
FBgn0034435	1024	1000	983	65	18	3.611111111111111	959
FBgn0034436	1002	1000	989	15	3	5	987
FBgn0034437	1006	1000	994	18	9	2	988
FBgn0034438	1031	1000	1018	44	8	5.5	987
FBgn0034439	1007	1000	974	40	10	4	967
FBgn0034442	885	874	399	497	8	62.125	388
FBgn0034443	1016	1000	996	36	11	3.272727272727273	980
FBgn0034447	1026	1000	623	429	12	35.75	597
FBgn0034452	1007	1000	989	25	5	5	982
FBgn0034456	1000	1000	975	25	3	8.333333333333334	975
FBgn0034458	1016	1000	1004	28	10	2.8	988
FBgn0034459	1042	1000	1027	57	13	4.384615384615385	985
FBgn0034460	1058	998	1050	68	6	11.333333333333334	990
FBgn0034462	1014	1000	1014	14	1	14	1000
FBgn0034464	1029	1000	894	164	6	27.333333333333332	865
FBgn0034467	1011	1000	990	32	8	4	979
FBgn0034470	1013	1000	937	89	7	12.714285714285714	924
FBgn0034471	1023	1000	1006	40	4	10	983
FBgn0034473	1011	1000	1004	18	8	2.25	993
FBgn0034474	1004	1000	948	60	5	12	944
FBgn0034475	1018	1000	1013	23	6	3.8333333333333335	995
FBgn0034476	1010	1000	978	42	6	7	968
FBgn0034477	1030	1000	951	109	11	9.909090909090908	921
FBgn0034478	1000	1000	975	25	2	12.5	975
FBgn0034479	1012	1000	1003	21	6	3.5	991
FBgn0034481	1002	1000	968	36	6	6	966
FBgn0034483	1018	1000	921	115	6	19.166666666666668	903
FBgn0034484	1005	1000	960	50	9	5.555555555555555	955
FBgn0034486	1016	1000	997	35	6	5.833333333333333	981
FBgn0034487	1015	1000	995	35	5	7	980
FBgn0034491	1000	1000	943	57	5	11.4	943
FBgn0034494	1002	1000	1002	2	1	2	1000
FBgn0034495	1001	1000	999	3	2	1.5	998
FBgn0034497	1011	1000	1004	18	4	4.5	993
FBgn0034498	1038	1000	1031	45	8	5.625	993
FBgn0034500	910	901	894	25	6	4.166666666666667	885
FBgn0034501	1020	1000	980	60	8	7.5	960
FBgn0034502	1004	1000	987	21	10	2.1	983
FBgn0034503	1053	1000	987	119	11	10.818181818181818	934
FBgn0034504	1051	1000	1008	94	9	10.444444444444445	957
FBgn0034506	1024	1000	1008	40	8	5	984
FBgn0034507	1049	1000	1033	65	11	5.909090909090909	984
FBgn0034509	1000	1000	980	20	4	5	980
FBgn0034510	1031	1000	1016	46	11	4.181818181818182	985
FBgn0034520	1021	1000	1002	40	9	4.444444444444445	981
FBgn0034523	1025	1000	1004	46	12	3.8333333333333335	979
FBgn0034527	1004	1000	909	99	6	16.5	905
FBgn0034528	1000	1000	994	6	2	3	994
FBgn0034529	1000	1000	999	1	1	1	999
FBgn0034530	693	684	678	24	2	12	669
FBgn0034532	1003	1000	992	14	2	7	989
FBgn0034534	1001	1000	1001	1	1	1	1000
FBgn0034537	1002	1000	807	197	5	39.4	805
FBgn0034538	761	757	716	49	8	6.125	712
FBgn0034539	1000	1000	978	22	4	5.5	978
FBgn0034541	1026	1000	1021	31	6	5.166666666666667	995
FBgn0034543	1013	1000	1006	20	3	6.666666666666667	993
FBgn0034546	1034	1000	1023	45	6	7.5	989
FBgn0034548	1037	1000	983	91	8	11.375	946
FBgn0034551	1008	1000	993	23	4	5.75	985
FBgn0034553	1030	1000	1029	31	6	5.166666666666667	999
FBgn0034554	1011	1000	990	32	7	4.571428571428571	979
FBgn0034558	811	802	794	26	5	5.2	785
FBgn0034560	1008	1000	1003	13	5	2.6	995
FBgn0034563	1004	1000	987	21	8	2.625	983
FBgn0034565	1023	1000	1018	28	6	4.666666666666667	995
FBgn0034566	1000	1000	993	7	3	2.3333333333333335	993
FBgn0034568	1005	1000	965	45	7	6.428571428571429	960
FBgn0034569	1020	1000	758	282	10	28.2	738
FBgn0034572	1001	1000	1001	1	1	1	1000
FBgn0034573	1022	1000	985	59	15	3.933333333333333	963
FBgn0034576	906	895	869	48	7	6.857142857142857	858
FBgn0034577	1003	1000	959	47	8	5.875	956
FBgn0034578	1007	1000	999	15	4	3.75	992
FBgn0034579	1002	1000	991	13	4	3.25	989
FBgn0034582	1038	1000	924	152	7	21.714285714285715	886
FBgn0034583	1015	1000	970	60	14	4.285714285714286	955
FBgn0034585	1023	1000	930	116	19	6.105263157894737	907
FBgn0034590	1023	1000	1021	25	4	6.25	998
FBgn0034592	1000	1000	965	35	4	8.75	965
FBgn0034595	1006	1000	981	31	8	3.875	975
FBgn0034598	1000	1000	830	170	3	56.666666666666664	830
FBgn0034601	1022	1000	1017	27	5	5.4	995
FBgn0034602	1022	1000	1012	32	7	4.571428571428571	990
FBgn0034605	1036	1000	986	86	14	6.142857142857143	950
FBgn0034606	1064	1000	1042	86	20	4.3	978
FBgn0034611	1001	1000	993	9	4	2.25	992
FBgn0034612	949	942	889	67	8	8.375	882
FBgn0034614	1001	1000	996	6	3	2	995
FBgn0034617	1017	1000	1007	27	7	3.857142857142857	990
FBgn0034618	1013	1000	1009	17	6	2.8333333333333335	996
FBgn0034622	845	844	813	33	7	4.714285714285714	812
FBgn0034623	1016	1000	1002	30	5	6	986
FBgn0034624	1029	1000	1013	45	7	6.428571428571429	984
FBgn0034627	1032	1000	1022	42	6	7	990
FBgn0034628	1001	1000	996	6	3	2	995
FBgn0034631	1005	1000	823	187	6	31.166666666666668	818
FBgn0034636	1030	1000	996	64	10	6.4	966
FBgn0034639	1015	1000	986	44	8	5.5	971
FBgn0034641	1004	1000	994	14	5	2.8	990
FBgn0034644	1025	1000	1018	32	7	4.571428571428571	993
FBgn0034645	1009	1000	991	27	7	3.857142857142857	982
FBgn0034646	1017	1000	987	47	8	5.875	970
FBgn0034647	1016	1000	958	74	10	7.4	942
FBgn0034650	1013	1000	1009	17	4	4.25	996
FBgn0034655	1004	1000	995	13	7	1.8571428571428572	991
FBgn0034657	1020	1000	1016	24	5	4.8	996
FBgn0034658	1000	1000	982	18	5	3.6	982
FBgn0034659	1051	1000	1048	54	7	7.714285714285714	997
FBgn0034660	1017	1000	1001	33	6	5.5	984
FBgn0034661	1012	1000	962	62	10	6.2	950
FBgn0034662	1013	1000	990	36	5	7.2	977
FBgn0034664	1001	1000	996	6	4	1.5	995
FBgn0034665	1013	1000	966	60	12	5	953
FBgn0034666	1005	1000	995	15	2	7.5	990
FBgn0034667	1005	1000	998	12	6	2	993
FBgn0034670	1016	1000	993	39	9	4.333333333333333	977
FBgn0034671	1032	1000	1015	49	8	6.125	983
FBgn0034674	1019	1000	1010	28	6	4.666666666666667	991
FBgn0034681	1010	1000	1001	19	7	2.7142857142857144	991
FBgn0034683	1023	1000	989	57	8	7.125	966
FBgn0034684	1012	1000	970	54	8	6.75	958
FBgn0034689	1039	1000	1017	61	13	4.6923076923076925	978
FBgn0034691	1013	1000	999	27	8	3.375	986
FBgn0034692	1000	1000	981	19	4	4.75	981
FBgn0034693	1013	1000	995	31	7	4.428571428571429	982
FBgn0034694	1026	1000	1009	43	11	3.909090909090909	983
FBgn0034697	1018	1000	995	41	8	5.125	977
FBgn0034704	1015	1000	999	31	7	4.428571428571429	984
FBgn0034705	1006	1000	975	37	4	9.25	969
FBgn0034709	1033	1000	1020	46	9	5.111111111111111	987
FBgn0034712	1020	1000	944	96	5	19.2	924
FBgn0034716	1002	1000	966	38	7	5.428571428571429	964
FBgn0034721	1025	1000	1015	35	9	3.888888888888889	990
FBgn0034722	1021	1000	1017	25	5	5	996
FBgn0034723	785	767	734	69	13	5.3076923076923075	716
FBgn0034724	841	835	834	13	4	3.25	828
FBgn0034725	1024	1000	981	67	7	9.571428571428571	957
FBgn0034727	1047	1000	1002	92	11	8.363636363636363	955
FBgn0034728	1047	1000	1002	92	11	8.363636363636363	955
FBgn0034729	1000	1000	992	8	3	2.6666666666666665	992
FBgn0034730	1000	1000	987	13	3	4.333333333333333	987
FBgn0034731	1012	1000	1004	20	6	3.3333333333333335	992
FBgn0034733	1037	1000	998	76	12	6.333333333333333	961
FBgn0034736	1011	1000	969	53	12	4.416666666666667	958
FBgn0034737	1010	1000	999	21	5	4.2	989
FBgn0034741	1001	1000	412	590	6	98.33333333333333	411
FBgn0034742	1003	1000	972	34	6	5.666666666666667	969
FBgn0034743	1000	1000	1000	0	0	NA	1000
FBgn0034745	1016	1000	1009	23	8	2.875	993
FBgn0034766	1000	1000	998	2	2	1	998
FBgn0034768	1029	1000	1002	56	11	5.090909090909091	973
FBgn0034769	1000	1000	999	1	1	1	999
FBgn0034770	1002	1000	998	6	4	1.5	996
FBgn0034774	1008	1000	986	30	6	5	978
FBgn0034776	1053	1000	1044	62	6	10.333333333333334	991
FBgn0034783	817	813	794	27	7	3.857142857142857	790
FBgn0034784	1040	1000	1035	45	9	5	995
FBgn0034786	1031	1000	999	63	8	7.875	968
FBgn0034788	1015	997	970	63	5	12.6	952
FBgn0034789	863	861	811	54	11	4.909090909090909	809
FBgn0034792	1002	1000	987	17	6	2.8333333333333335	985
FBgn0034793	1000	1000	984	16	4	4	984
FBgn0034795	1003	1000	1001	5	3	1.6666666666666667	998
FBgn0034800	1015	1000	1001	29	8	3.625	986
FBgn0034802	1005	1000	1000	10	5	2	995
FBgn0034803	1000	1000	993	7	1	7	993
FBgn0034804	1045	1000	969	121	21	5.761904761904762	924
FBgn0034807	1033	1000	1001	65	8	8.125	968
FBgn0034808	1000	1000	964	36	6	6	964
FBgn0034816	1003	1000	999	7	4	1.75	996
FBgn0034819	1024	1000	986	62	9	6.888888888888889	962
FBgn0034820	1016	1000	978	54	7	7.714285714285714	962
FBgn0034821	1008	1000	986	30	7	4.285714285714286	978
FBgn0034822	950	919	732	249	11	22.636363636363637	701
FBgn0034824	1021	1000	972	70	6	11.666666666666666	951
FBgn0034825	1007	1000	1001	13	3	4.333333333333333	994
FBgn0034826	1006	1000	994	18	6	3	988
FBgn0034827	1000	1000	923	77	4	19.25	923
FBgn0034828	1016	1000	974	58	13	4.461538461538462	958
FBgn0034829	722	722	717	5	2	2.5	717
FBgn0034833	1040	1000	971	109	14	7.785714285714286	931
FBgn0034834	1050	1000	1015	85	10	8.5	965
FBgn0034835	1008	1000	946	70	15	4.666666666666667	938
FBgn0034837	1031	1000	1013	49	6	8.166666666666666	982
FBgn0034839	1063	1000	1034	92	11	8.363636363636363	971
FBgn0034840	1000	1000	981	19	4	4.75	981
FBgn0034841	1017	1000	1007	27	5	5.4	990
FBgn0034842	1007	1000	930	84	9	9.333333333333334	923
FBgn0034844	1024	1000	1001	47	3	15.666666666666666	977
FBgn0034846	1000	1000	993	7	2	3.5	993
FBgn0034849	912	912	907	5	2	2.5	907
FBgn0034850	1012	1000	965	59	3	19.666666666666668	953
FBgn0034853	1014	1000	983	45	10	4.5	969
FBgn0034856	924	917	907	24	5	4.8	900
FBgn0034858	1012	1000	1005	19	6	3.1666666666666665	993
FBgn0034860	1034	1000	985	83	16	5.1875	951
FBgn0034861	1006	1000	990	22	4	5.5	984
FBgn0034863	1001	1000	975	27	5	5.4	974
FBgn0034866	1016	1000	946	86	12	7.166666666666667	930
FBgn0034869	1046	1000	1040	52	11	4.7272727272727275	994
FBgn0034870	1035	1000	994	76	9	8.444444444444445	959
FBgn0034871	1027	1000	1003	51	11	4.636363636363637	976
FBgn0034876	977	939	967	48	5	9.6	929
FBgn0034877	1001	1000	978	24	8	3	977
FBgn0034879	1059	1000	1002	116	16	7.25	943
FBgn0034880	1041	1000	1005	77	12	6.416666666666667	964
FBgn0034882	1008	1000	943	73	6	12.166666666666666	935
FBgn0034883	1029	1000	992	66	12	5.5	963
FBgn0034887	1002	1000	936	68	14	4.857142857142857	934
FBgn0034893	1003	1000	981	25	6	4.166666666666667	978
FBgn0034894	1000	1000	1000	0	0	NA	1000
FBgn0034903	1014	1000	936	92	10	9.2	922
FBgn0034907	1007	1000	995	19	5	3.8	988
FBgn0034908	1008	1000	976	40	7	5.714285714285714	968
FBgn0034909	1035	1000	985	85	8	10.625	950
FBgn0034910	1054	1000	1010	98	9	10.88888888888889	956
FBgn0034911	1009	1000	962	56	13	4.3076923076923075	953
FBgn0034913	1001	1000	932	70	3	23.333333333333332	931
FBgn0034914	1001	1000	978	24	2	12	977
FBgn0034919	1033	1000	1022	44	10	4.4	989
FBgn0034920	1016	1000	988	44	9	4.888888888888889	972
FBgn0034921	1023	1000	1011	35	8	4.375	988
FBgn0034923	1000	1000	995	5	2	2.5	995
FBgn0034924	1004	1000	1003	5	2	2.5	999
FBgn0034925	1022	1000	999	45	7	6.428571428571429	977
FBgn0034933	1019	1000	737	301	10	30.1	718
FBgn0034935	1003	1000	985	21	5	4.2	982
FBgn0034936	1030	1000	996	64	9	7.111111111111111	966
FBgn0034938	1000	1000	987	13	1	13	987
FBgn0034939	1003	1000	971	35	5	7	968
FBgn0034940	1019	1000	996	42	4	10.5	977
FBgn0034942	1004	1000	995	13	4	3.25	991
FBgn0034943	1012	1000	994	30	7	4.285714285714286	982
FBgn0034946	1025	1000	1007	43	7	6.142857142857143	982
FBgn0034948	1097	1000	1060	134	12	11.166666666666666	963
FBgn0034950	1012	1000	1011	13	4	3.25	999
FBgn0034956	1008	1000	980	36	6	6	972
FBgn0034957	1028	1000	1007	49	11	4.454545454545454	979
FBgn0034958	1000	1000	1000	0	0	NA	1000
FBgn0034959	1000	1000	997	3	2	1.5	997
FBgn0034961	1014	1000	968	60	14	4.285714285714286	954
FBgn0034962	1000	1000	1000	0	0	NA	1000
FBgn0034963	1004	1000	1004	4	2	2	1000
FBgn0034964	1013	1000	1012	14	6	2.3333333333333335	999
FBgn0034965	1023	1000	1019	27	4	6.75	996
FBgn0034966	1046	1000	1018	74	10	7.4	972
FBgn0034968	1008	1000	983	33	10	3.3	975
FBgn0034970	1006	1000	966	46	6	7.666666666666667	960
FBgn0034971	1003	1000	970	36	2	18	967
FBgn0034972	1004	1000	940	68	13	5.230769230769231	936
FBgn0034973	1000	1000	841	159	5	31.8	841
FBgn0034975	1008	1000	935	81	11	7.363636363636363	927
FBgn0034976	1010	1000	976	44	3	14.666666666666666	966
FBgn0034982	1002	1000	956	48	8	6	954
FBgn0034985	1006	1000	1000	12	5	2.4	994
FBgn0034986	1009	1000	999	19	3	6.333333333333333	990
FBgn0034990	1012	1000	986	38	6	6.333333333333333	974
FBgn0034994	1017	1000	1012	22	4	5.5	995
FBgn0034996	906	899	894	19	6	3.1666666666666665	887
FBgn0034997	870	852	854	34	9	3.7777777777777777	836
FBgn0034998	1027	1000	933	121	8	15.125	906
FBgn0034999	1056	1000	1043	69	6	11.5	987
FBgn0035000	1023	1000	982	64	6	10.666666666666666	959
FBgn0035001	1001	1000	989	13	3	4.333333333333333	988
FBgn0035004	1011	1000	955	67	6	11.166666666666666	944
FBgn0035005	1000	1000	986	14	3	4.666666666666667	986
FBgn0035006	1001	1000	977	25	5	5	976
FBgn0035010	1011	1000	993	29	9	3.2222222222222223	982
FBgn0035014	1017	1000	982	52	6	8.666666666666666	965
FBgn0035016	1003	1000	1002	4	2	2	999
FBgn0035019	1003	1000	1001	5	4	1.25	998
FBgn0035020	1001	1000	998	4	3	1.3333333333333333	997
FBgn0035021	1014	1000	991	37	5	7.4	977
FBgn0035022	1040	1000	1027	53	9	5.888888888888889	987
FBgn0035023	808	793	780	43	7	6.142857142857143	765
FBgn0035024	1001	1000	969	33	6	5.5	968
FBgn0035025	819	777	805	56	8	7	763
FBgn0035026	1000	1000	999	1	1	1	999
FBgn0035027	1000	1000	991	9	1	9	991
FBgn0035031	1004	1000	1001	7	3	2.3333333333333335	997
FBgn0035032	1001	1000	998	4	3	1.3333333333333333	997
FBgn0035033	856	855	845	12	3	4	844
FBgn0035034	859	859	816	43	4	10.75	816
FBgn0035036	1008	1000	998	18	6	3	990
FBgn0035039	1015	1000	989	41	11	3.727272727272727	974
FBgn0035040	1018	1000	990	46	8	5.75	972
FBgn0035041	1024	1000	993	55	6	9.166666666666666	969
FBgn0035042	1018	1000	984	52	6	8.666666666666666	966
FBgn0035043	1026	1000	1022	30	4	7.5	996
FBgn0035044	1008	1000	1000	16	3	5.333333333333333	992
FBgn0035046	1000	1000	994	6	2	3	994
FBgn0035047	1009	1000	1009	9	3	3	1000
FBgn0035049	1013	1000	1013	13	3	4.333333333333333	1000
FBgn0035050	1098	1000	1094	102	12	8.5	996
FBgn0035056	1012	1000	970	54	9	6	958
FBgn0035063	935	929	935	6	2	3	929
FBgn0035064	1005	1000	1005	5	2	2.5	1000
FBgn0035065	1003	1000	1003	3	2	1.5	1000
FBgn0035068	1016	1000	956	76	9	8.444444444444445	940
FBgn0035070	1032	1000	990	74	9	8.222222222222221	958
FBgn0035076	1021	1000	1018	24	6	4	997
FBgn0035078	1014	1000	1013	15	3	5	999
FBgn0035083	1006	1000	901	111	9	12.333333333333334	895
FBgn0035084	1000	1000	997	3	2	1.5	997
FBgn0035085	1028	1000	977	79	5	15.8	949
FBgn0035086	1001	1000	996	6	4	1.5	995
FBgn0035088	1000	1000	995	5	2	2.5	995
FBgn0035091	1019	1000	998	40	7	5.714285714285714	979
FBgn0035092	1019	1000	923	115	6	19.166666666666668	904
FBgn0035097	1111	1000	1030	192	25	7.68	919
FBgn0035101	1003	1000	992	14	7	2	989
FBgn0035103	1055	1000	1030	80	10	8	975
FBgn0035104	1068	1000	1045	91	10	9.1	977
FBgn0035106	1025	1000	1024	26	4	6.5	999
FBgn0035107	1025	1000	1022	28	4	7	997
FBgn0035109	909	891	891	36	8	4.5	873
FBgn0035110	1003	1000	1003	3	1	3	1000
FBgn0035111	1003	1000	1002	4	2	2	999
FBgn0035113	1044	1000	989	99	17	5.823529411764706	945
FBgn0035120	1035	1000	1035	35	5	7	1000
FBgn0035121	1011	1000	971	51	10	5.1	960
FBgn0035122	1013	1000	979	47	11	4.2727272727272725	966
FBgn0035131	1008	1000	987	29	6	4.833333333333333	979
FBgn0035134	914	894	912	22	6	3.6666666666666665	892
FBgn0035137	1001	1000	996	6	4	1.5	995
FBgn0035138	1045	1000	1039	51	5	10.2	994
FBgn0035139	1011	1000	995	27	10	2.7	984
FBgn0035140	1007	1000	967	47	10	4.7	960
FBgn0035141	1013	1000	974	52	13	4	961
FBgn0035142	1010	997	992	31	7	4.428571428571429	979
FBgn0035143	1005	1000	994	16	11	1.4545454545454546	989
FBgn0035144	1006	1000	985	27	10	2.7	979
FBgn0035145	1032	1000	995	69	9	7.666666666666667	963
FBgn0035146	1039	1000	1027	51	10	5.1	988
FBgn0035147	1041	1000	1026	56	12	4.666666666666667	985
FBgn0035149	1017	1000	971	63	7	9	954
FBgn0035150	1017	1000	971	63	9	7	954
FBgn0035157	1031	1000	998	64	12	5.333333333333333	967
FBgn0035159	1073	1000	1066	80	8	10	993
FBgn0035160	1015	1000	981	49	9	5.444444444444445	966
FBgn0035161	1035	1000	1027	43	8	5.375	992
FBgn0035162	1005	1000	975	35	12	2.9166666666666665	970
FBgn0035164	1003	1000	950	56	4	14	947
FBgn0035165	1005	1000	991	19	5	3.8	986
FBgn0035166	1063	1000	1055	71	10	7.1	992
FBgn0035167	1031	1000	1023	39	3	13	992
FBgn0035173	1007	1000	970	44	5	8.8	963
FBgn0035181	1002	1000	957	47	9	5.222222222222222	955
FBgn0035186	1080	1000	1040	120	16	7.5	960
FBgn0035187	1015	1000	978	52	5	10.4	963
FBgn0035189	1011	1000	997	25	5	5	986
FBgn0035193	1005	1000	994	16	6	2.6666666666666665	989
FBgn0035194	1001	1000	1000	2	2	1	999
FBgn0035199	997	961	936	97	12	8.083333333333334	900
FBgn0035204	1002	1000	910	94	4	23.5	908
FBgn0035205	1000	1000	990	10	1	10	990
FBgn0035206	1067	1000	1052	82	5	16.4	985
FBgn0035207	1050	1000	1027	73	7	10.428571428571429	977
FBgn0035211	1009	1000	987	31	9	3.4444444444444446	978
FBgn0035216	1038	1000	987	89	12	7.416666666666667	949
FBgn0035217	1029	1000	982	76	15	5.066666666666666	953
FBgn0035228	1027	1000	989	65	10	6.5	962
FBgn0035231	867	866	851	17	6	2.8333333333333335	850
FBgn0035232	1006	1000	996	16	5	3.2	990
FBgn0035233	1000	1000	999	1	1	1	999
FBgn0035234	1063	1000	992	134	15	8.933333333333334	929
FBgn0035235	1023	1000	996	50	11	4.545454545454546	973
FBgn0035236	1023	1000	988	58	13	4.461538461538462	965
FBgn0035237	1009	1000	978	40	9	4.444444444444445	969
FBgn0035238	1014	1000	1006	22	2	11	992
FBgn0035241	1027	1000	987	67	9	7.444444444444445	960
FBgn0035243	1011	1000	1001	21	7	3	990
FBgn0035245	1001	1000	981	21	5	4.2	980
FBgn0035247	1039	1000	1000	78	9	8.666666666666666	961
FBgn0035248	1000	1000	1000	0	0	NA	1000
FBgn0035249	1001	1000	994	8	4	2	993
FBgn0035251	1000	1000	1000	0	0	NA	1000
FBgn0035252	1000	1000	1000	0	0	NA	1000
FBgn0035253	1010	1000	1006	14	3	4.666666666666667	996
FBgn0035254	1000	1000	1000	0	0	NA	1000
FBgn0035256	1061	1000	1026	96	11	8.727272727272727	965
FBgn0035258	1011	1000	965	57	8	7.125	954
FBgn0035260	1012	1000	945	79	19	4.157894736842105	933
FBgn0035263	1000	1000	983	17	4	4.25	983
FBgn0035265	1008	1000	975	41	8	5.125	967
FBgn0035266	1008	1000	992	24	5	4.8	984
FBgn0035267	1025	1000	985	65	13	5	960
FBgn0035268	1012	1000	1001	23	3	7.666666666666667	989
FBgn0035270	1019	1000	973	65	8	8.125	954
FBgn0035271	1006	1000	1000	12	3	4	994
FBgn0035279	1032	1000	980	84	14	6	948
FBgn0035280	1000	1000	939	61	4	15.25	939
FBgn0035281	1025	1000	1007	43	8	5.375	982
FBgn0035282	1025	1000	1021	29	6	4.833333333333333	996
FBgn0035283	1032	1000	1010	54	10	5.4	978
FBgn0035285	1004	1000	987	21	3	7	983
FBgn0035286	1079	1000	1071	87	8	10.875	992
FBgn0035287	1038	991	1029	56	7	8	982
FBgn0035290	1051	1000	1042	60	7	8.571428571428571	991
FBgn0035294	1025	1000	1011	39	5	7.8	986
FBgn0035295	1000	1000	996	4	1	4	996
FBgn0035299	1014	1000	999	29	6	4.833333333333333	985
FBgn0035300	1014	1000	980	48	7	6.857142857142857	966
FBgn0035308	1013	1000	994	32	11	2.909090909090909	981
FBgn0035312	1090	1000	1031	149	16	9.3125	941
FBgn0035313	1001	1000	972	30	7	4.285714285714286	971
FBgn0035315	1000	1000	966	34	5	6.8	966
FBgn0035316	1047	1000	1017	77	10	7.7	970
FBgn0035317	1012	1000	983	41	7	5.857142857142857	971
FBgn0035318	1017	1000	1013	21	4	5.25	996
FBgn0035321	1001	1000	1001	1	1	1	1000
FBgn0035323	1002	1000	982	22	7	3.142857142857143	980
FBgn0035325	1035	1000	1004	66	6	11	969
FBgn0035328	1003	1000	977	29	5	5.8	974
FBgn0035331	1003	1000	992	14	3	4.666666666666667	989
FBgn0035332	1039	1000	1021	57	6	9.5	982
FBgn0035333	985	969	956	45	7	6.428571428571429	940
FBgn0035334	1016	1000	987	45	5	9	971
FBgn0035335	1000	1000	1000	0	0	NA	1000
FBgn0035336	969	955	961	22	4	5.5	947
FBgn0035337	1010	1000	1008	12	5	2.4	998
FBgn0035343	789	788	767	23	4	5.75	766
FBgn0035344	1021	1000	965	77	8	9.625	944
FBgn0035348	1008	1000	991	25	4	6.25	983
FBgn0035355	1017	1000	1017	17	3	5.666666666666667	1000
FBgn0035358	1000	1000	969	31	6	5.166666666666667	969
FBgn0035359	1022	1000	1005	39	7	5.571428571428571	983
FBgn0035360	1074	1000	1066	82	8	10.25	992
FBgn0035370	1018	1000	995	41	11	3.727272727272727	977
FBgn0035372	1048	1000	1046	50	6	8.333333333333334	998
FBgn0035379	1008	1000	984	32	8	4	976
FBgn0035380	1000	1000	927	73	4	18.25	927
FBgn0035382	1012	1000	1011	13	3	4.333333333333333	999
FBgn0035383	1046	1000	1036	56	8	7	990
FBgn0035384	1006	1000	931	81	7	11.571428571428571	925
FBgn0035385	1021	1000	1019	23	5	4.6	998
FBgn0035390	1031	1000	1022	40	4	10	991
FBgn0035397	1000	1000	972	28	5	5.6	972
FBgn0035398	1046	1000	1032	60	10	6	986
FBgn0035400	1012	1000	1012	12	3	4	1000
FBgn0035401	1012	1000	995	29	6	4.833333333333333	983
FBgn0035402	1002	1000	999	5	4	1.25	997
FBgn0035407	1013	1000	839	187	6	31.166666666666668	826
FBgn0035410	1019	1000	1011	27	8	3.375	992
FBgn0035415	714	689	693	46	5	9.2	668
FBgn0035420	1000	1000	997	3	2	1.5	997
FBgn0035421	1000	1000	998	2	2	1	998
FBgn0035422	1027	1000	1019	35	8	4.375	992
FBgn0035425	1015	1000	992	38	13	2.923076923076923	977
FBgn0035426	1032	1000	1008	56	12	4.666666666666667	976
FBgn0035427	1014	1000	998	30	7	4.285714285714286	984
FBgn0035428	1028	1000	996	60	10	6	968
FBgn0035429	1023	1000	1010	36	6	6	987
FBgn0035430	1010	1000	1005	15	7	2.142857142857143	995
FBgn0035432	1019	1000	671	367	5	73.4	652
FBgn0035434	959	928	584	406	7	58	553
FBgn0035435	1010	1000	997	23	5	4.6	987
FBgn0035438	1048	1000	1048	48	9	5.333333333333333	1000
FBgn0035443	1000	1000	992	8	2	4	992
FBgn0035445	978	967	958	31	9	3.4444444444444446	947
FBgn0035452	1028	1000	1017	39	13	3	989
FBgn0035455	1029	1000	994	64	11	5.818181818181818	965
FBgn0035462	1024	1000	957	91	8	11.375	933
FBgn0035464	1006	1000	998	14	3	4.666666666666667	992
FBgn0035468	870	855	868	17	3	5.666666666666667	853
FBgn0035469	1001	1000	980	22	3	7.333333333333333	979
FBgn0035471	1001	1000	991	11	6	1.8333333333333333	990
FBgn0035473	1000	1000	984	16	5	3.2	984
FBgn0035475	731	702	727	33	6	5.5	698
FBgn0035476	1002	987	971	46	9	5.111111111111111	956
FBgn0035478	1008	1000	990	26	10	2.6	982
FBgn0035479	1023	1000	926	120	11	10.909090909090908	903
FBgn0035480	1024	1000	971	77	14	5.5	947
FBgn0035481	1002	1000	998	6	3	2	996
FBgn0035484	1037	1000	993	81	10	8.1	956
FBgn0035488	1004	1000	1004	4	1	4	1000
FBgn0035490	1034	1000	1023	45	9	5	989
FBgn0035491	1011	1000	977	45	10	4.5	966
FBgn0035495	1022	1000	999	45	9	5	977
FBgn0035496	1010	1000	963	57	14	4.071428571428571	953
FBgn0035497	1005	1000	977	33	10	3.3	972
FBgn0035499	1018	1000	976	60	9	6.666666666666667	958
FBgn0035504	1008	1000	1006	10	3	3.3333333333333335	998
FBgn0035505	1056	1000	1043	69	11	6.2727272727272725	987
FBgn0035508	1015	1000	975	55	5	11	960
FBgn0035510	1027	1000	1018	36	10	3.6	991
FBgn0035511	704	704	682	22	3	7.333333333333333	682
FBgn0035512	1000	1000	966	34	4	8.5	966
FBgn0035515	1030	1000	962	98	9	10.88888888888889	932
FBgn0035517	1010	1000	951	69	9	7.666666666666667	941
FBgn0035518	1006	1000	998	14	4	3.5	992
FBgn0035519	1003	1000	995	11	3	3.6666666666666665	992
FBgn0035520	1001	1000	967	35	11	3.1818181818181817	966
FBgn0035521	1000	1000	980	20	4	5	980
FBgn0035526	1050	1000	928	172	13	13.23076923076923	878
FBgn0035528	1002	1000	1000	4	3	1.3333333333333333	998
FBgn0035529	1002	1000	1000	4	3	1.3333333333333333	998
FBgn0035532	1030	1000	1012	48	7	6.857142857142857	982
FBgn0035533	1002	1000	993	11	4	2.75	991
FBgn0035534	1003	1000	993	13	5	2.6	990
FBgn0035537	1006	1000	999	13	5	2.6	993
FBgn0035539	1059	1000	994	124	15	8.266666666666667	935
FBgn0035541	1078	1000	1057	99	12	8.25	979
FBgn0035542	1078	1000	1061	95	11	8.636363636363637	983
FBgn0035543	1008	1000	989	27	6	4.5	981
FBgn0035544	1000	1000	990	10	2	5	990
FBgn0035546	1020	1000	1003	37	6	6.166666666666667	983
FBgn0035548	1028	1000	1023	33	5	6.6	995
FBgn0035551	1007	1000	938	76	7	10.857142857142858	931
FBgn0035552	1015	1000	993	37	6	6.166666666666667	978
FBgn0035553	1003	1000	954	52	7	7.428571428571429	951
FBgn0035554	1017	1000	999	35	9	3.888888888888889	982
FBgn0035555	1012	1000	848	176	5	35.2	836
FBgn0035557	1056	1000	1023	89	11	8.090909090909092	967
FBgn0035558	1044	1000	999	89	16	5.5625	955
FBgn0035568	1016	1000	925	107	12	8.916666666666666	909
FBgn0035569	1054	1000	1021	87	11	7.909090909090909	967
FBgn0035570	1012	1000	975	49	9	5.444444444444445	963
FBgn0035571	1018	1000	1002	34	8	4.25	984
FBgn0035574	1059	1000	970	148	20	7.4	911
FBgn0035575	963	896	945	85	8	10.625	878
FBgn0035577	1000	1000	885	115	4	28.75	885
FBgn0035582	1012	1000	1009	15	4	3.75	997
FBgn0035586	1001	1000	1000	2	2	1	999
FBgn0035587	1006	1000	1006	6	2	3	1000
FBgn0035588	875	873	859	18	4	4.5	857
FBgn0035589	980	979	970	11	4	2.75	969
FBgn0035590	1001	1000	993	9	4	2.25	992
FBgn0035592	1000	1000	995	5	2	2.5	995
FBgn0035593	1013	1000	1010	16	8	2	997
FBgn0035594	1001	1000	970	32	6	5.333333333333333	969
FBgn0035598	1012	1000	943	81	10	8.1	931
FBgn0035600	1034	1000	988	80	19	4.2105263157894735	954
FBgn0035601	1002	1000	991	13	5	2.6	989
FBgn0035604	1047	1000	1036	58	8	7.25	989
FBgn0035607	1000	1000	999	1	1	1	999
FBgn0035610	1034	1000	989	79	11	7.181818181818182	955
FBgn0035611	1003	1000	1003	3	1	3	1000
FBgn0035612	1005	1000	995	15	6	2.5	990
FBgn0035617	1014	1000	983	45	11	4.090909090909091	969
FBgn0035619	1000	1000	1000	0	0	NA	1000
FBgn0035620	1042	1000	1010	74	7	10.571428571428571	968
FBgn0035621	1015	1000	945	85	8	10.625	930
FBgn0035624	1052	1000	1040	64	10	6.4	988
FBgn0035626	1081	1000	1065	97	10	9.7	984
FBgn0035627	1004	1000	997	11	6	1.8333333333333333	993
FBgn0035630	1001	1000	979	23	3	7.666666666666667	978
FBgn0035631	1014	1000	1014	14	5	2.8	1000
FBgn0035632	1014	1000	1013	15	4	3.75	999
FBgn0035636	1031	1000	1003	59	11	5.363636363636363	972
FBgn0035638	1038	1000	965	111	12	9.25	927
FBgn0035639	1000	1000	983	17	4	4.25	983
FBgn0035641	1005	1000	985	25	8	3.125	980
FBgn0035643	1038	1000	1018	58	10	5.8	980
FBgn0035644	1001	1000	994	8	4	2	993
FBgn0035645	1013	1000	1002	24	6	4	989
FBgn0035647	1037	1000	1024	50	7	7.142857142857143	987
FBgn0035648	1029	1000	1011	47	8	5.875	982
FBgn0035649	1061	1000	1042	80	13	6.153846153846154	981
FBgn0035656	1024	1000	996	52	8	6.5	972
FBgn0035657	1012	1000	977	47	7	6.714285714285714	965
FBgn0035665	1001	1000	997	5	4	1.25	996
FBgn0035670	1020	1000	1014	26	6	4.333333333333333	994
FBgn0035673	785	767	765	38	6	6.333333333333333	747
FBgn0035674	1022	1000	991	53	12	4.416666666666667	969
FBgn0035675	1019	1000	1006	32	4	8	987
FBgn0035677	1020	1000	1014	26	4	6.5	994
FBgn0035685	752	742	706	56	6	9.333333333333334	696
FBgn0035686	1020	1000	979	61	13	4.6923076923076925	959
FBgn0035687	1016	1000	996	36	8	4.5	980
FBgn0035688	1034	1000	1024	44	10	4.4	990
FBgn0035689	1033	1000	1023	43	10	4.3	990
FBgn0035691	1016	1000	992	40	10	4	976
FBgn0035692	1063	1000	1033	93	10	9.3	970
FBgn0035693	1003	1000	993	13	7	1.8571428571428572	990
FBgn0035696	860	840	816	64	12	5.333333333333333	796
FBgn0035697	991	985	990	7	3	2.3333333333333335	984
FBgn0035699	1006	1000	998	14	3	4.666666666666667	992
FBgn0035702	1026	1000	1023	29	5	5.8	997
FBgn0035703	1026	1000	1026	26	3	8.666666666666666	1000
FBgn0035704	1003	1000	990	16	6	2.6666666666666665	987
FBgn0035708	926	906	887	59	13	4.538461538461538	867
FBgn0035710	1001	1000	936	66	6	11	935
FBgn0035711	1001	1000	936	66	6	11	935
FBgn0035713	1004	1000	1000	8	3	2.6666666666666665	996
FBgn0035714	1004	1000	993	15	5	3	989
FBgn0035718	1021	1000	935	107	9	11.88888888888889	914
FBgn0035720	1003	1000	1003	3	1	3	1000
FBgn0035721	1006	1000	977	35	10	3.5	971
FBgn0035722	1002	1000	995	9	5	1.8	993
FBgn0035725	1022	1000	1003	41	12	3.4166666666666665	981
FBgn0035726	1022	1000	1002	42	12	3.5	980
FBgn0035727	877	875	854	25	6	4.166666666666667	852
FBgn0035730	1010	1000	820	200	11	18.181818181818183	810
FBgn0035733	1000	1000	977	23	5	4.6	977
FBgn0035734	1045	1000	1021	69	9	7.666666666666667	976
FBgn0035736	1008	1000	995	21	8	2.625	987
FBgn0035737	1002	1000	995	9	7	1.2857142857142858	993
FBgn0035741	1015	1000	1003	27	6	4.5	988
FBgn0035742	1036	1000	1019	53	4	13.25	983
FBgn0035743	1036	1000	1031	41	3	13.666666666666666	995
FBgn0035750	1011	1000	1003	19	5	3.8	992
FBgn0035751	1030	1000	1017	43	4	10.75	987
FBgn0035753	1023	1000	1001	45	5	9	978
FBgn0035755	1060	1000	985	135	19	7.105263157894737	925
FBgn0035756	1028	1000	973	83	7	11.857142857142858	945
FBgn0035761	1002	1000	984	20	3	6.666666666666667	982
FBgn0035762	1002	1000	984	20	3	6.666666666666667	982
FBgn0035763	1000	1000	994	6	3	2	994
FBgn0035766	1026	1000	1005	47	11	4.2727272727272725	979
FBgn0035770	1023	1000	991	55	8	6.875	968
FBgn0035771	1000	1000	977	23	2	11.5	977
FBgn0035776	1000	1000	882	118	9	13.11111111111111	882
FBgn0035777	1027	1000	1023	31	11	2.8181818181818183	996
FBgn0035781	1048	1000	988	108	12	9	940
FBgn0035782	1019	1000	962	76	10	7.6	943
FBgn0035785	1046	1000	1026	66	7	9.428571428571429	980
FBgn0035787	1006	1000	999	13	8	1.625	993
FBgn0035788	1036	1000	1035	37	8	4.625	999
FBgn0035789	1017	1000	762	272	8	34	745
FBgn0035790	1044	1000	1012	76	9	8.444444444444445	968
FBgn0035792	1000	1000	1000	0	0	NA	1000
FBgn0035793	1001	1000	952	50	7	7.142857142857143	951
FBgn0035798	1033	1000	994	72	8	9	961
FBgn0035800	1035	1000	983	87	15	5.8	948
FBgn0035805	1056	1000	961	151	14	10.785714285714286	905
FBgn0035807	1030	1000	989	71	12	5.916666666666667	959
FBgn0035812	1000	1000	366	634	1	634	366
FBgn0035813	1002	1000	984	20	6	3.3333333333333335	982
FBgn0035815	1010	1000	955	65	12	5.416666666666667	945
FBgn0035824	1054	1000	1022	86	9	9.555555555555555	968
FBgn0035827	1014	1000	1003	25	10	2.5	989
FBgn0035829	1005	1000	973	37	9	4.111111111111111	968
FBgn0035830	1031	1000	981	81	14	5.785714285714286	950
FBgn0035831	1003	1000	922	84	8	10.5	919
FBgn0035833	1011	1000	963	59	9	6.555555555555555	952
FBgn0035838	817	815	801	18	5	3.6	799
FBgn0035842	1004	1000	994	14	4	3.5	990
FBgn0035844	1048	1000	993	103	12	8.583333333333334	945
FBgn0035847	1019	1000	1007	31	5	6.2	988
FBgn0035848	1019	1000	1007	31	5	6.2	988
FBgn0035849	1000	1000	974	26	7	3.7142857142857144	974
FBgn0035850	1006	1000	1000	12	2	6	994
FBgn0035851	1020	1000	1013	27	7	3.857142857142857	993
FBgn0035852	1000	1000	1000	0	0	NA	1000
FBgn0035853	1014	1000	1007	21	6	3.5	993
FBgn0035854	1035	1000	1030	40	8	5	995
FBgn0035856	1056	1000	1052	60	4	15	996
FBgn0035857	1001	1000	980	22	3	7.333333333333333	979
FBgn0035858	1041	1000	1008	74	13	5.6923076923076925	967
FBgn0035859	1011	1000	961	61	9	6.777777777777778	950
FBgn0035861	1013	1000	973	53	5	10.6	960
FBgn0035865	1000	1000	989	11	1	11	989
FBgn0035866	1018	1000	1017	19	4	4.75	999
FBgn0035867	1020	1000	1011	29	8	3.625	991
FBgn0035868	1029	1000	1018	40	3	13.333333333333334	989
FBgn0035872	1035	1000	998	72	13	5.538461538461538	963
FBgn0035873	1040	1000	1002	78	9	8.666666666666666	962
FBgn0035875	1039	1000	965	113	12	9.416666666666666	926
FBgn0035876	910	902	878	40	5	8	870
FBgn0035878	1001	1000	920	82	5	16.4	919
FBgn0035879	1013	1000	963	63	7	9	950
FBgn0035886	1038	1000	1016	60	13	4.615384615384615	978
FBgn0035887	1011	1000	915	107	10	10.7	904
FBgn0035888	1027	1000	597	457	11	41.54545454545455	570
FBgn0035896	1017	1000	995	39	9	4.333333333333333	978
FBgn0035900	1003	1000	999	7	5	1.4	996
FBgn0035901	1005	1000	992	18	5	3.6	987
FBgn0035902	1004	1000	993	15	3	5	989
FBgn0035904	1014	1000	981	47	9	5.222222222222222	967
FBgn0035907	1102	1000	1066	138	17	8.117647058823529	964
FBgn0035909	1016	1000	958	74	8	9.25	942
FBgn0035911	1042	1000	1026	58	10	5.8	984
FBgn0035914	1012	1000	1006	18	5	3.6	994
FBgn0035915	1005	1000	982	28	7	4	977
FBgn0035916	1052	1000	1029	75	10	7.5	977
FBgn0035917	1052	1000	1034	70	9	7.777777777777778	982
FBgn0035918	1011	1000	974	48	5	9.6	963
FBgn0035921	671	668	664	10	5	2	661
FBgn0035922	1002	1000	993	11	5	2.2	991
FBgn0035923	1004	1000	939	69	5	13.8	935
FBgn0035926	1010	1000	1004	16	7	2.2857142857142856	994
FBgn0035928	1000	1000	849	151	6	25.166666666666668	849
FBgn0035929	1002	1000	1001	3	2	1.5	999
FBgn0035931	1000	1000	996	4	1	4	996
FBgn0035934	1027	994	991	69	11	6.2727272727272725	958
FBgn0035943	1007	1000	1004	10	4	2.5	997
FBgn0035944	1007	1000	1003	11	5	2.2	996
FBgn0035948	1013	1000	977	49	10	4.9	964
FBgn0035949	1006	1000	979	33	8	4.125	973
FBgn0035951	1020	1000	1000	40	7	5.714285714285714	980
FBgn0035952	1005	1000	1003	7	4	1.75	998
FBgn0035953	1002	1000	996	8	3	2.6666666666666665	994
FBgn0035954	1042	1000	1003	81	12	6.75	961
FBgn0035955	1071	1000	951	191	9	21.22222222222222	880
FBgn0035956	1011	1000	1001	21	4	5.25	990
FBgn0035957	1000	1000	960	40	7	5.714285714285714	960
FBgn0035959	1043	1000	1043	43	2	21.5	1000
FBgn0035960	1044	1000	1043	45	4	11.25	999
FBgn0035965	1068	1000	1037	99	15	6.6	969
FBgn0035968	1047	1000	1044	50	8	6.25	997
FBgn0035969	1017	1000	995	39	9	4.333333333333333	978
FBgn0035970	1024	1000	1000	48	12	4	976
FBgn0035971	1040	1000	1034	46	10	4.6	994
FBgn0035975	1020	1000	971	69	9	7.666666666666667	951
FBgn0035976	1020	1000	989	51	13	3.923076923076923	969
FBgn0035977	1002	1000	526	478	5	95.6	524
FBgn0035978	1024	1000	1016	32	7	4.571428571428571	992
FBgn0035980	1000	1000	972	28	6	4.666666666666667	972
FBgn0035981	1000	1000	996	4	1	4	996
FBgn0035982	1025	1000	992	58	11	5.2727272727272725	967
FBgn0035985	1019	1000	984	54	10	5.4	965
FBgn0035986	1001	1000	1001	1	1	1	1000
FBgn0035987	1001	1000	995	7	2	3.5	994
FBgn0035989	1003	1000	984	22	3	7.333333333333333	981
FBgn0035996	1012	1000	976	48	5	9.6	964
FBgn0035998	1005	1000	998	12	6	2	993
FBgn0035999	1000	1000	1000	0	0	NA	1000
FBgn0036000	1027	1000	950	104	9	11.555555555555555	923
FBgn0036004	1000	1000	1000	0	0	NA	1000
FBgn0036010	1002	1000	982	22	6	3.6666666666666665	980
FBgn0036015	1005	1000	1003	7	3	2.3333333333333335	998
FBgn0036018	875	846	843	61	10	6.1	814
FBgn0036020	1010	1000	1006	14	2	7	996
FBgn0036022	1016	1000	1016	16	2	8	1000
FBgn0036024	927	917	714	223	7	31.857142857142858	704
FBgn0036028	1006	1000	981	31	8	3.875	975
FBgn0036035	1013	1000	1012	14	3	4.666666666666667	999
FBgn0036036	1013	1000	1008	18	5	3.6	995
FBgn0036038	1013	1000	968	58	7	8.285714285714286	955
FBgn0036040	1006	1000	974	38	12	3.1666666666666665	968
FBgn0036043	1013	1000	989	37	12	3.0833333333333335	976
FBgn0036044	1032	1000	1002	62	11	5.636363636363637	970
FBgn0036052	855	815	848	47	8	5.875	808
FBgn0036053	1015	1000	927	103	6	17.166666666666668	912
FBgn0036058	1002	1000	994	10	4	2.5	992
FBgn0036062	1001	1000	873	129	4	32.25	872
FBgn0036063	1001	1000	980	22	5	4.4	979
FBgn0036066	893	855	884	47	8	5.875	846
FBgn0036070	1016	1000	976	56	6	9.333333333333334	960
FBgn0036075	1021	1000	954	88	9	9.777777777777779	933
FBgn0036078	1023	1000	1023	23	5	4.6	1000
FBgn0036080	1008	1000	996	20	6	3.3333333333333335	988
FBgn0036082	1016	1000	978	54	10	5.4	962
FBgn0036085	1010	1000	874	146	11	13.272727272727273	864
FBgn0036089	776	733	766	53	10	5.3	723
FBgn0036090	1019	1000	979	59	8	7.375	960
FBgn0036093	1000	1000	966	34	7	4.857142857142857	966
FBgn0036096	1098	1000	1057	139	21	6.619047619047619	959
FBgn0036099	1058	1000	988	128	13	9.846153846153847	930
FBgn0036101	1047	1000	963	131	17	7.705882352941177	916
FBgn0036102	1007	1000	982	32	10	3.2	975
FBgn0036104	1000	1000	976	24	3	8	976
FBgn0036105	1000	1000	987	13	2	6.5	987
FBgn0036106	1011	1000	1003	19	7	2.7142857142857144	992
FBgn0036107	1016	1000	989	43	10	4.3	973
FBgn0036108	1035	1000	1006	64	13	4.923076923076923	971
FBgn0036110	1017	1000	934	100	8	12.5	917
FBgn0036111	1093	1000	1053	133	15	8.866666666666667	960
FBgn0036112	1008	1000	979	37	11	3.3636363636363638	971
FBgn0036116	1013	1000	955	71	16	4.4375	942
FBgn0036117	971	948	967	27	6	4.5	944
FBgn0036118	1027	1000	1023	31	7	4.428571428571429	996
FBgn0036121	1115	1000	1068	162	25	6.48	953
FBgn0036126	1006	1000	999	13	3	4.333333333333333	993
FBgn0036133	1035	1000	1005	65	12	5.416666666666667	970
FBgn0036134	1014	1000	999	29	6	4.833333333333333	985
FBgn0036135	1000	1000	994	6	4	1.5	994
FBgn0036136	1015	1000	985	45	13	3.4615384615384617	970
FBgn0036138	987	986	944	44	11	4	943
FBgn0036139	1008	1000	794	222	13	17.076923076923077	786
FBgn0036141	1011	1000	995	27	6	4.5	984
FBgn0036142	1002	1000	1002	2	1	2	1000
FBgn0036143	1002	1000	956	48	5	9.6	954
FBgn0036144	899	889	861	48	9	5.333333333333333	851
FBgn0036145	1010	1000	990	30	6	5	980
FBgn0036146	902	870	890	44	10	4.4	858
FBgn0036147	816	780	776	76	12	6.333333333333333	740
FBgn0036152	1032	1000	1001	63	10	6.3	969
FBgn0036153	1051	1000	1016	86	13	6.615384615384615	965
FBgn0036154	1037	1000	965	109	17	6.411764705882353	928
FBgn0036155	1010	1000	1008	12	3	4	998
FBgn0036156	1007	1000	975	39	10	3.9	968
FBgn0036157	1069	1000	1036	102	10	10.2	967
FBgn0036158	1021	1000	969	73	12	6.083333333333333	948
FBgn0036159	1036	1000	908	164	15	10.933333333333334	872
FBgn0036160	1000	1000	998	2	2	1	998
FBgn0036161	1004	1000	1002	6	3	2	998
FBgn0036162	1012	1000	995	29	10	2.9	983
FBgn0036165	1021	1000	973	69	16	4.3125	952
FBgn0036173	1038	1000	1031	45	14	3.2142857142857144	993
FBgn0036176	1024	1000	924	124	11	11.272727272727273	900
FBgn0036177	1035	1000	1013	57	9	6.333333333333333	978
FBgn0036179	1009	1000	999	19	4	4.75	990
FBgn0036180	1036	1000	1007	65	14	4.642857142857143	971
FBgn0036187	1001	1000	973	29	5	5.8	972
FBgn0036188	1004	1000	973	35	7	5	969
FBgn0036192	1000	1000	988	12	5	2.4	988
FBgn0036193	1023	1000	985	61	12	5.083333333333333	962
FBgn0036195	1000	1000	958	42	7	6	958
FBgn0036196	1025	1000	999	51	10	5.1	974
FBgn0036198	1009	1000	976	42	9	4.666666666666667	967
FBgn0036199	1020	1000	1014	26	6	4.333333333333333	994
FBgn0036202	1005	1000	932	78	6	13	927
FBgn0036203	1048	1000	996	100	10	10	948
FBgn0036204	1033	1000	962	104	9	11.555555555555555	929
FBgn0036205	1029	1000	1027	31	4	7.75	998
FBgn0036206	1034	1000	1000	68	8	8.5	966
FBgn0036207	1023	1000	997	49	9	5.444444444444445	974
FBgn0036214	1008	1000	957	59	8	7.375	949
FBgn0036218	1011	1000	920	102	10	10.2	909
FBgn0036221	1014	1000	954	74	11	6.7272727272727275	940
FBgn0036224	1027	1000	1016	38	9	4.222222222222222	989
FBgn0036225	1080	1000	1035	125	13	9.615384615384615	955
FBgn0036226	1017	1000	999	35	5	7	982
FBgn0036228	1021	1000	987	55	7	7.857142857142857	966
FBgn0036229	1012	1000	1003	21	4	5.25	991
FBgn0036230	1004	1000	976	32	8	4	972
FBgn0036235	1016	1000	983	49	13	3.769230769230769	967
FBgn0036239	1039	1000	1035	43	6	7.166666666666667	996
FBgn0036240	1048	1000	1014	82	11	7.454545454545454	966
FBgn0036242	1035	1000	1026	44	10	4.4	991
FBgn0036246	1059	1000	1002	116	15	7.733333333333333	943
FBgn0036250	1024	1000	989	59	12	4.916666666666667	965
FBgn0036254	944	933	938	17	5	3.4	927
FBgn0036255	1011	1000	1009	13	3	4.333333333333333	998
FBgn0036257	1036	1000	1007	65	7	9.285714285714286	971
FBgn0036258	1005	1000	1004	6	4	1.5	999
FBgn0036259	1019	1000	1013	25	9	2.7777777777777777	994
FBgn0036260	1013	1000	968	58	9	6.444444444444445	955
FBgn0036262	1006	1000	931	81	10	8.1	925
FBgn0036263	1008	1000	982	34	5	6.8	974
FBgn0036264	1026	1000	1007	45	10	4.5	981
FBgn0036266	1042	1000	1014	70	7	10	972
FBgn0036271	1014	1000	1008	20	7	2.857142857142857	994
FBgn0036272	1047	1000	1004	90	15	6	957
FBgn0036273	1058	1000	1015	101	17	5.9411764705882355	957
FBgn0036274	1016	1000	1011	21	6	3.5	995
FBgn0036277	1000	1000	964	36	10	3.6	964
FBgn0036278	1006	1000	1003	9	5	1.8	997
FBgn0036279	1046	1000	1041	51	8	6.375	995
FBgn0036282	1006	1000	989	23	8	2.875	983
FBgn0036285	1028	1000	788	268	10	26.8	760
FBgn0036286	1059	1000	1037	81	13	6.230769230769231	978
FBgn0036289	1053	1000	1034	72	7	10.285714285714286	981
FBgn0036290	1031	1000	1023	39	10	3.9	992
FBgn0036291	1005	1000	868	142	5	28.4	863
FBgn0036292	1015	1000	999	31	10	3.1	984
FBgn0036299	1008	1000	994	22	7	3.142857142857143	986
FBgn0036301	876	869	842	41	13	3.1538461538461537	835
FBgn0036302	1046	1000	1034	58	13	4.461538461538462	988
FBgn0036305	1046	1000	1027	65	7	9.285714285714286	981
FBgn0036306	1009	1000	1004	14	2	7	995
FBgn0036310	1004	1000	994	14	4	3.5	990
FBgn0036311	1004	1000	1002	6	2	3	998
FBgn0036314	1022	1000	988	56	10	5.6	966
FBgn0036316	1006	1000	988	24	8	3	982
FBgn0036317	1003	1000	998	8	4	2	995
FBgn0036318	1000	1000	999	1	1	1	999
FBgn0036319	903	865	858	83	8	10.375	820
FBgn0036320	1001	1000	954	48	6	8	953
FBgn0036321	1052	1000	1022	82	8	10.25	970
FBgn0036325	1000	1000	983	17	3	5.666666666666667	983
FBgn0036327	1001	1000	1000	2	2	1	999
FBgn0036328	1001	1000	996	6	4	1.5	995
FBgn0036333	1006	1000	928	84	9	9.333333333333334	922
FBgn0036334	1006	1000	936	76	8	9.5	930
FBgn0036336	1009	1000	988	30	8	3.75	979
FBgn0036340	723	719	699	28	9	3.111111111111111	695
FBgn0036343	1007	1000	1005	9	4	2.25	998
FBgn0036345	1003	1000	993	13	6	2.1666666666666665	990
FBgn0036346	1030	1000	960	100	13	7.6923076923076925	930
FBgn0036348	1019	1000	951	87	13	6.6923076923076925	932
FBgn0036350	1029	1000	1022	36	8	4.5	993
FBgn0036351	1003	1000	973	33	5	6.6	970
FBgn0036352	932	883	870	111	18	6.166666666666667	821
FBgn0036353	780	722	761	77	14	5.5	703
FBgn0036354	1024	1000	993	55	11	5	969
FBgn0036356	1001	1000	733	269	4	67.25	732
FBgn0036359	1020	1000	577	463	11	42.09090909090909	557
FBgn0036361	1010	1000	980	40	9	4.444444444444445	970
FBgn0036362	1010	1000	975	45	11	4.090909090909091	965
FBgn0036363	1003	1000	993	13	6	2.1666666666666665	990
FBgn0036364	1002	1000	992	12	4	3	990
FBgn0036367	1016	1000	1016	16	5	3.2	1000
FBgn0036369	1089	1000	1055	123	10	12.3	966
FBgn0036372	1055	1000	1010	100	15	6.666666666666667	955
FBgn0036373	1043	1000	1019	67	9	7.444444444444445	976
FBgn0036376	1000	1000	981	19	3	6.333333333333333	981
FBgn0036377	1015	1000	892	138	5	27.6	877
FBgn0036381	1099	1000	1057	141	7	20.142857142857142	958
FBgn0036382	1018	1000	959	77	9	8.555555555555555	941
FBgn0036386	1047	1000	994	100	10	10	947
FBgn0036390	1027	1000	970	84	11	7.636363636363637	943
FBgn0036391	1041	1000	992	90	14	6.428571428571429	951
FBgn0036393	1015	1000	1003	27	9	3	988
FBgn0036394	784	761	758	49	10	4.9	735
FBgn0036395	745	720	654	116	11	10.545454545454545	629
FBgn0036397	1005	1000	988	22	8	2.75	983
FBgn0036402	1051	1000	1042	60	8	7.5	991
FBgn0036403	780	779	644	137	4	34.25	643
FBgn0036405	1000	1000	67	933	2	466.5	67
FBgn0036411	1020	1000	981	59	16	3.6875	961
FBgn0036414	1004	1000	413	595	5	119	409
FBgn0036416	1022	1000	1021	23	4	5.75	999
FBgn0036417	1000	1000	969	31	2	15.5	969
FBgn0036421	1001	1000	910	92	7	13.142857142857142	909
FBgn0036422	1103	1000	1040	166	15	11.066666666666666	937
FBgn0036423	1020	1000	988	52	12	4.333333333333333	968
FBgn0036426	1008	1000	1002	14	4	3.5	994
FBgn0036428	1035	1000	993	77	13	5.923076923076923	958
FBgn0036433	1010	1000	1006	14	6	2.3333333333333335	996
FBgn0036436	1021	1000	980	62	9	6.888888888888889	959
FBgn0036443	1016	1000	564	468	6	78	548
FBgn0036446	1007	1000	963	51	6	8.5	956
FBgn0036448	896	856	886	50	9	5.555555555555555	846
FBgn0036449	1000	1000	754	246	1	246	754
FBgn0036450	1054	1000	861	247	8	30.875	807
FBgn0036454	1055	1000	1024	86	18	4.777777777777778	969
FBgn0036459	1030	1000	945	115	11	10.454545454545455	915
FBgn0036462	1025	1000	1009	41	10	4.1	984
FBgn0036470	1023	1000	1018	28	8	3.5	995
FBgn0036481	1003	1000	955	51	11	4.636363636363637	952
FBgn0036483	1018	1000	993	43	9	4.777777777777778	975
FBgn0036486	1041	1000	1031	51	6	8.5	990
FBgn0036487	1039	1000	1028	50	6	8.333333333333334	989
FBgn0036488	973	964	967	15	7	2.142857142857143	958
FBgn0036489	1038	1000	1012	64	12	5.333333333333333	974
FBgn0036490	1009	1000	979	39	5	7.8	970
FBgn0036492	1001	1000	971	31	7	4.428571428571429	970
FBgn0036493	1024	1000	1002	46	10	4.6	978
FBgn0036495	1032	1000	1001	63	7	9	969
FBgn0036496	1001	1000	187	815	2	407.5	186
FBgn0036497	1033	1000	958	108	15	7.2	925
FBgn0036498	1011	1000	768	254	12	21.166666666666668	757
FBgn0036502	1040	1000	1037	43	6	7.166666666666667	997
FBgn0036503	793	773	740	73	11	6.636363636363637	720
FBgn0036504	1009	1000	979	39	9	4.333333333333333	970
FBgn0036509	1005	1000	983	27	7	3.857142857142857	978
FBgn0036510	1001	1000	982	20	6	3.3333333333333335	981
FBgn0036512	816	816	556	260	4	65	556
FBgn0036514	1010	1000	1002	18	4	4.5	992
FBgn0036516	1016	1000	959	73	13	5.615384615384615	943
FBgn0036518	1015	1000	955	75	13	5.769230769230769	940
FBgn0036522	1001	1000	996	6	4	1.5	995
FBgn0036527	1025	1000	1001	49	10	4.9	976
FBgn0036528	1011	1000	1002	20	5	4	991
FBgn0036529	1010	1000	1010	10	3	3.3333333333333335	1000
FBgn0036531	1008	1000	950	66	5	13.2	942
FBgn0036532	805	765	793	52	7	7.428571428571429	753
FBgn0036534	1014	1000	857	171	7	24.428571428571427	843
FBgn0036536	1026	1000	977	75	13	5.769230769230769	951
FBgn0036537	783	770	781	15	8	1.875	768
FBgn0036538	1015	1000	991	39	6	6.5	976
FBgn0036544	1065	1000	1045	85	12	7.083333333333333	980
FBgn0036545	1010	1000	998	22	13	1.6923076923076923	988
FBgn0036547	879	872	852	34	6	5.666666666666667	845
FBgn0036549	1023	1000	1022	24	4	6	999
FBgn0036550	1037	1000	1023	51	5	10.2	986
FBgn0036556	1006	1000	994	18	6	3	988
FBgn0036557	1009	1000	991	27	11	2.4545454545454546	982
FBgn0036565	1026	1000	998	54	7	7.714285714285714	972
FBgn0036566	1000	1000	999	1	1	1	999
FBgn0036567	1068	1000	1058	78	12	6.5	990
FBgn0036568	1052	1000	1049	55	6	9.166666666666666	997
FBgn0036570	1014	1000	997	31	7	4.428571428571429	983
FBgn0036571	1008	1000	977	39	2	19.5	969
FBgn0036574	1032	1000	1014	50	13	3.8461538461538463	982
FBgn0036575	1006	1000	1005	7	2	3.5	999
FBgn0036577	1010	1000	959	61	10	6.1	949
FBgn0036579	1019	1000	1010	28	3	9.333333333333334	991
FBgn0036580	1008	1000	991	25	10	2.5	983
FBgn0036581	1010	1000	1009	11	2	5.5	999
FBgn0036584	1004	1000	723	285	5	57	719
FBgn0036585	1026	1000	1023	29	6	4.833333333333333	997
FBgn0036587	1016	1000	1014	18	5	3.6	998
FBgn0036588	1016	1000	1009	23	7	3.2857142857142856	993
FBgn0036589	1003	1000	997	9	3	3	994
FBgn0036590	1051	1000	1012	90	15	6	961
FBgn0036591	1013	1000	977	49	7	7	964
FBgn0036592	1031	1000	1016	46	12	3.8333333333333335	985
FBgn0036593	857	843	837	34	10	3.4	823
FBgn0036594	1015	1000	962	68	11	6.181818181818182	947
FBgn0036595	1017	1000	1008	26	10	2.6	991
FBgn0036596	1023	1000	995	51	10	5.1	972
FBgn0036597	1012	1000	1009	15	5	3	997
FBgn0036598	1014	1000	989	39	10	3.9	975
FBgn0036600	1006	1000	989	23	5	4.6	983
FBgn0036601	1006	1000	989	23	5	4.6	983
FBgn0036602	1002	1000	963	41	9	4.555555555555555	961
FBgn0036612	1019	1000	1002	36	9	4	983
FBgn0036614	1000	1000	999	1	1	1	999
FBgn0036617	1051	1000	1039	63	10	6.3	988
FBgn0036618	1015	1000	977	53	10	5.3	962
FBgn0036619	1058	1000	1033	83	12	6.916666666666667	975
FBgn0036620	1058	1000	1031	85	13	6.538461538461538	973
FBgn0036623	1016	1000	1006	26	9	2.888888888888889	990
FBgn0036624	1041	1000	1031	51	12	4.25	990
FBgn0036639	1012	1000	1001	23	9	2.5555555555555554	989
FBgn0036652	1016	1000	1007	25	4	6.25	991
FBgn0036654	1059	1000	997	121	16	7.5625	938
FBgn0036655	1004	1000	991	17	9	1.8888888888888888	987
FBgn0036656	1000	1000	994	6	3	2	994
FBgn0036661	1001	1000	971	31	4	7.75	970
FBgn0036663	1022	1000	975	69	15	4.6	953
FBgn0036665	1015	1000	957	73	12	6.083333333333333	942
FBgn0036667	1036	1000	794	278	5	55.6	758
FBgn0036668	993	992	671	323	2	161.5	670
FBgn0036671	1020	1000	1017	23	4	5.75	997
FBgn0036676	1040	1000	1003	77	17	4.529411764705882	963
FBgn0036677	1066	1000	1016	116	10	11.6	950
FBgn0036678	1002	1000	1002	2	1	2	1000
FBgn0036680	1013	1000	1001	25	7	3.5714285714285716	988
FBgn0036681	1001	1000	997	5	4	1.25	996
FBgn0036684	900	884	862	54	6	9	846
FBgn0036685	1106	1000	1087	125	8	15.625	981
FBgn0036686	1016	1000	821	211	6	35.166666666666664	805
FBgn0036688	1049	1000	1019	79	12	6.583333333333333	970
FBgn0036689	714	709	659	60	8	7.5	654
FBgn0036695	1002	1000	968	36	4	9	966
FBgn0036696	1033	1000	981	85	10	8.5	948
FBgn0036697	1045	1000	989	101	16	6.3125	944
FBgn0036698	1000	1000	998	2	2	1	998
FBgn0036704	1018	1000	1011	25	11	2.272727272727273	993
FBgn0036706	1010	1000	1010	10	4	2.5	1000
FBgn0036707	1027	1000	953	101	8	12.625	926
FBgn0036709	1003	1000	1000	6	4	1.5	997
FBgn0036711	903	862	840	104	9	11.555555555555555	799
FBgn0036712	721	721	697	24	1	24	697
FBgn0036713	1006	1000	978	34	4	8.5	972
FBgn0036714	1036	1000	1024	48	5	9.6	988
FBgn0036716	1004	1000	984	24	7	3.4285714285714284	980
FBgn0036717	1001	1000	990	12	3	4	989
FBgn0036723	1000	1000	1000	0	0	NA	1000
FBgn0036725	1007	1000	998	16	6	2.6666666666666665	991
FBgn0036726	1034	1000	625	443	13	34.07692307692308	591
FBgn0036727	1111	1000	1100	122	11	11.090909090909092	989
FBgn0036730	1003	1000	902	104	4	26	899
FBgn0036731	1027	1000	1001	53	9	5.888888888888889	974
FBgn0036732	1027	1000	1001	53	9	5.888888888888889	974
FBgn0036733	1072	1000	1058	86	11	7.818181818181818	986
FBgn0036734	1072	1000	1063	81	10	8.1	991
FBgn0036738	1020	1000	983	57	6	9.5	963
FBgn0036740	1016	1000	937	95	5	19	921
FBgn0036745	1003	1000	955	51	6	8.5	952
FBgn0036746	1070	1000	1056	84	14	6	986
FBgn0036747	1071	1000	1064	78	8	9.75	993
FBgn0036750	1087	1000	1076	98	10	9.8	989
FBgn0036751	1016	1000	1004	28	5	5.6	988
FBgn0036756	1006	1000	997	15	4	3.75	991
FBgn0036760	711	709	700	13	5	2.6	698
FBgn0036761	1003	1000	967	39	9	4.333333333333333	964
FBgn0036762	1002	1000	970	34	7	4.857142857142857	968
FBgn0036764	1081	1000	1018	144	16	9	937
FBgn0036766	930	877	861	122	17	7.176470588235294	808
FBgn0036769	1038	1000	996	80	12	6.666666666666667	958
FBgn0036770	1001	1000	994	8	4	2	993
FBgn0036771	1006	1000	996	16	7	2.2857142857142856	990
FBgn0036772	1015	1000	1011	19	4	4.75	996
FBgn0036773	1013	1000	986	40	9	4.444444444444445	973
FBgn0036774	1014	1000	993	35	7	5	979
FBgn0036775	1044	1000	1000	88	5	17.6	956
FBgn0036778	1013	1000	946	80	10	8	933
FBgn0036780	1024	1000	979	69	17	4.0588235294117645	955
FBgn0036781	1023	1000	924	122	13	9.384615384615385	901
FBgn0036782	1046	1000	1011	81	18	4.5	965
FBgn0036783	1052	1000	1030	74	10	7.4	978
FBgn0036784	1007	1000	797	217	8	27.125	790
FBgn0036785	1001	1000	1000	2	2	1	999
FBgn0036786	1033	1000	967	99	14	7.071428571428571	934
FBgn0036789	1009	1000	908	110	8	13.75	899
FBgn0036790	1043	1000	1033	53	12	4.416666666666667	990
FBgn0036791	1008	1000	996	20	6	3.3333333333333335	988
FBgn0036801	1051	1000	575	527	10	52.7	524
FBgn0036804	1000	1000	730	270	4	67.5	730
FBgn0036806	1059	1000	1014	104	12	8.666666666666666	955
FBgn0036807	1021	1000	919	123	11	11.181818181818182	898
FBgn0036809	1018	1000	891	145	10	14.5	873
FBgn0036810	1052	1000	908	196	16	12.25	856
FBgn0036812	1019	1000	1010	28	9	3.111111111111111	991
FBgn0036813	1005	1000	1000	10	4	2.5	995
FBgn0036814	1023	1000	1018	28	7	4	995
FBgn0036815	1003	1000	1003	3	3	1	1000
FBgn0036817	1020	1000	1003	37	8	4.625	983
FBgn0036822	1019	1000	970	68	16	4.25	951
FBgn0036826	1000	1000	1000	0	0	NA	1000
FBgn0036827	1039	1000	1021	57	8	7.125	982
FBgn0036828	1001	1000	592	410	5	82	591
FBgn0036830	1010	1000	976	44	6	7.333333333333333	966
FBgn0036831	1008	1000	964	52	7	7.428571428571429	956
FBgn0036833	1011	1000	995	27	10	2.7	984
FBgn0036834	1038	1000	1031	45	9	5	993
FBgn0036835	1000	1000	999	1	1	1	999
FBgn0036839	1002	1000	963	41	5	8.2	961
FBgn0036842	1061	1000	1045	77	12	6.416666666666667	984
FBgn0036843	1061	1000	1050	72	13	5.538461538461538	989
FBgn0036844	1005	1000	993	17	6	2.8333333333333335	988
FBgn0036848	1055	1000	1044	66	11	6	989
FBgn0036849	1027	1000	969	85	10	8.5	942
FBgn0036850	1058	1000	1007	109	17	6.411764705882353	949
FBgn0036851	1014	1000	995	33	5	6.6	981
FBgn0036853	1093	1000	1085	101	9	11.222222222222221	992
FBgn0036857	877	858	760	136	6	22.666666666666668	741
FBgn0036858	1000	1000	475	525	2	262.5	475
FBgn0036859	1047	1000	996	98	7	14	949
FBgn0036860	1033	1000	1020	46	11	4.181818181818182	987
FBgn0036861	1019	1000	981	57	10	5.7	962
FBgn0036868	1026	1000	1004	48	11	4.363636363636363	978
FBgn0036870	1002	1000	696	308	5	61.6	694
FBgn0036875	802	754	798	52	5	10.4	750
FBgn0036877	1020	1000	977	63	14	4.5	957
FBgn0036878	1010	1000	979	41	8	5.125	969
FBgn0036879	1003	1000	972	34	6	5.666666666666667	969
FBgn0036881	1007	1000	959	55	7	7.857142857142857	952
FBgn0036886	1000	1000	1000	0	0	NA	1000
FBgn0036887	1002	1000	970	34	8	4.25	968
FBgn0036888	1013	1000	982	44	11	4	969
FBgn0036889	785	777	780	13	8	1.625	772
FBgn0036891	1017	1000	969	65	11	5.909090909090909	952
FBgn0036893	1000	1000	797	203	2	101.5	797
FBgn0036896	1044	1000	1016	72	16	4.5	972
FBgn0036897	1058	1000	1030	86	14	6.142857142857143	972
FBgn0036899	1030	1000	999	61	9	6.777777777777778	969
FBgn0036906	1002	1000	990	14	4	3.5	988
FBgn0036909	1001	1000	999	3	2	1.5	998
FBgn0036911	1012	1000	1006	18	2	9	994
FBgn0036913	1011	1000	996	26	5	5.2	985
FBgn0036918	1000	1000	1000	0	0	NA	1000
FBgn0036920	1018	1000	1003	33	7	4.714285714285714	985
FBgn0036921	1010	1000	1000	20	6	3.3333333333333335	990
FBgn0036923	1004	1000	905	103	9	11.444444444444445	901
FBgn0036924	1024	1000	1007	41	7	5.857142857142857	983
FBgn0036925	1015	1000	1013	17	4	4.25	998
FBgn0036927	1023	1000	999	47	8	5.875	976
FBgn0036928	1004	1000	980	28	10	2.8	976
FBgn0036932	1033	1000	949	117	9	13	916
FBgn0036934	1079	1000	1064	94	11	8.545454545454545	985
FBgn0036935	1033	1000	1007	59	8	7.375	974
FBgn0036937	838	819	830	27	7	3.857142857142857	811
FBgn0036939	1004	1000	995	13	5	2.6	991
FBgn0036941	1002	1000	963	41	2	20.5	961
FBgn0036942	1069	1000	1052	86	10	8.6	983
FBgn0036945	1076	1000	1055	97	18	5.388888888888889	979
FBgn0036948	1003	983	791	232	6	38.666666666666664	771
FBgn0036949	1033	1000	967	99	16	6.1875	934
FBgn0036950	1005	1000	926	84	12	7	921
FBgn0036952	1087	1000	1043	131	16	8.1875	956
FBgn0036953	1098	1000	906	290	13	22.307692307692307	808
FBgn0036973	1005	1000	995	15	7	2.142857142857143	990
FBgn0036974	1005	1000	1002	8	5	1.6	997
FBgn0036978	1011	1000	979	43	7	6.142857142857143	968
FBgn0036980	1018	1000	996	40	6	6.666666666666667	978
FBgn0036984	1009	1000	986	32	9	3.5555555555555554	977
FBgn0036985	1023	1000	963	83	8	10.375	940
FBgn0036987	726	686	696	70	6	11.666666666666666	656
FBgn0036990	1000	1000	951	49	3	16.333333333333332	951
FBgn0036991	1000	1000	985	15	1	15	985
FBgn0036992	1018	1000	1016	20	6	3.3333333333333335	998
FBgn0036993	1051	1000	1033	69	9	7.666666666666667	982
FBgn0036994	1058	1000	1005	111	19	5.842105263157895	947
FBgn0036996	1029	1000	973	85	15	5.666666666666667	944
FBgn0036997	1072	1000	1044	100	13	7.6923076923076925	972
FBgn0036998	1118	1000	1105	131	11	11.909090909090908	987
FBgn0037000	1002	1000	993	11	5	2.2	991
FBgn0037001	1011	1000	955	67	7	9.571428571428571	944
FBgn0037009	1019	1000	989	49	5	9.8	970
FBgn0037011	1035	1000	1032	38	8	4.75	997
FBgn0037012	1028	1000	984	72	12	6	956
FBgn0037013	1049	1000	1000	98	14	7	951
FBgn0037014	1043	1000	1039	47	8	5.875	996
FBgn0037015	1069	1000	1055	83	11	7.545454545454546	986
FBgn0037016	1030	1000	961	99	9	11	931
FBgn0037017	702	702	693	9	4	2.25	693
FBgn0037018	1082	1000	1037	127	11	11.545454545454545	955
FBgn0037019	1036	1000	981	91	10	9.1	945
FBgn0037020	1036	1000	982	90	9	10	946
FBgn0037023	1000	1000	996	4	2	2	996
FBgn0037024	1000	1000	996	4	2	2	996
FBgn0037026	1000	1000	996	4	2	2	996
FBgn0037027	1000	1000	999	1	1	1	999
FBgn0037028	1062	1000	1038	86	10	8.6	976
FBgn0037030	1007	1000	1001	13	6	2.1666666666666665	994
FBgn0037031	1015	1000	891	139	7	19.857142857142858	876
FBgn0037035	1002	1000	993	11	5	2.2	991
FBgn0037036	1027	1000	1026	28	4	7	999
FBgn0037037	1002	1000	969	35	5	7	967
FBgn0037042	1069	1000	1056	82	17	4.823529411764706	987
FBgn0037044	1016	1000	983	49	7	7	967
FBgn0037045	1043	1000	998	88	13	6.769230769230769	955
FBgn0037046	1043	1000	1029	57	13	4.384615384615385	986
FBgn0037050	1005	1000	995	15	7	2.142857142857143	990
FBgn0037051	767	753	762	19	6	3.1666666666666665	748
FBgn0037057	1018	1000	997	39	11	3.5454545454545454	979
FBgn0037059	1010	1000	988	32	5	6.4	978
FBgn0037060	1029	1000	1005	53	7	7.571428571428571	976
FBgn0037061	1008	1000	963	53	4	13.25	955
FBgn0037064	1004	1000	997	11	6	1.8333333333333333	993
FBgn0037065	1000	1000	998	2	1	2	998
FBgn0037067	1015	1000	985	45	9	5	970
FBgn0037069	1031	1000	1012	50	8	6.25	981
FBgn0037070	1000	1000	995	5	1	5	995
FBgn0037073	1022	1000	1022	22	2	11	1000
FBgn0037074	1002	1000	954	50	4	12.5	952
FBgn0037076	1021	1000	981	61	5	12.2	960
FBgn0037078	1001	1000	651	351	8	43.875	650
FBgn0037081	1008	1000	999	17	6	2.8333333333333335	991
FBgn0037084	1002	1000	923	81	10	8.1	921
FBgn0037085	867	861	360	513	4	128.25	354
FBgn0037086	1019	1000	1012	26	7	3.7142857142857144	993
FBgn0037087	1024	1000	953	95	14	6.785714285714286	929
FBgn0037092	1057	1000	1052	62	7	8.857142857142858	995
FBgn0037093	1014	1000	989	39	11	3.5454545454545454	975
FBgn0037094	1040	1000	1035	45	10	4.5	995
FBgn0037098	783	722	775	69	9	7.666666666666667	714
FBgn0037099	1017	1000	988	46	6	7.666666666666667	971
FBgn0037100	1024	1000	967	81	15	5.4	943
FBgn0037101	1027	1000	1024	30	8	3.75	997
FBgn0037102	1011	1000	996	26	5	5.2	985
FBgn0037105	1000	1000	973	27	9	3	973
FBgn0037106	1026	1000	1018	34	5	6.8	992
FBgn0037107	1001	1000	973	29	6	4.833333333333333	972
FBgn0037108	1013	1000	995	31	9	3.4444444444444446	982
FBgn0037110	1083	1000	753	413	15	27.533333333333335	670
FBgn0037114	1019	1000	1019	19	3	6.333333333333333	1000
FBgn0037115	1084	1000	900	268	24	11.166666666666666	816
FBgn0037116	1018	1000	983	53	11	4.818181818181818	965
FBgn0037120	936	935	931	6	2	3	930
FBgn0037121	1019	1000	999	39	9	4.333333333333333	980
FBgn0037124	1013	1000	1004	22	4	5.5	991
FBgn0037125	1013	1000	1004	22	4	5.5	991
FBgn0037126	1064	1000	1017	111	11	10.090909090909092	953
FBgn0037127	1005	1000	988	22	7	3.142857142857143	983
FBgn0037128	1005	1000	988	22	7	3.142857142857143	983
FBgn0037130	1003	1000	234	772	2	386	231
FBgn0037131	1016	1000	1013	19	3	6.333333333333333	997
FBgn0037137	1014	1000	622	406	7	58	608
FBgn0037140	1040	1000	1023	57	11	5.181818181818182	983
FBgn0037141	1047	1000	1005	89	17	5.235294117647059	958
FBgn0037142	1024	1000	992	56	9	6.222222222222222	968
FBgn0037146	1022	1000	997	47	6	7.833333333333333	975
FBgn0037150	752	724	418	362	9	40.22222222222222	390
FBgn0037151	1010	1000	1009	11	2	5.5	999
FBgn0037162	1000	1000	990	10	4	2.5	990
FBgn0037163	1052	1000	1017	87	9	9.666666666666666	965
FBgn0037166	830	765	818	77	16	4.8125	753
FBgn0037167	1011	1000	996	26	8	3.25	985
FBgn0037170	1003	1000	969	37	7	5.285714285714286	966
FBgn0037171	1049	1000	842	256	13	19.692307692307693	793
FBgn0037172	1006	1000	997	15	6	2.5	991
FBgn0037174	1040	1000	996	84	10	8.4	956
FBgn0037175	1000	1000	1000	0	0	NA	1000
FBgn0037176	1004	1000	1004	4	3	1.3333333333333333	1000
FBgn0037178	1007	1000	950	64	10	6.4	943
FBgn0037181	1028	1000	993	63	11	5.7272727272727275	965
FBgn0037182	1018	1000	986	50	8	6.25	968
FBgn0037184	1043	1000	1018	68	5	13.6	975
FBgn0037185	1019	1000	989	49	5	9.8	970
FBgn0037186	683	680	664	22	3	7.333333333333333	661
FBgn0037188	1027	1000	1016	38	8	4.75	989
FBgn0037195	1022	1000	976	68	10	6.8	954
FBgn0037197	1022	1000	947	97	7	13.857142857142858	925
FBgn0037199	839	838	838	2	2	1	837
FBgn0037202	1006	1000	1002	10	7	1.4285714285714286	996
FBgn0037206	808	803	731	82	5	16.4	726
FBgn0037213	1017	1000	348	686	7	98	331
FBgn0037223	1025	1000	965	85	7	12.142857142857142	940
FBgn0037227	1035	1000	1026	44	7	6.285714285714286	991
FBgn0037228	1001	1000	292	710	4	177.5	291
FBgn0037229	1027	1000	694	360	10	36	667
FBgn0037230	1052	1000	1052	52	4	13	1000
FBgn0037231	1126	1000	1116	136	13	10.461538461538462	990
FBgn0037232	811	685	809	128	13	9.846153846153847	683
FBgn0037234	1022	1000	1012	32	8	4	990
FBgn0037235	1003	1000	987	19	3	6.333333333333333	984
FBgn0037236	1023	1000	984	62	8	7.75	961
FBgn0037244	1013	1000	988	38	7	5.428571428571429	975
FBgn0037249	799	728	668	202	6	33.666666666666664	597
FBgn0037250	1002	1000	1002	2	1	2	1000
FBgn0037251	1006	1000	994	18	2	9	988
FBgn0037260	1032	1000	1013	51	12	4.25	981
FBgn0037261	1008	1000	978	38	6	6.333333333333333	970
FBgn0037265	745	710	724	56	8	7	689
FBgn0037275	974	968	917	63	12	5.25	911
FBgn0037279	1064	1000	1040	88	16	5.5	976
FBgn0037282	1020	1000	946	94	12	7.833333333333333	926
FBgn0037288	1031	1000	1001	61	9	6.777777777777778	970
FBgn0037290	1035	1000	993	77	11	7	958
FBgn0037295	1000	1000	687	313	12	26.083333333333332	687
FBgn0037296	1014	1000	1013	15	3	5	999
FBgn0037299	1000	1000	91	909	1	909	91
FBgn0037301	1026	1000	996	56	15	3.7333333333333334	970
FBgn0037305	1025	1000	1003	47	7	6.714285714285714	978
FBgn0037307	1068	1000	1014	122	18	6.777777777777778	946
FBgn0037310	1087	1000	1050	124	21	5.904761904761905	963
FBgn0037312	1039	1000	912	166	11	15.090909090909092	873
FBgn0037313	1022	1000	1018	26	9	2.888888888888889	996
FBgn0037315	1000	1000	126	874	2	437	126
FBgn0037322	1005	1000	1004	6	3	2	999
FBgn0037323	1001	1000	985	17	3	5.666666666666667	984
FBgn0037324	1002	1000	959	45	8	5.625	957
FBgn0037325	1018	1000	967	69	10	6.9	949
FBgn0037327	1008	954	938	124	22	5.636363636363637	884
FBgn0037328	1020	1000	999	41	10	4.1	979
FBgn0037329	1019	1000	998	40	9	4.444444444444445	979
FBgn0037330	1021	1000	977	65	14	4.642857142857143	956
FBgn0037332	1060	1000	1010	110	13	8.461538461538462	950
FBgn0037340	1007	1000	993	21	6	3.5	986
FBgn0037341	1000	1000	934	66	4	16.5	934
FBgn0037342	1009	1000	1001	17	6	2.8333333333333335	992
FBgn0037345	1001	1000	685	317	3	105.66666666666667	684
FBgn0037347	1018	1000	1002	34	8	4.25	984
FBgn0037351	1044	1000	1031	57	8	7.125	987
FBgn0037356	1051	1000	1032	70	9	7.777777777777778	981
FBgn0037358	1000	1000	993	7	4	1.75	993
FBgn0037359	1007	1000	998	16	8	2	991
FBgn0037360	1007	1000	957	57	15	3.8	950
FBgn0037363	1006	1000	944	68	8	8.5	938
FBgn0037364	1056	1000	1011	101	15	6.733333333333333	955
FBgn0037365	1011	1000	379	643	7	91.85714285714286	368
FBgn0037369	1009	1000	954	64	7	9.142857142857142	945
FBgn0037370	1018	1000	960	76	9	8.444444444444445	942
FBgn0037371	1010	1000	1006	14	3	4.666666666666667	996
FBgn0037375	1000	1000	983	17	3	5.666666666666667	983
FBgn0037376	1008	1000	1008	8	1	8	1000
FBgn0037378	1001	1000	1001	1	1	1	1000
FBgn0037379	1001	1000	996	6	3	2	995
FBgn0037382	1060	1000	1024	96	12	8	964
FBgn0037383	1031	1000	1031	31	4	7.75	1000
FBgn0037384	1000	1000	1000	0	0	NA	1000
FBgn0037387	1046	1000	996	96	11	8.727272727272727	950
FBgn0037388	820	808	471	361	11	32.81818181818182	459
FBgn0037391	1000	1000	617	383	3	127.66666666666667	617
FBgn0037395	1071	1000	1067	75	15	5	996
FBgn0037396	1077	1000	829	325	14	23.214285714285715	752
FBgn0037398	1035	1000	1018	52	13	4	983
FBgn0037399	1019	1000	738	300	5	60	719
FBgn0037402	1004	1000	955	53	3	17.666666666666668	951
FBgn0037406	1028	1000	998	58	5	11.6	970
FBgn0037408	1005	1000	524	486	7	69.42857142857143	519
FBgn0037409	1024	1000	883	165	12	13.75	859
FBgn0037410	1023	1000	1008	38	6	6.333333333333333	985
FBgn0037411	1004	1000	972	36	5	7.2	968
FBgn0037412	1029	1000	977	81	11	7.363636363636363	948
FBgn0037413	1088	1000	1082	94	5	18.8	994
FBgn0037414	1011	1000	727	295	5	59	716
FBgn0037416	1003	1000	976	30	4	7.5	973
FBgn0037419	1005	1000	940	70	10	7	935
FBgn0037420	1001	1000	975	27	8	3.375	974
FBgn0037421	1064	1000	1042	86	10	8.6	978
FBgn0037424	1033	1000	1031	35	5	7	998
FBgn0037427	885	881	360	529	3	176.33333333333334	356
FBgn0037428	1042	1000	1029	55	6	9.166666666666666	987
FBgn0037429	1010	1000	567	453	4	113.25	557
FBgn0037430	1077	1000	1050	104	7	14.857142857142858	973
FBgn0037435	1040	1000	1018	62	10	6.2	978
FBgn0037436	1092	1000	1024	160	10	16	932
FBgn0037439	1031	1000	964	98	11	8.909090909090908	933
FBgn0037440	1003	1000	836	170	5	34	833
FBgn0037443	1069	1000	1031	107	18	5.944444444444445	962
FBgn0037445	1014	1000	636	392	3	130.66666666666666	622
FBgn0037446	1012	1000	889	135	7	19.285714285714285	877
FBgn0037447	1021	1000	998	44	7	6.285714285714286	977
FBgn0037448	1004	1000	992	16	3	5.333333333333333	988
FBgn0037449	1035	1000	950	120	18	6.666666666666667	915
FBgn0037455	1021	1000	925	117	8	14.625	904
FBgn0037456	1010	1000	491	529	5	105.8	481
FBgn0037461	1007	1000	991	23	4	5.75	984
FBgn0037462	1007	1000	991	23	4	5.75	984
FBgn0037465	1018	1000	1011	25	4	6.25	993
FBgn0037466	1021	1000	1009	33	8	4.125	988
FBgn0037468	1006	1000	982	30	13	2.3076923076923075	976
FBgn0037470	1014	1000	1008	20	8	2.5	994
FBgn0037472	1030	1000	1012	48	6	8	982
FBgn0037475	1002	1000	997	7	3	2.3333333333333335	995
FBgn0037477	1044	1000	1023	65	9	7.222222222222222	979
FBgn0037481	1003	1000	986	20	6	3.3333333333333335	983
FBgn0037482	1018	1000	1003	33	7	4.714285714285714	985
FBgn0037483	1021	1000	1021	21	3	7	1000
FBgn0037486	1021	1000	1003	39	8	4.875	982
FBgn0037487	1052	1000	1026	78	10	7.8	974
FBgn0037488	1000	1000	985	15	2	7.5	985
FBgn0037489	1009	1000	992	26	6	4.333333333333333	983
FBgn0037490	1004	1000	982	26	3	8.666666666666666	978
FBgn0037491	1000	1000	999	1	1	1	999
FBgn0037492	1006	1000	1002	10	4	2.5	996
FBgn0037498	1005	1000	195	815	3	271.6666666666667	190
FBgn0037500	1034	1000	1011	57	9	6.333333333333333	977
FBgn0037501	1076	1000	1026	126	15	8.4	950
FBgn0037503	1013	1000	1007	19	4	4.75	994
FBgn0037512	1020	1000	1001	39	10	3.9	981
FBgn0037513	1050	1000	996	104	10	10.4	946
FBgn0037514	1007	1000	962	52	10	5.2	955
FBgn0037516	1005	1000	989	21	6	3.5	984
FBgn0037517	1009	1000	1009	9	2	4.5	1000
FBgn0037520	1000	1000	972	28	5	5.6	972
FBgn0037521	1009	1000	971	47	11	4.2727272727272725	962
FBgn0037525	1026	1000	1025	27	6	4.5	999
FBgn0037526	1047	1000	1040	54	7	7.714285714285714	993
FBgn0037529	824	765	813	70	9	7.777777777777778	754
FBgn0037530	1011	1000	996	26	6	4.333333333333333	985
FBgn0037531	1024	1000	913	135	6	22.5	889
FBgn0037533	1000	1000	995	5	3	1.6666666666666667	995
FBgn0037535	1018	1000	980	56	9	6.222222222222222	962
FBgn0037536	722	709	705	30	6	5	692
FBgn0037538	1015	1000	998	32	8	4	983
FBgn0037539	1024	1000	1001	47	10	4.7	977
FBgn0037540	1024	1000	1000	48	11	4.363636363636363	976
FBgn0037541	1006	1000	988	24	6	4	982
FBgn0037543	1025	1000	1019	31	7	4.428571428571429	994
FBgn0037544	1015	1000	1014	16	2	8	999
FBgn0037547	1012	1000	961	63	7	9	949
FBgn0037549	1008	1000	1003	13	5	2.6	995
FBgn0037550	1041	1000	1023	59	6	9.833333333333334	982
FBgn0037551	1008	1000	993	23	3	7.666666666666667	985
FBgn0037552	1039	1000	1024	54	13	4.153846153846154	985
FBgn0037555	1041	1000	1011	71	16	4.4375	970
FBgn0037556	1021	1000	1020	22	4	5.5	999
FBgn0037561	1040	1000	1037	43	9	4.777777777777778	997
FBgn0037563	1042	1000	981	103	13	7.923076923076923	939
FBgn0037565	1008	1000	961	55	8	6.875	953
FBgn0037566	1035	1000	987	83	12	6.916666666666667	952
FBgn0037571	1016	1000	1002	30	5	6	986
FBgn0037572	1000	1000	923	77	6	12.833333333333334	923
FBgn0037574	1008	1000	974	42	7	6	966
FBgn0037577	1030	1000	988	72	9	8	958
FBgn0037578	1013	1000	999	27	8	3.375	986
FBgn0037579	1007	1000	1003	11	4	2.75	996
FBgn0037584	1008	1000	748	268	6	44.666666666666664	740
FBgn0037591	1027	1000	1007	47	6	7.833333333333333	980
FBgn0037594	1016	1000	1009	23	5	4.6	993
FBgn0037602	1000	1000	997	3	2	1.5	997
FBgn0037603	1000	1000	1000	0	0	NA	1000
FBgn0037607	771	771	764	7	2	3.5	764
FBgn0037609	1010	1000	1004	16	4	4	994
FBgn0037612	1072	1000	1011	133	16	8.3125	939
FBgn0037613	1036	1000	1026	46	8	5.75	990
FBgn0037614	1002	1000	993	11	3	3.6666666666666665	991
FBgn0037616	1003	1000	974	32	8	4	971
FBgn0037618	830	802	798	60	11	5.454545454545454	770
FBgn0037621	1003	1000	974	32	7	4.571428571428571	971
FBgn0037622	1004	1000	972	36	9	4	968
FBgn0037623	1044	1000	1033	55	6	9.166666666666666	989
FBgn0037624	1007	1000	1001	13	6	2.1666666666666665	994
FBgn0037625	1032	1000	1000	64	7	9.142857142857142	968
FBgn0037626	1046	1000	990	102	10	10.2	944
FBgn0037627	1000	1000	999	1	1	1	999
FBgn0037630	1001	1000	958	44	7	6.285714285714286	957
FBgn0037632	1053	1000	1044	62	5	12.4	991
FBgn0037633	1002	1000	997	7	5	1.4	995
FBgn0037635	1034	1000	1012	56	16	3.5	978
FBgn0037637	1000	1000	982	18	5	3.6	982
FBgn0037638	1013	1000	995	31	6	5.166666666666667	982
FBgn0037643	1006	1000	981	31	8	3.875	975
FBgn0037644	1049	1000	1035	63	9	7	986
FBgn0037647	1027	1000	1018	36	6	6	991
FBgn0037648	1000	1000	995	5	2	2.5	995
FBgn0037650	1030	1000	998	62	11	5.636363636363637	968
FBgn0037652	1014	1000	1014	14	3	4.666666666666667	1000
FBgn0037653	1000	1000	964	36	6	6	964
FBgn0037656	1003	1000	1001	5	4	1.25	998
FBgn0037657	1053	1000	1050	56	6	9.333333333333334	997
FBgn0037659	793	746	778	62	8	7.75	731
FBgn0037660	1000	1000	1000	0	0	NA	1000
FBgn0037661	1000	1000	996	4	1	4	996
FBgn0037662	1078	1000	1068	88	14	6.285714285714286	990
FBgn0037664	1015	1000	995	35	8	4.375	980
FBgn0037669	1082	1000	1071	93	8	11.625	989
FBgn0037670	1082	1000	1079	85	7	12.142857142857142	997
FBgn0037672	1068	1000	1058	78	9	8.666666666666666	990
FBgn0037675	1001	1000	938	64	8	8	937
FBgn0037676	783	764	783	19	3	6.333333333333333	764
FBgn0037678	796	776	794	22	5	4.4	774
FBgn0037679	1017	1000	1015	19	6	3.1666666666666665	998
FBgn0037680	1020	1000	998	42	11	3.8181818181818183	978
FBgn0037683	1020	1000	1006	34	8	4.25	986
FBgn0037685	1007	1000	995	19	5	3.8	988
FBgn0037686	1018	1000	1018	18	3	6	1000
FBgn0037688	1012	1000	1006	18	6	3	994
FBgn0037690	1005	1000	1002	8	6	1.3333333333333333	997
FBgn0037696	1000	1000	963	37	7	5.285714285714286	963
FBgn0037698	1062	1000	1060	64	4	16	998
FBgn0037707	1013	1000	935	91	7	13	922
FBgn0037708	1002	1000	985	19	6	3.1666666666666665	983
FBgn0037709	1002	1000	984	20	7	2.857142857142857	982
FBgn0037710	1010	1000	1007	13	4	3.25	997
FBgn0037715	1002	1000	990	14	4	3.5	988
FBgn0037716	1028	1000	994	62	10	6.2	966
FBgn0037718	916	900	872	60	6	10	856
FBgn0037719	1023	1000	998	48	9	5.333333333333333	975
FBgn0037720	1019	1000	1010	28	4	7	991
FBgn0037721	1001	1000	993	9	3	3	992
FBgn0037722	1001	1000	986	16	6	2.6666666666666665	985
FBgn0037723	1000	1000	996	4	2	2	996
FBgn0037724	1000	1000	994	6	3	2	994
FBgn0037727	1092	1000	1076	108	12	9	984
FBgn0037736	1005	1000	951	59	10	5.9	946
FBgn0037737	1005	1000	954	56	8	7	949
FBgn0037739	1001	1000	995	7	4	1.75	994
FBgn0037742	1003	1000	1001	5	2	2.5	998
FBgn0037747	1000	1000	994	6	2	3	994
FBgn0037753	1045	1000	1023	67	11	6.090909090909091	978
FBgn0037754	1054	1000	1018	90	9	10	964
FBgn0037755	1009	1000	1005	13	5	2.6	996
FBgn0037756	1018	1000	1017	19	5	3.8	999
FBgn0037758	1002	1000	996	8	4	2	994
FBgn0037759	1003	1000	1000	6	4	1.5	997
FBgn0037761	1052	1000	1018	86	13	6.615384615384615	966
FBgn0037765	771	751	767	24	6	4	747
FBgn0037766	1006	1000	517	495	6	82.5	511
FBgn0037770	1017	1000	1005	29	4	7.25	988
FBgn0037772	1000	1000	983	17	4	4.25	983
FBgn0037773	1007	1000	964	50	6	8.333333333333334	957
FBgn0037777	1007	1000	1005	9	3	3	998
FBgn0037778	997	996	997	1	1	1	996
FBgn0037779	1021	1000	1007	35	8	4.375	986
FBgn0037780	1031	1000	1010	52	9	5.777777777777778	979
FBgn0037783	1033	1000	994	72	5	14.4	961
FBgn0037786	1008	1000	1004	12	4	3	996
FBgn0037788	1002	1000	983	21	7	3	981
FBgn0037796	1036	1000	1011	61	8	7.625	975
FBgn0037797	1013	1000	996	30	7	4.285714285714286	983
FBgn0037798	1000	1000	973	27	5	5.4	973
FBgn0037802	1004	1000	995	13	5	2.6	991
FBgn0037807	1044	1000	1028	60	11	5.454545454545454	984
FBgn0037809	1065	1000	1032	98	15	6.533333333333333	967
FBgn0037814	1001	1000	993	9	4	2.25	992
FBgn0037815	1003	1000	999	7	4	1.75	996
FBgn0037816	1051	1000	1032	70	10	7	981
FBgn0037817	1036	1000	1017	55	10	5.5	981
FBgn0037819	1046	1000	1025	67	11	6.090909090909091	979
FBgn0037826	1009	1000	999	19	10	1.9	990
FBgn0037827	1017	1000	1008	26	7	3.7142857142857144	991
FBgn0037828	1015	1000	989	41	8	5.125	974
FBgn0037829	910	862	870	88	10	8.8	822
FBgn0037831	1024	1000	996	52	6	8.666666666666666	972
FBgn0037832	1005	1000	971	39	6	6.5	966
FBgn0037834	1019	1000	1016	22	4	5.5	997
FBgn0037835	1001	1000	987	15	8	1.875	986
FBgn0037837	1000	1000	999	1	1	1	999
FBgn0037838	1000	1000	972	28	4	7	972
FBgn0037841	1014	1000	956	72	12	6	942
FBgn0037842	1017	1000	1013	21	5	4.2	996
FBgn0037843	894	894	894	0	0	NA	894
FBgn0037844	1051	1000	1036	66	8	8.25	985
FBgn0037845	1033	969	1010	87	8	10.875	946
FBgn0037848	1004	1000	981	27	6	4.5	977
FBgn0037849	1040	1000	1013	67	13	5.153846153846154	973
FBgn0037850	688	686	665	25	7	3.5714285714285716	663
FBgn0037855	1000	1000	999	1	1	1	999
FBgn0037857	1007	1000	981	33	5	6.6	974
FBgn0037860	1001	1000	974	28	5	5.6	973
FBgn0037862	1059	1000	1041	77	10	7.7	982
FBgn0037870	1042	1000	996	88	11	8	954
FBgn0037874	1018	1000	1012	24	6	4	994
FBgn0037875	908	830	885	101	18	5.611111111111111	807
FBgn0037876	1029	1000	1025	33	3	11	996
FBgn0037878	780	774	658	128	6	21.333333333333332	652
FBgn0037879	1021	1000	682	360	8	45	661
FBgn0037882	1004	1000	988	20	8	2.5	984
FBgn0037883	1039	1000	1036	42	3	14	997
FBgn0037884	1036	1000	633	439	8	54.875	597
FBgn0037885	1008	1000	994	22	5	4.4	986
FBgn0037890	1000	1000	994	6	5	1.2	994
FBgn0037891	1004	1000	976	32	7	4.571428571428571	972
FBgn0037892	1002	1000	1001	3	3	1	999
FBgn0037894	1003	1000	930	76	6	12.666666666666666	927
FBgn0037895	819	817	801	20	5	4	799
FBgn0037896	1002	1000	990	14	6	2.3333333333333335	988
FBgn0037897	1013	1000	1005	21	7	3	992
FBgn0037899	1006	1000	1006	6	3	2	1000
FBgn0037900	1000	1000	999	1	1	1	999
FBgn0037901	1001	1000	996	6	4	1.5	995
FBgn0037902	1014	1000	1011	17	4	4.25	997
FBgn0037906	1015	1000	992	38	10	3.8	977
FBgn0037908	1016	1000	1013	19	5	3.8	997
FBgn0037910	1046	1000	1034	58	11	5.2727272727272725	988
FBgn0037911	1005	1000	989	21	5	4.2	984
FBgn0037915	1006	1000	945	67	2	33.5	939
FBgn0037916	1000	1000	949	51	2	25.5	949
FBgn0037918	1032	1000	998	66	9	7.333333333333333	966
FBgn0037920	1005	1000	991	19	6	3.1666666666666665	986
FBgn0037922	1011	1000	1000	22	7	3.142857142857143	989
FBgn0037923	1032	1000	1031	33	4	8.25	999
FBgn0037926	1005	1000	978	32	9	3.5555555555555554	973
FBgn0037930	764	758	741	29	7	4.142857142857143	735
FBgn0037933	1001	1000	992	10	5	2	991
FBgn0037937	1013	1000	938	88	12	7.333333333333333	925
FBgn0037939	1017	1000	1015	19	6	3.1666666666666665	998
FBgn0037940	1005	1000	962	48	4	12	957
FBgn0037941	1000	1000	977	23	3	7.666666666666667	977
FBgn0037942	1018	1000	1002	34	7	4.857142857142857	984
FBgn0037943	1035	1000	1023	47	5	9.4	988
FBgn0037944	1000	1000	992	8	3	2.6666666666666665	992
FBgn0037949	1000	1000	996	4	1	4	996
FBgn0037950	1024	1000	1024	24	6	4	1000
FBgn0037955	1020	1000	1006	34	5	6.8	986
FBgn0037956	1037	1000	1018	56	12	4.666666666666667	981
FBgn0037958	1002	1000	995	9	3	3	993
FBgn0037960	1006	1000	969	43	8	5.375	963
FBgn0037962	959	950	952	16	4	4	943
FBgn0037963	1042	1000	1039	45	6	7.5	997
FBgn0037964	1007	1000	987	27	9	3	980
FBgn0037976	1029	1000	879	179	6	29.833333333333332	850
FBgn0037978	1009	1000	961	57	4	14.25	952
FBgn0037979	1009	1000	948	70	5	14	939
FBgn0037980	1000	1000	948	52	2	26	948
FBgn0037981	1028	1000	1004	52	7	7.428571428571429	976
FBgn0037985	1009	1000	973	45	11	4.090909090909091	964
FBgn0037986	1016	1000	1013	19	5	3.8	997
FBgn0037987	1009	1000	983	35	7	5	974
FBgn0037989	1019	1000	1012	26	6	4.333333333333333	993
FBgn0037992	1075	1000	1056	94	8	11.75	981
FBgn0037993	1004	1000	985	23	6	3.8333333333333335	981
FBgn0037994	1055	1000	1053	57	5	11.4	998
FBgn0037995	1002	1000	980	24	5	4.8	978
FBgn0037996	1008	1000	1000	16	4	4	992
FBgn0037997	1029	1000	968	90	10	9	939
FBgn0037999	1015	1000	1008	22	9	2.4444444444444446	993
FBgn0038000	771	756	766	20	8	2.5	751
FBgn0038002	1004	1000	987	21	2	10.5	983
FBgn0038003	1000	1000	994	6	5	1.2	994
FBgn0038007	1005	1000	1002	8	4	2	997
FBgn0038008	1050	1000	1046	54	6	9	996
FBgn0038011	1012	1000	1006	18	6	3	994
FBgn0038016	1016	1000	959	73	8	9.125	943
FBgn0038017	1079	1000	1067	91	14	6.5	988
FBgn0038028	1034	1000	1022	46	7	6.571428571428571	988
FBgn0038029	1008	1000	1002	14	6	2.3333333333333335	994
FBgn0038037	1025	1000	887	163	9	18.11111111111111	862
FBgn0038043	1000	1000	826	174	2	87	826
FBgn0038045	1033	1000	1026	40	7	5.714285714285714	993
FBgn0038046	1003	1000	988	18	7	2.5714285714285716	985
FBgn0038047	1004	1000	1001	7	6	1.1666666666666667	997
FBgn0038049	1002	1000	966	38	6	6.333333333333333	964
FBgn0038056	1001	1000	996	6	3	2	995
FBgn0038057	1025	1000	1018	32	7	4.571428571428571	993
FBgn0038063	1064	1000	1038	90	10	9	974
FBgn0038065	1000	1000	988	12	2	6	988
FBgn0038070	1029	1000	1024	34	8	4.25	995
FBgn0038071	1031	1000	966	96	10	9.6	935
FBgn0038072	1015	1000	1013	17	5	3.4	998
FBgn0038073	1011	1000	999	23	6	3.8333333333333335	988
FBgn0038074	1009	994	997	27	11	2.4545454545454546	982
FBgn0038076	1062	1000	1035	89	9	9.88888888888889	973
FBgn0038078	1012	1000	1005	19	5	3.8	993
FBgn0038079	1014	1000	1012	16	6	2.6666666666666665	998
FBgn0038080	1008	1000	974	42	6	7	966
FBgn0038082	1039	1000	1006	72	7	10.285714285714286	967
FBgn0038083	1004	991	924	93	10	9.3	911
FBgn0038084	1003	1000	966	40	8	5	963
FBgn0038087	671	670	653	19	5	3.8	652
FBgn0038088	1000	1000	993	7	2	3.5	993
FBgn0038089	1000	1000	990	10	3	3.3333333333333335	990
FBgn0038090	1038	1000	1015	61	11	5.545454545454546	977
FBgn0038092	1026	1000	1010	42	6	7	984
FBgn0038095	802	749	747	108	15	7.2	694
FBgn0038098	1001	1000	987	15	3	5	986
FBgn0038099	1015	1000	988	42	7	6	973
FBgn0038102	1000	1000	1000	0	0	NA	1000
FBgn0038105	1016	1000	996	36	5	7.2	980
FBgn0038106	1019	1000	999	39	6	6.5	980
FBgn0038108	1022	1000	1010	34	10	3.4	988
FBgn0038109	1002	1000	1002	2	1	2	1000
FBgn0038110	1009	1000	997	21	6	3.5	988
FBgn0038114	1005	1000	984	26	3	8.666666666666666	979
FBgn0038115	1069	1000	1011	127	18	7.055555555555555	942
FBgn0038118	1005	1000	1005	5	2	2.5	1000
FBgn0038122	1000	1000	734	266	4	66.5	734
FBgn0038123	1018	1000	980	56	7	8	962
FBgn0038124	1018	1000	970	66	3	22	952
FBgn0038125	1045	1000	971	119	5	23.8	926
FBgn0038126	1029	1000	1023	35	8	4.375	994
FBgn0038127	1015	1000	877	153	8	19.125	862
FBgn0038128	1001	1000	963	39	7	5.571428571428571	962
FBgn0038129	1027	1000	1014	40	9	4.444444444444445	987
FBgn0038130	1014	1000	986	42	9	4.666666666666667	972
FBgn0038131	1025	1000	1004	46	8	5.75	979
FBgn0038132	1009	1000	944	74	11	6.7272727272727275	935
FBgn0038133	1001	1000	976	26	8	3.25	975
FBgn0038134	1013	1000	965	61	7	8.714285714285714	952
FBgn0038135	1034	1000	992	76	8	9.5	958
FBgn0038139	1018	1000	1005	31	6	5.166666666666667	987
FBgn0038140	1002	1000	992	12	5	2.4	990
FBgn0038143	1027	1000	994	60	10	6	967
FBgn0038144	1058	1000	1003	113	12	9.416666666666666	945
FBgn0038145	813	762	794	70	6	11.666666666666666	743
FBgn0038146	980	963	957	40	9	4.444444444444445	940
FBgn0038147	1046	1000	1024	68	9	7.555555555555555	978
FBgn0038151	1031	1000	1027	35	8	4.375	996
FBgn0038153	1007	1000	957	57	13	4.384615384615385	950
FBgn0038156	1025	1000	1009	41	4	10.25	984
FBgn0038157	1004	1000	966	42	6	7	962
FBgn0038158	1013	1000	986	40	9	4.444444444444445	973
FBgn0038159	1046	1000	1001	91	12	7.583333333333333	955
FBgn0038160	1037	1000	994	80	9	8.88888888888889	957
FBgn0038161	1042	1000	1026	58	11	5.2727272727272725	984
FBgn0038166	1009	1000	1009	9	1	9	1000
FBgn0038168	1006	1000	968	44	8	5.5	962
FBgn0038170	1003	1000	994	12	5	2.4	991
FBgn0038172	1061	1000	1060	62	14	4.428571428571429	999
FBgn0038173	1053	1000	1051	55	11	5	998
FBgn0038179	1038	1000	1006	70	9	7.777777777777778	968
FBgn0038181	968	966	930	40	7	5.714285714285714	928
FBgn0038183	1015	959	1010	61	12	5.083333333333333	954
FBgn0038186	1000	1000	977	23	5	4.6	977
FBgn0038188	1013	1000	958	68	10	6.8	945
FBgn0038189	1047	1000	999	95	12	7.916666666666667	952
FBgn0038190	1020	1000	991	49	12	4.083333333333333	971
FBgn0038191	1024	1000	609	439	6	73.16666666666667	585
FBgn0038194	1033	1000	921	145	13	11.153846153846153	888
FBgn0038195	976	944	959	49	8	6.125	927
FBgn0038196	1053	1000	958	148	24	6.166666666666667	905
FBgn0038197	1027	1000	1007	47	12	3.9166666666666665	980
FBgn0038198	1015	1000	993	37	10	3.7	978
FBgn0038200	1029	1000	1000	58	7	8.285714285714286	971
FBgn0038201	1002	1000	993	11	5	2.2	991
FBgn0038202	987	964	973	37	13	2.8461538461538463	950
FBgn0038203	1025	1000	1011	39	14	2.7857142857142856	986
FBgn0038205	1003	1000	997	9	6	1.5	994
FBgn0038206	1024	1000	1006	42	6	7	982
FBgn0038207	1023	1000	972	74	10	7.4	949
FBgn0038210	1051	1000	1011	91	12	7.583333333333333	960
FBgn0038213	1004	1000	974	34	9	3.7777777777777777	970
FBgn0038214	1015	1000	994	36	6	6	979
FBgn0038218	1005	1000	1002	8	3	2.6666666666666665	997
FBgn0038219	1024	1000	998	50	5	10	974
FBgn0038221	948	944	917	35	8	4.375	913
FBgn0038223	1008	1000	1008	8	2	4	1000
FBgn0038224	1005	1000	1003	7	2	3.5	998
FBgn0038225	1027	1000	966	88	8	11	939
FBgn0038233	992	984	992	8	4	2	984
FBgn0038234	1003	1000	995	11	3	3.6666666666666665	992
FBgn0038235	1012	1000	974	50	8	6.25	962
FBgn0038236	1017	1000	993	41	11	3.727272727272727	976
FBgn0038238	1026	1000	977	75	10	7.5	951
FBgn0038239	1029	1000	980	78	11	7.090909090909091	951
FBgn0038246	1015	1000	1009	21	8	2.625	994
FBgn0038247	1038	1000	1021	55	10	5.5	983
FBgn0038248	1007	1000	997	17	8	2.125	990
FBgn0038252	1010	1000	1001	19	3	6.333333333333333	991
FBgn0038256	1078	1000	1066	90	16	5.625	988
FBgn0038258	1018	1000	982	54	14	3.857142857142857	964
FBgn0038260	1006	1000	993	19	8	2.375	987
FBgn0038266	1065	1000	1022	108	12	9	957
FBgn0038268	1028	1000	992	64	10	6.4	964
FBgn0038269	1000	1000	884	116	3	38.666666666666664	884
FBgn0038271	1001	1000	1000	2	2	1	999
FBgn0038272	1028	1000	1014	42	12	3.5	986
FBgn0038273	1029	1000	1017	41	12	3.4166666666666665	988
FBgn0038274	1006	1000	768	244	3	81.33333333333333	762
FBgn0038275	1005	1000	930	80	6	13.333333333333334	925
FBgn0038277	1015	1000	948	82	12	6.833333333333333	933
FBgn0038279	1023	1000	985	61	12	5.083333333333333	962
FBgn0038280	1001	1000	988	14	4	3.5	987
FBgn0038281	1000	1000	964	36	4	9	964
FBgn0038282	1028	1000	979	77	7	11	951
FBgn0038286	1005	1000	992	18	5	3.6	987
FBgn0038291	1046	1000	1021	71	11	6.454545454545454	975
FBgn0038294	1005	1000	994	16	7	2.2857142857142856	989
FBgn0038295	1001	1000	988	14	6	2.3333333333333335	987
FBgn0038296	1033	1000	1026	40	7	5.714285714285714	993
FBgn0038299	1024	1000	996	52	7	7.428571428571429	972
FBgn0038300	1036	1000	974	98	15	6.533333333333333	938
FBgn0038301	1024	1000	1019	29	8	3.625	995
FBgn0038302	1022	1000	1018	26	7	3.7142857142857144	996
FBgn0038303	1024	1000	1005	43	9	4.777777777777778	981
FBgn0038304	1028	1000	1018	38	9	4.222222222222222	990
FBgn0038306	1018	1000	994	42	9	4.666666666666667	976
FBgn0038307	1018	1000	983	53	11	4.818181818181818	965
FBgn0038309	1051	1000	1034	68	9	7.555555555555555	983
FBgn0038311	1003	1000	997	9	5	1.8	994
FBgn0038312	1012	1000	991	33	8	4.125	979
FBgn0038313	1009	1000	992	26	4	6.5	983
FBgn0038315	1022	1000	980	64	11	5.818181818181818	958
FBgn0038316	1035	1000	1013	57	9	6.333333333333333	978
FBgn0038318	1018	1000	987	49	7	7	969
FBgn0038320	1008	1000	972	44	7	6.285714285714286	964
FBgn0038321	1029	1000	1023	35	11	3.1818181818181817	994
FBgn0038324	1000	1000	997	3	2	1.5	997
FBgn0038325	1011	1000	987	35	6	5.833333333333333	976
FBgn0038326	1014	1000	993	35	6	5.833333333333333	979
FBgn0038327	1000	1000	992	8	2	4	992
FBgn0038330	1004	1000	973	35	10	3.5	969
FBgn0038331	1002	1000	986	18	3	6	984
FBgn0038332	1001	1000	981	21	4	5.25	980
FBgn0038334	1009	1000	991	27	6	4.5	982
FBgn0038337	1000	1000	993	7	2	3.5	993
FBgn0038339	1012	1000	991	33	3	11	979
FBgn0038342	1071	1000	1030	112	10	11.2	959
FBgn0038343	1029	1000	1007	51	9	5.666666666666667	978
FBgn0038344	1043	1000	1018	68	11	6.181818181818182	975
FBgn0038345	1020	1000	923	117	4	29.25	903
FBgn0038350	1019	1000	1017	21	6	3.5	998
FBgn0038353	1018	1000	991	45	9	5	973
FBgn0038354	1016	1000	981	51	7	7.285714285714286	965
FBgn0038356	1003	1000	906	100	8	12.5	903
FBgn0038357	1026	1000	981	71	10	7.1	955
FBgn0038359	1020	1000	985	55	8	6.875	965
FBgn0038360	1051	1000	998	104	17	6.117647058823529	947
FBgn0038363	1009	1000	1009	9	1	9	1000
FBgn0038365	1023	1000	978	68	9	7.555555555555555	955
FBgn0038366	1008	1000	1007	9	3	3	999
FBgn0038371	1001	1000	865	137	4	34.25	864
FBgn0038373	1031	1000	1007	55	11	5	976
FBgn0038376	869	860	848	30	7	4.285714285714286	839
FBgn0038377	1000	1000	998	2	1	2	998
FBgn0038380	1015	1000	990	40	5	8	975
FBgn0038385	1017	1000	981	53	8	6.625	964
FBgn0038386	1006	1000	993	19	6	3.1666666666666665	987
FBgn0038387	1002	1000	952	52	4	13	950
FBgn0038388	939	939	938	1	1	1	938
FBgn0038389	1000	1000	999	1	1	1	999
FBgn0038390	797	797	795	2	2	1	795
FBgn0038391	1012	1000	1003	21	3	7	991
FBgn0038394	1016	1000	987	45	7	6.428571428571429	971
FBgn0038396	1024	1000	982	66	13	5.076923076923077	958
FBgn0038397	1019	1000	992	46	8	5.75	973
FBgn0038398	1020	1000	969	71	9	7.888888888888889	949
FBgn0038400	1010	1000	948	72	3	24	938
FBgn0038401	1032	1000	1019	45	6	7.5	987
FBgn0038402	1017	1000	1005	29	6	4.833333333333333	988
FBgn0038404	1000	1000	975	25	5	5	975
FBgn0038405	764	763	764	1	1	1	763
FBgn0038407	1027	1000	1027	27	4	6.75	1000
FBgn0038412	1012	1000	1000	24	8	3	988
FBgn0038414	1032	1000	999	65	5	13	967
FBgn0038418	1003	1000	996	10	4	2.5	993
FBgn0038419	1006	1000	991	21	3	7	985
FBgn0038420	1007	1000	1007	7	2	3.5	1000
FBgn0038422	1008	1000	1005	11	2	5.5	997
FBgn0038423	1003	1000	956	50	5	10	953
FBgn0038428	1013	1000	999	27	8	3.375	986
FBgn0038429	1011	1000	1001	21	5	4.2	990
FBgn0038431	1007	1000	944	70	12	5.833333333333333	937
FBgn0038435	1000	1000	950	50	2	25	950
FBgn0038436	1044	1000	1026	62	7	8.857142857142858	982
FBgn0038439	1010	1000	993	27	8	3.375	983
FBgn0038445	1010	1000	952	68	6	11.333333333333334	942
FBgn0038446	1052	1000	986	118	9	13.11111111111111	934
FBgn0038447	1009	1000	992	26	7	3.7142857142857144	983
FBgn0038449	1004	1000	970	38	10	3.8	966
FBgn0038450	894	869	884	35	10	3.5	859
FBgn0038451	1080	1000	938	222	24	9.25	858
FBgn0038453	1101	1000	980	222	20	11.1	879
FBgn0038454	1033	1000	1024	42	10	4.2	991
FBgn0038458	1011	1000	998	24	3	8	987
FBgn0038465	1031	1000	1015	47	5	9.4	984
FBgn0038466	1038	1000	981	95	14	6.785714285714286	943
FBgn0038467	1007	1000	940	74	10	7.4	933
FBgn0038468	794	791	785	12	5	2.4	782
FBgn0038470	1006	1000	949	63	13	4.846153846153846	943
FBgn0038471	1003	1000	946	60	13	4.615384615384615	943
FBgn0038472	1021	1000	982	60	10	6	961
FBgn0038473	1002	1000	993	11	3	3.6666666666666665	991
FBgn0038474	1000	1000	998	2	1	2	998
FBgn0038475	1019	1000	990	48	11	4.363636363636363	971
FBgn0038476	1005	1000	983	27	9	3	978
FBgn0038481	923	869	895	82	11	7.454545454545454	841
FBgn0038482	1002	1000	1002	2	1	2	1000
FBgn0038484	903	897	870	39	10	3.9	864
FBgn0038487	1040	1000	1019	61	13	4.6923076923076925	979
FBgn0038488	1003	1000	989	17	4	4.25	986
FBgn0038492	1015	1000	986	44	8	5.5	971
FBgn0038494	1001	1000	950	52	10	5.2	949
FBgn0038498	1028	1000	1022	34	6	5.666666666666667	994
FBgn0038508	1066	1000	818	314	14	22.428571428571427	752
FBgn0038509	1010	1000	1006	14	6	2.3333333333333335	996
FBgn0038510	1019	1000	998	40	6	6.666666666666667	979
FBgn0038511	1014	1000	997	31	10	3.1	983
FBgn0038512	1003	1000	580	426	5	85.2	577
FBgn0038515	1054	1000	976	132	15	8.8	922
FBgn0038516	1024	1000	987	61	7	8.714285714285714	963
FBgn0038519	1010	1000	979	41	9	4.555555555555555	969
FBgn0038523	1010	1000	996	24	6	4	986
FBgn0038524	1060	1000	1013	107	16	6.6875	953
FBgn0038525	1030	1000	1017	43	7	6.142857142857143	987
FBgn0038531	1000	1000	992	8	2	4	992
FBgn0038533	1050	1000	1037	63	7	9	987
FBgn0038535	1000	1000	998	2	2	1	998
FBgn0038536	1014	1000	1013	15	4	3.75	999
FBgn0038539	1072	1000	1047	97	16	6.0625	975
FBgn0038540	862	781	825	118	14	8.428571428571429	744
FBgn0038545	1024	1000	990	58	13	4.461538461538462	966
FBgn0038546	774	695	753	100	16	6.25	674
FBgn0038552	1038	1000	1027	49	9	5.444444444444445	989
FBgn0038558	1005	1000	840	170	5	34	835
FBgn0038566	1018	1000	976	60	11	5.454545454545454	958
FBgn0038567	1016	1000	989	43	9	4.777777777777778	973
FBgn0038569	1038	1000	1011	65	7	9.285714285714286	973
FBgn0038575	1009	1000	1008	10	2	5	999
FBgn0038576	1002	1000	986	18	7	2.5714285714285716	984
FBgn0038577	1002	1000	991	13	3	4.333333333333333	989
FBgn0038578	1000	1000	989	11	2	5.5	989
FBgn0038579	1019	1000	995	43	13	3.3076923076923075	976
FBgn0038582	1015	1000	1005	25	4	6.25	990
FBgn0038583	888	886	869	21	4	5.25	867
FBgn0038584	1002	1000	1002	2	1	2	1000
FBgn0038585	1005	1000	985	25	4	6.25	980
FBgn0038586	1009	1000	995	23	6	3.8333333333333335	986
FBgn0038588	1009	1000	991	27	12	2.25	982
FBgn0038589	1019	1000	991	47	7	6.714285714285714	972
FBgn0038592	1006	1000	984	28	9	3.111111111111111	978
FBgn0038593	1008	1000	1006	10	5	2	998
FBgn0038595	1021	1000	988	54	13	4.153846153846154	967
FBgn0038596	1003	1000	994	12	5	2.4	991
FBgn0038597	1008	1000	1006	10	5	2	998
FBgn0038598	801	801	797	4	3	1.3333333333333333	797
FBgn0038602	1001	1000	939	63	7	9	938
FBgn0038603	1025	1000	984	66	13	5.076923076923077	959
FBgn0038606	1043	1000	1013	73	9	8.11111111111111	970
FBgn0038607	833	800	780	86	7	12.285714285714286	747
FBgn0038610	781	770	734	58	12	4.833333333333333	723
FBgn0038613	821	819	805	18	4	4.5	803
FBgn0038617	1029	1000	1010	48	10	4.8	981
FBgn0038626	1023	1000	986	60	14	4.285714285714286	963
FBgn0038629	1014	1000	1004	24	10	2.4	990
FBgn0038632	1041	1000	998	84	12	7	957
FBgn0038640	1008	1000	1005	11	6	1.8333333333333333	997
FBgn0038643	1021	1000	978	64	12	5.333333333333333	957
FBgn0038645	1044	1000	1018	70	10	7	974
FBgn0038646	1009	1000	991	27	6	4.5	982
FBgn0038647	1007	1000	959	55	14	3.9285714285714284	952
FBgn0038649	1007	1000	951	63	9	7	944
FBgn0038653	1023	1000	954	92	12	7.666666666666667	931
FBgn0038654	1034	1000	1013	55	8	6.875	979
FBgn0038655	1044	1000	1021	67	9	7.444444444444445	977
FBgn0038658	1053	1000	1028	78	14	5.571428571428571	975
FBgn0038659	1053	1000	1030	76	13	5.846153846153846	977
FBgn0038660	1019	1000	961	77	21	3.6666666666666665	942
FBgn0038662	1043	1000	967	119	15	7.933333333333334	924
FBgn0038666	1002	1000	996	8	3	2.6666666666666665	994
FBgn0038672	1012	1000	967	57	8	7.125	955
FBgn0038673	1000	1000	987	13	2	6.5	987
FBgn0038675	1002	1000	968	36	7	5.142857142857143	966
FBgn0038676	1001	1000	892	110	3	36.666666666666664	891
FBgn0038678	1002	1000	957	47	7	6.714285714285714	955
FBgn0038680	1017	1000	1006	28	10	2.8	989
FBgn0038682	1013	1000	959	67	10	6.7	946
FBgn0038685	1054	1000	1048	60	13	4.615384615384615	994
FBgn0038686	1038	1000	1023	53	15	3.533333333333333	985
FBgn0038691	1004	1000	995	13	3	4.333333333333333	991
FBgn0038692	1000	1000	971	29	3	9.666666666666666	971
FBgn0038693	1028	1000	956	100	10	10	928
FBgn0038694	1033	1000	1016	50	7	7.142857142857143	983
FBgn0038695	1027	1000	979	75	14	5.357142857142857	952
FBgn0038702	1023	1000	900	146	12	12.166666666666666	877
FBgn0038705	1021	1000	940	102	10	10.2	919
FBgn0038706	1015	1000	992	38	9	4.222222222222222	977
FBgn0038709	1024	1000	977	71	13	5.461538461538462	953
FBgn0038714	1001	1000	998	4	4	1	997
FBgn0038715	1005	1000	995	15	4	3.75	990
FBgn0038716	791	778	769	35	8	4.375	756
FBgn0038717	1018	975	955	106	11	9.636363636363637	912
FBgn0038718	945	939	941	10	5	2	935
FBgn0038719	1011	1000	1005	17	5	3.4	994
FBgn0038720	1011	1000	971	51	10	5.1	960
FBgn0038721	808	785	777	54	11	4.909090909090909	754
FBgn0038722	1010	1000	976	44	11	4	966
FBgn0038725	1074	1000	1069	79	8	9.875	995
FBgn0038727	1026	1000	1023	29	6	4.833333333333333	997
FBgn0038732	1179	1000	1137	221	17	13	958
FBgn0038733	685	673	638	59	5	11.8	626
FBgn0038735	1073	1000	992	154	14	11	919
FBgn0038737	1002	1000	989	15	2	7.5	987
FBgn0038738	1023	1000	1013	33	10	3.3	990
FBgn0038739	1005	1000	996	14	5	2.8	991
FBgn0038741	1004	1000	988	20	5	4	984
FBgn0038742	1001	1000	1000	2	2	1	999
FBgn0038744	1031	1000	1005	57	11	5.181818181818182	974
FBgn0038746	1017	1000	965	69	5	13.8	948
FBgn0038747	1021	1000	992	50	5	10	971
FBgn0038750	1007	1000	1005	9	4	2.25	998
FBgn0038751	1007	1000	1005	9	4	2.25	998
FBgn0038752	1034	1000	1002	66	12	5.5	968
FBgn0038753	1011	1000	987	35	5	7	976
FBgn0038755	1007	1000	1002	12	7	1.7142857142857142	995
FBgn0038756	1017	1000	1008	26	7	3.7142857142857144	991
FBgn0038760	1007	1000	1002	12	7	1.7142857142857142	995
FBgn0038761	1003	1000	984	22	6	3.6666666666666665	981
FBgn0038763	1076	1000	1056	96	9	10.666666666666666	980
FBgn0038765	1003	1000	999	7	3	2.3333333333333335	996
FBgn0038766	1001	1000	990	12	4	3	989
FBgn0038767	1009	1000	955	63	16	3.9375	946
FBgn0038768	1013	1000	965	61	14	4.357142857142857	952
FBgn0038769	1008	1000	970	46	8	5.75	962
FBgn0038771	1010	1000	1005	15	6	2.5	995
FBgn0038772	1021	1000	1011	31	9	3.4444444444444446	990
FBgn0038774	1040	1000	1032	48	7	6.857142857142857	992
FBgn0038775	1015	1000	998	32	8	4	983
FBgn0038783	1000	1000	385	615	3	205	385
FBgn0038784	1018	1000	591	445	5	89	573
FBgn0038787	1012	1000	1006	18	6	3	994
FBgn0038788	1001	1000	999	3	3	1	998
FBgn0038789	1007	1000	964	50	6	8.333333333333334	957
FBgn0038796	1024	1000	1016	32	7	4.571428571428571	992
FBgn0038803	1020	1000	978	62	7	8.857142857142858	958
FBgn0038804	1003	1000	982	24	8	3	979
FBgn0038805	1011	1000	1011	11	1	11	1000
FBgn0038806	1000	1000	996	4	1	4	996
FBgn0038808	1001	1000	1001	1	1	1	1000
FBgn0038814	1015	1000	981	49	13	3.769230769230769	966
FBgn0038815	1015	1000	981	49	13	3.769230769230769	966
FBgn0038816	1022	1000	976	68	18	3.7777777777777777	954
FBgn0038818	1014	1000	812	216	8	27	798
FBgn0038819	1003	1000	957	49	2	24.5	954
FBgn0038820	1017	1000	996	38	5	7.6	979
FBgn0038821	1014	1000	994	34	6	5.666666666666667	980
FBgn0038826	1008	1000	994	22	7	3.142857142857143	986
FBgn0038827	919	887	909	42	6	7	877
FBgn0038829	1005	1000	1003	7	3	2.3333333333333335	998
FBgn0038830	922	900	661	283	5	56.6	639
FBgn0038832	1030	1000	968	92	9	10.222222222222221	938
FBgn0038833	1016	1000	966	66	7	9.428571428571429	950
FBgn0038834	1013	1000	706	320	6	53.333333333333336	693
FBgn0038839	1011	1000	1005	17	4	4.25	994
FBgn0038840	1020	1000	996	44	7	6.285714285714286	976
FBgn0038842	1047	1000	957	137	8	17.125	910
FBgn0038845	1003	1000	994	12	3	4	991
FBgn0038846	1008	1000	965	51	8	6.375	957
FBgn0038847	1018	1000	1001	35	5	7	983
FBgn0038849	1135	1000	1102	168	18	9.333333333333334	967
FBgn0038850	1008	1000	983	33	8	4.125	975
FBgn0038851	1020	1000	988	52	7	7.428571428571429	968
FBgn0038852	1020	1000	998	42	8	5.25	978
FBgn0038855	1010	1000	993	27	8	3.375	983
FBgn0038857	1011	1000	1006	16	8	2	995
FBgn0038858	1003	1000	1001	5	3	1.6666666666666667	998
FBgn0038859	1010	1000	952	68	11	6.181818181818182	942
FBgn0038860	1013	1000	967	59	12	4.916666666666667	954
FBgn0038861	1058	1000	1047	69	7	9.857142857142858	989
FBgn0038862	1062	1000	1056	68	7	9.714285714285714	994
FBgn0038865	1062	1000	1033	91	17	5.352941176470588	971
FBgn0038869	1008	1000	1007	9	4	2.25	999
FBgn0038870	1018	1000	1012	24	6	4	994
FBgn0038872	1029	1000	1029	29	2	14.5	1000
FBgn0038876	1005	1000	1004	6	3	2	999
FBgn0038878	1000	1000	992	8	3	2.6666666666666665	992
FBgn0038879	1016	1000	1000	32	5	6.4	984
FBgn0038880	1001	1000	999	3	2	1.5	998
FBgn0038881	1020	1000	973	67	9	7.444444444444445	953
FBgn0038886	1019	1000	976	62	9	6.888888888888889	957
FBgn0038887	1016	1000	1001	31	10	3.1	985
FBgn0038888	979	927	793	238	9	26.444444444444443	741
FBgn0038889	1044	1000	1033	55	7	7.857142857142857	989
FBgn0038892	1027	1000	984	70	7	10	957
FBgn0038893	1041	1000	1008	74	11	6.7272727272727275	967
FBgn0038894	1000	1000	990	10	4	2.5	990
FBgn0038897	1043	1000	1012	74	10	7.4	969
FBgn0038902	1001	1000	999	3	3	1	998
FBgn0038909	880	870	870	20	7	2.857142857142857	860
FBgn0038917	1054	1000	1016	92	13	7.076923076923077	962
FBgn0038918	1001	1000	980	22	4	5.5	979
FBgn0038921	1018	1000	952	84	12	7	934
FBgn0038923	1000	1000	999	1	1	1	999
FBgn0038925	1009	1000	967	51	6	8.5	958
FBgn0038926	862	859	854	11	2	5.5	851
FBgn0038929	1025	1000	1011	39	8	4.875	986
FBgn0038930	1076	1000	1059	93	11	8.454545454545455	983
FBgn0038931	1016	1000	981	51	10	5.1	965
FBgn0038941	1015	1000	1005	25	3	8.333333333333334	990
FBgn0038944	1050	982	1003	115	11	10.454545454545455	935
FBgn0038945	1007	1000	993	21	5	4.2	986
FBgn0038946	1007	1000	1001	13	5	2.6	994
FBgn0038948	1000	1000	518	482	1	482	518
FBgn0038951	1002	1000	955	49	4	12.25	953
FBgn0038956	1011	1000	1002	20	8	2.5	991
FBgn0038957	1072	1000	1042	102	16	6.375	970
FBgn0038958	1000	1000	1000	0	0	NA	1000
FBgn0038959	1014	1000	1011	17	6	2.8333333333333335	997
FBgn0038964	1016	1000	1006	26	6	4.333333333333333	990
FBgn0038965	1000	1000	1000	0	0	NA	1000
FBgn0038967	1010	1000	1005	15	8	1.875	995
FBgn0038972	952	944	939	21	6	3.5	931
FBgn0038974	1004	1000	1004	4	2	2	1000
FBgn0038975	1004	1000	1002	6	3	2	998
FBgn0038976	1001	1000	999	3	2	1.5	998
FBgn0038980	1027	1000	1016	38	8	4.75	989
FBgn0038983	1034	1000	1025	43	10	4.3	991
FBgn0038984	1002	1000	998	6	5	1.2	996
FBgn0038989	1001	1000	996	6	2	3	995
FBgn0038993	1054	1000	1054	54	6	9	1000
FBgn0039002	1004	1000	997	11	5	2.2	993
FBgn0039003	1000	1000	997	3	1	3	997
FBgn0039004	1000	1000	1000	0	0	NA	1000
FBgn0039007	1002	1000	976	28	7	4	974
FBgn0039010	967	953	961	20	4	5	947
FBgn0039013	1046	1000	1031	61	14	4.357142857142857	985
FBgn0039016	1013	1000	993	33	4	8.25	980
FBgn0039017	1000	1000	997	3	1	3	997
FBgn0039019	1000	1000	997	3	1	3	997
FBgn0039024	998	997	988	11	5	2.2	987
FBgn0039027	1001	1000	952	50	7	7.142857142857143	951
FBgn0039028	1070	1000	1050	90	11	8.181818181818182	980
FBgn0039029	1022	1000	1019	25	6	4.166666666666667	997
FBgn0039031	1022	1000	1014	30	5	6	992
FBgn0039033	1000	1000	997	3	1	3	997
FBgn0039034	799	791	780	27	6	4.5	772
FBgn0039038	1000	1000	876	124	7	17.714285714285715	876
FBgn0039039	1008	1000	971	45	9	5	963
FBgn0039040	1063	1000	987	139	23	6.043478260869565	924
FBgn0039041	907	900	888	26	11	2.3636363636363638	881
FBgn0039042	1020	1000	960	80	11	7.2727272727272725	940
FBgn0039043	1035	1000	1011	59	7	8.428571428571429	976
FBgn0039048	1023	1000	981	65	12	5.416666666666667	958
FBgn0039051	843	840	806	40	7	5.714285714285714	803
FBgn0039054	1018	1000	1005	31	8	3.875	987
FBgn0039055	1021	1000	1021	21	5	4.2	1000
FBgn0039056	1014	1000	1005	23	6	3.8333333333333335	991
FBgn0039058	1091	1000	1059	123	10	12.3	968
FBgn0039059	1020	1000	980	60	13	4.615384615384615	960
FBgn0039064	688	688	670	18	6	3	670
FBgn0039065	1000	1000	979	21	4	5.25	979
FBgn0039066	1038	1000	999	77	10	7.7	961
FBgn0039067	1035	1000	1032	38	10	3.8	997
FBgn0039068	1028	1000	1024	32	6	5.333333333333333	996
FBgn0039071	1014	1000	989	39	9	4.333333333333333	975
FBgn0039073	1041	1000	1009	73	12	6.083333333333333	968
FBgn0039075	1012	1000	920	104	14	7.428571428571429	908
FBgn0039077	1000	1000	1000	0	0	NA	1000
FBgn0039078	1004	1000	1001	7	3	2.3333333333333335	997
FBgn0039080	1001	1000	996	6	4	1.5	995
FBgn0039081	762	762	753	9	1	9	753
FBgn0039083	1028	1000	970	86	13	6.615384615384615	942
FBgn0039084	1032	1000	1003	61	11	5.545454545454546	971
FBgn0039087	1003	1000	995	11	7	1.5714285714285714	992
FBgn0039088	1039	1000	1015	63	10	6.3	976
FBgn0039089	1070	1000	1065	75	11	6.818181818181818	995
FBgn0039093	1024	1000	993	55	7	7.857142857142857	969
FBgn0039094	1007	1000	985	29	10	2.9	978
FBgn0039098	1029	1000	911	147	17	8.647058823529411	882
FBgn0039106	1022	1000	1004	40	10	4	982
FBgn0039108	1000	1000	519	481	6	80.16666666666667	519
FBgn0039109	1026	1000	931	121	13	9.307692307692308	905
FBgn0039110	1001	1000	1001	1	1	1	1000
FBgn0039111	1034	1000	1031	37	3	12.333333333333334	997
FBgn0039113	1012	1000	1009	15	4	3.75	997
FBgn0039114	1012	1000	1007	17	5	3.4	995
FBgn0039115	1016	1000	1001	31	6	5.166666666666667	985
FBgn0039116	1016	1000	959	73	9	8.11111111111111	943
FBgn0039120	1006	1000	1000	12	3	4	994
FBgn0039126	733	729	722	15	3	5	718
FBgn0039128	1001	1000	999	3	3	1	998
FBgn0039129	1000	1000	981	19	3	6.333333333333333	981
FBgn0039130	1000	1000	984	16	3	5.333333333333333	984
FBgn0039131	1012	1000	998	26	7	3.7142857142857144	986
FBgn0039135	1000	1000	1000	0	0	NA	1000
FBgn0039136	1013	1000	1007	19	6	3.1666666666666665	994
FBgn0039137	1022	1000	1011	33	4	8.25	989
FBgn0039139	1006	1000	993	19	4	4.75	987
FBgn0039140	1021	1000	1010	32	4	8	989
FBgn0039141	1013	1000	1012	14	3	4.666666666666667	999
FBgn0039147	1014	1000	1003	25	5	5	989
FBgn0039149	1003	1000	982	24	5	4.8	979
FBgn0039151	1039	1000	1030	48	11	4.363636363636363	991
FBgn0039153	1000	1000	999	1	1	1	999
FBgn0039156	1004	1000	997	11	6	1.8333333333333333	993
FBgn0039157	1013	1000	1003	23	5	4.6	990
FBgn0039158	1018	1000	1011	25	6	4.166666666666667	993
FBgn0039159	1011	1000	996	26	8	3.25	985
FBgn0039160	1014	1000	1013	15	3	5	999
FBgn0039161	1000	1000	988	12	3	4	988
FBgn0039165	1027	1000	1017	37	9	4.111111111111111	990
FBgn0039169	1020	1000	1020	20	3	6.666666666666667	1000
FBgn0039170	1000	1000	1000	0	0	NA	1000
FBgn0039178	1026	1000	967	85	16	5.3125	941
FBgn0039180	1021	1000	1006	36	9	4	985
FBgn0039182	1005	1000	1005	5	1	5	1000
FBgn0039183	1000	1000	995	5	1	5	995
FBgn0039186	1001	1000	1001	1	1	1	1000
FBgn0039187	1000	1000	997	3	1	3	997
FBgn0039189	776	746	551	255	10	25.5	521
FBgn0039190	1000	1000	998	2	2	1	998
FBgn0039192	1011	1000	1009	13	2	6.5	998
FBgn0039193	1012	1000	1007	17	4	4.25	995
FBgn0039195	728	728	710	18	4	4.5	710
FBgn0039196	1011	1000	635	387	6	64.5	624
FBgn0039197	1012	1000	998	26	8	3.25	986
FBgn0039198	1003	1000	992	14	3	4.666666666666667	989
FBgn0039199	1007	1000	988	26	4	6.5	981
FBgn0039200	1014	1000	1005	23	6	3.8333333333333335	991
FBgn0039201	1001	1000	1000	2	2	1	999
FBgn0039205	1000	1000	995	5	3	1.6666666666666667	995
FBgn0039210	1011	1000	979	43	8	5.375	968
FBgn0039213	1000	1000	1000	0	0	NA	1000
FBgn0039214	1006	1000	1004	8	5	1.6	998
FBgn0039215	1007	1000	1006	8	3	2.6666666666666665	999
FBgn0039219	1014	1000	984	44	9	4.888888888888889	970
FBgn0039223	946	928	943	21	7	3	925
FBgn0039224	1059	1000	1018	100	15	6.666666666666667	959
FBgn0039225	1018	1000	1012	24	7	3.4285714285714284	994
FBgn0039228	1000	1000	986	14	1	14	986
FBgn0039232	1028	1000	1004	52	6	8.666666666666666	976
FBgn0039237	1034	1000	1025	43	7	6.142857142857143	991
FBgn0039238	1043	1000	1033	53	9	5.888888888888889	990
FBgn0039239	1017	1000	998	36	3	12	981
FBgn0039240	1024	1000	1002	46	6	7.666666666666667	978
FBgn0039244	1017	1000	1002	32	6	5.333333333333333	985
FBgn0039246	1024	1000	1018	30	6	5	994
FBgn0039249	1005	1000	981	29	6	4.833333333333333	976
FBgn0039254	1001	1000	987	15	3	5	986
FBgn0039257	1073	1000	1051	95	11	8.636363636363637	978
FBgn0039258	1012	1000	972	52	5	10.4	960
FBgn0039259	1023	1000	1021	25	5	5	998
FBgn0039260	1011	1000	991	31	5	6.2	980
FBgn0039261	1002	1000	991	13	4	3.25	989
FBgn0039264	1023	1000	1006	40	8	5	983
FBgn0039269	1006	1000	995	17	3	5.666666666666667	989
FBgn0039270	1000	1000	991	9	3	3	991
FBgn0039271	1001	1000	1000	2	2	1	999
FBgn0039273	1002	1000	935	69	9	7.666666666666667	933
FBgn0039274	1019	1000	999	39	6	6.5	980
FBgn0039277	691	691	679	12	3	4	679
FBgn0039286	1018	1000	987	49	7	7	969
FBgn0039288	1009	1000	876	142	5	28.4	867
FBgn0039290	1025	1000	1003	47	10	4.7	978
FBgn0039291	1075	1000	1055	95	13	7.3076923076923075	980
FBgn0039294	1011	1000	970	52	5	10.4	959
FBgn0039296	1036	1000	987	85	12	7.083333333333333	951
FBgn0039297	1074	1000	998	150	15	10	924
FBgn0039298	1010	1000	917	103	9	11.444444444444445	907
FBgn0039299	876	844	847	61	9	6.777777777777778	815
FBgn0039300	1004	1000	648	360	3	120	644
FBgn0039301	1006	1000	981	31	7	4.428571428571429	975
FBgn0039304	860	839	854	27	4	6.75	833
FBgn0039306	1000	1000	990	10	2	5	990
FBgn0039310	905	848	900	62	7	8.857142857142858	843
FBgn0039311	1006	1000	950	62	5	12.4	944
FBgn0039312	1054	1000	1039	69	12	5.75	985
FBgn0039313	1044	1000	1031	57	13	4.384615384615385	987
FBgn0039319	1081	1000	1045	117	15	7.8	964
FBgn0039321	1025	1000	1021	29	5	5.8	996
FBgn0039325	1013	1000	975	51	12	4.25	962
FBgn0039329	1000	1000	1000	0	0	NA	1000
FBgn0039331	1001	1000	989	13	2	6.5	988
FBgn0039335	1051	1000	1045	57	7	8.142857142857142	994
FBgn0039336	1005	1000	974	36	4	9	969
FBgn0039337	1001	1000	1001	1	1	1	1000
FBgn0039338	1005	1000	973	37	5	7.4	968
FBgn0039341	1042	1000	1000	84	16	5.25	958
FBgn0039342	713	712	681	33	9	3.6666666666666665	680
FBgn0039344	1023	1000	1013	33	7	4.714285714285714	990
FBgn0039346	1023	1000	1012	34	9	3.7777777777777777	989
FBgn0039347	1037	1000	1011	63	12	5.25	974
FBgn0039349	1001	1000	996	6	5	1.2	995
FBgn0039350	1016	1000	940	92	13	7.076923076923077	924
FBgn0039354	1010	1000	1002	18	5	3.6	992
FBgn0039355	684	683	683	2	2	1	682
FBgn0039356	1012	1000	1008	16	4	4	996
FBgn0039357	1001	1000	996	6	3	2	995
FBgn0039358	1005	1000	1004	6	4	1.5	999
FBgn0039370	1045	1000	1044	46	6	7.666666666666667	999
FBgn0039371	829	812	762	84	10	8.4	745
FBgn0039373	1034	1000	1000	68	7	9.714285714285714	966
FBgn0039376	1003	1000	999	7	5	1.4	996
FBgn0039378	1064	1000	1019	109	14	7.785714285714286	955
FBgn0039379	1006	1000	993	19	3	6.333333333333333	987
FBgn0039380	1067	1000	1025	109	8	13.625	958
FBgn0039385	1039	1000	1027	51	5	10.2	988
FBgn0039395	1018	1000	1018	18	3	6	1000
FBgn0039396	1002	1000	955	49	6	8.166666666666666	953
FBgn0039398	1003	1000	885	121	5	24.2	882
FBgn0039403	1000	1000	1000	0	0	NA	1000
FBgn0039404	1000	1000	992	8	4	2	992
FBgn0039406	1002	1000	1002	2	2	1	1000
FBgn0039407	1002	1000	1001	3	2	1.5	999
FBgn0039408	1027	1000	1001	53	9	5.888888888888889	974
FBgn0039411	1043	1000	1030	56	9	6.222222222222222	987
FBgn0039415	1004	1000	964	44	5	8.8	960
FBgn0039420	1009	1000	1005	13	5	2.6	996
FBgn0039421	1000	1000	1000	0	0	NA	1000
FBgn0039424	1026	1000	1025	27	5	5.4	999
FBgn0039425	1004	1000	998	10	4	2.5	994
FBgn0039428	1012	1000	996	28	10	2.8	984
FBgn0039429	1013	1000	945	81	11	7.363636363636363	932
FBgn0039431	1036	1000	983	89	14	6.357142857142857	947
FBgn0039434	1013	1000	974	52	8	6.5	961
FBgn0039435	1000	1000	999	1	1	1	999
FBgn0039436	1027	1000	1025	29	3	9.666666666666666	998
FBgn0039438	1022	1000	982	62	13	4.769230769230769	960
FBgn0039439	1001	1000	995	7	2	3.5	994
FBgn0039440	1007	1000	1007	7	2	3.5	1000
FBgn0039441	1009	1000	1002	16	5	3.2	993
FBgn0039443	773	770	769	7	3	2.3333333333333335	766
FBgn0039444	1021	1000	1014	28	4	7	993
FBgn0039448	1003	1000	988	18	6	3	985
FBgn0039449	1035	1000	994	76	9	8.444444444444445	959
FBgn0039450	1040	1000	999	81	12	6.75	959
FBgn0039451	1015	1000	986	44	10	4.4	971
FBgn0039453	1008	1000	989	27	5	5.4	981
FBgn0039454	1016	1000	1012	20	4	5	996
FBgn0039459	1031	1000	1026	36	10	3.6	995
FBgn0039462	1000	1000	887	113	8	14.125	887
FBgn0039464	1039	1000	1038	40	6	6.666666666666667	999
FBgn0039466	1005	1000	987	23	3	7.666666666666667	982
FBgn0039469	1000	1000	932	68	8	8.5	932
FBgn0039474	727	721	697	36	6	6	691
FBgn0039475	1044	1000	1026	62	11	5.636363636363637	982
FBgn0039478	1002	1000	973	31	9	3.4444444444444446	971
FBgn0039479	1016	1000	969	63	11	5.7272727272727275	953
FBgn0039480	1005	1000	945	65	10	6.5	940
FBgn0039481	1011	1000	1004	18	7	2.5714285714285716	993
FBgn0039482	1041	1000	1028	54	6	9	987
FBgn0039485	1045	1000	998	92	11	8.363636363636363	953
FBgn0039486	1033	1000	1019	47	12	3.9166666666666665	986
FBgn0039488	1001	1000	1001	1	1	1	1000
FBgn0039489	1001	1000	1001	1	1	1	1000
FBgn0039491	957	954	954	6	3	2	951
FBgn0039494	1016	1000	1011	21	7	3	995
FBgn0039495	1047	1000	1021	73	14	5.214285714285714	974
FBgn0039503	1000	1000	999	1	1	1	999
FBgn0039504	1024	1000	1017	31	3	10.333333333333334	993
FBgn0039505	1003	1000	975	31	7	4.428571428571429	972
FBgn0039507	1076	1000	1064	88	15	5.866666666666666	988
FBgn0039508	1076	1000	1064	88	15	5.866666666666666	988
FBgn0039509	1031	1000	1030	32	5	6.4	999
FBgn0039510	1006	1000	947	65	4	16.25	941
FBgn0039511	1035	1000	989	81	8	10.125	954
FBgn0039518	1005	1000	901	109	9	12.11111111111111	896
FBgn0039519	1028	1000	995	61	11	5.545454545454546	967
FBgn0039520	1016	1000	962	70	5	14	946
FBgn0039522	1022	1000	977	67	8	8.375	955
FBgn0039527	1017	1000	982	52	10	5.2	965
FBgn0039528	1033	1000	1005	61	14	4.357142857142857	972
FBgn0039529	1020	1000	965	75	10	7.5	945
FBgn0039530	1031	1000	1009	53	11	4.818181818181818	978
FBgn0039531	1011	1000	1003	19	7	2.7142857142857144	992
FBgn0039532	1002	1000	975	29	4	7.25	973
FBgn0039536	1019	1000	982	56	6	9.333333333333334	963
FBgn0039543	1000	1000	976	24	4	6	976
FBgn0039544	1000	1000	972	28	5	5.6	972
FBgn0039554	1003	1000	842	164	4	41	839
FBgn0039555	1035	1000	983	87	8	10.875	948
FBgn0039558	1026	1000	997	55	9	6.111111111111111	971
FBgn0039559	1052	1000	1028	76	11	6.909090909090909	976
FBgn0039560	1047	1000	1026	68	7	9.714285714285714	979
FBgn0039561	1019	1000	1003	35	9	3.888888888888889	984
FBgn0039562	1029	1000	1025	33	7	4.714285714285714	996
FBgn0039563	1020	1000	983	57	10	5.7	963
FBgn0039564	1020	1000	1005	35	10	3.5	985
FBgn0039568	1020	1000	989	51	9	5.666666666666667	969
FBgn0039577	1011	1000	1005	17	4	4.25	994
FBgn0039581	1005	1000	999	11	6	1.8333333333333333	994
FBgn0039582	1000	1000	996	4	2	2	996
FBgn0039584	1009	1000	1001	17	3	5.666666666666667	992
FBgn0039585	1038	1000	917	159	5	31.8	879
FBgn0039588	1030	1000	1006	54	10	5.4	976
FBgn0039590	1002	1000	365	639	3	213	363
FBgn0039592	1006	1000	993	19	5	3.8	987
FBgn0039594	1001	1000	952	50	6	8.333333333333334	951
FBgn0039595	1013	1000	1005	21	6	3.5	992
FBgn0039596	1002	1000	995	9	3	3	993
FBgn0039600	1019	1000	949	89	7	12.714285714285714	930
FBgn0039601	1010	1000	1000	20	7	2.857142857142857	990
FBgn0039602	1010	1000	997	23	8	2.875	987
FBgn0039609	1011	1000	1010	12	2	6	999
FBgn0039613	1004	1000	976	32	6	5.333333333333333	972
FBgn0039616	1013	1000	980	46	9	5.111111111111111	967
FBgn0039617	1020	1000	998	42	7	6	978
FBgn0039620	887	877	831	66	8	8.25	821
FBgn0039621	755	753	746	11	2	5.5	744
FBgn0039622	1000	1000	999	1	1	1	999
FBgn0039625	1002	1000	983	21	5	4.2	981
FBgn0039626	1007	1000	1000	14	4	3.5	993
FBgn0039627	1001	1000	956	46	4	11.5	955
FBgn0039632	1001	1000	998	4	4	1	997
FBgn0039633	1002	1000	1001	3	3	1	999
FBgn0039634	1003	1000	951	55	7	7.857142857142857	948
FBgn0039635	1011	1000	950	72	6	12	939
FBgn0039637	1001	1000	984	18	3	6	983
FBgn0039638	1000	1000	993	7	5	1.4	993
FBgn0039639	1005	1000	1000	10	4	2.5	995
FBgn0039640	975	975	970	5	2	2.5	970
FBgn0039644	1012	1000	933	91	11	8.272727272727273	921
FBgn0039645	1028	1000	1025	31	4	7.75	997
FBgn0039647	1072	1000	1044	100	11	9.090909090909092	972
FBgn0039648	1000	1000	965	35	5	7	965
FBgn0039651	1000	1000	975	25	6	4.166666666666667	975
FBgn0039654	1011	1000	958	64	3	21.333333333333332	947
FBgn0039655	1012	1000	969	55	7	7.857142857142857	957
FBgn0039659	1010	1000	992	28	6	4.666666666666667	982
FBgn0039663	1014	1000	1004	24	4	6	990
FBgn0039664	1022	1000	1014	30	4	7.5	992
FBgn0039665	1086	1000	1085	87	12	7.25	999
FBgn0039666	1078	1000	1046	110	13	8.461538461538462	968
FBgn0039668	1027	1000	912	142	12	11.833333333333334	885
FBgn0039669	1020	1000	972	68	9	7.555555555555555	952
FBgn0039670	1019	965	901	172	21	8.19047619047619	847
FBgn0039673	1045	1000	1040	50	8	6.25	995
FBgn0039674	1000	1000	964	36	5	7.2	964
FBgn0039675	1009	1000	989	29	6	4.833333333333333	980
FBgn0039676	1015	1000	1009	21	3	7	994
FBgn0039677	1000	1000	993	7	3	2.3333333333333335	993
FBgn0039680	1001	1000	996	6	4	1.5	995
FBgn0039681	1022	1000	998	46	10	4.6	976
FBgn0039682	1000	1000	963	37	5	7.4	963
FBgn0039683	1046	1000	1024	68	8	8.5	978
FBgn0039684	1048	1000	1031	65	12	5.416666666666667	983
FBgn0039685	1005	1000	978	32	8	4	973
FBgn0039686	1001	1000	976	26	5	5.2	975
FBgn0039687	1005	1000	1005	5	1	5	1000
FBgn0039689	1000	1000	985	15	4	3.75	985
FBgn0039691	1000	1000	984	16	3	5.333333333333333	984
FBgn0039694	1062	1000	1033	91	19	4.7894736842105265	971
FBgn0039696	1032	1000	1019	45	6	7.5	987
FBgn0039697	1001	1000	1001	1	1	1	1000
FBgn0039698	1000	1000	999	1	1	1	999
FBgn0039703	1015	1000	979	51	12	4.25	964
FBgn0039704	1019	1000	987	51	9	5.666666666666667	968
FBgn0039709	1041	1000	1009	73	10	7.3	968
FBgn0039712	1000	1000	964	36	4	9	964
FBgn0039713	1003	1000	1002	4	2	2	999
FBgn0039714	1013	1000	1005	21	6	3.5	992
FBgn0039718	1034	1000	991	77	17	4.529411764705882	957
FBgn0039719	1023	1000	1011	35	6	5.833333333333333	988
FBgn0039722	1004	1000	972	36	4	9	968
FBgn0039726	1000	1000	986	14	2	7	986
FBgn0039727	1000	1000	976	24	3	8	976
FBgn0039728	1064	1000	1015	113	14	8.071428571428571	951
FBgn0039730	1000	1000	1000	0	0	NA	1000
FBgn0039731	1005	1000	1002	8	3	2.6666666666666665	997
FBgn0039732	1000	1000	1000	0	0	NA	1000
FBgn0039733	943	943	938	5	2	2.5	938
FBgn0039735	1003	1000	964	42	8	5.25	961
FBgn0039736	1004	1000	1000	8	2	4	996
FBgn0039737	1002	1000	987	17	5	3.4	985
FBgn0039739	1007	1000	1006	8	4	2	999
FBgn0039741	1006	1000	1002	10	3	3.3333333333333335	996
FBgn0039742	1000	1000	968	32	4	8	968
FBgn0039747	1028	1000	1020	36	6	6	992
FBgn0039749	1043	1000	1031	55	8	6.875	988
FBgn0039751	1001	1000	977	25	7	3.5714285714285716	976
FBgn0039752	1005	1000	993	17	6	2.8333333333333335	988
FBgn0039754	1012	1000	1001	23	8	2.875	989
FBgn0039756	1019	1000	988	50	5	10	969
FBgn0039757	1064	1000	1054	74	12	6.166666666666667	990
FBgn0039758	814	793	778	57	9	6.333333333333333	757
FBgn0039759	1034	1000	1006	62	11	5.636363636363637	972
FBgn0039765	1011	1000	985	37	6	6.166666666666667	974
FBgn0039766	901	896	869	37	8	4.625	864
FBgn0039767	1028	1000	1023	33	7	4.714285714285714	995
FBgn0039768	1028	1000	1025	31	7	4.428571428571429	997
FBgn0039769	850	803	848	49	8	6.125	801
FBgn0039771	1006	1000	986	26	4	6.5	980
FBgn0039773	1093	1000	1003	183	17	10.764705882352942	910
FBgn0039774	1023	1000	967	79	5	15.8	944
FBgn0039780	898	894	866	36	4	9	862
FBgn0039782	1009	1000	992	26	7	3.7142857142857144	983
FBgn0039787	1011	1000	1008	14	4	3.5	997
FBgn0039788	935	850	925	95	12	7.916666666666667	840
FBgn0039789	1046	1000	1027	65	8	8.125	981
FBgn0039792	1007	1000	978	36	6	6	971
FBgn0039795	1007	1000	1005	9	4	2.25	998
FBgn0039797	1029	1000	974	84	12	7	945
FBgn0039798	1024	1000	989	59	11	5.363636363636363	965
FBgn0039799	1000	1000	993	7	3	2.3333333333333335	993
FBgn0039802	1019	1000	1000	38	10	3.8	981
FBgn0039804	1029	1000	1011	47	12	3.9166666666666665	982
FBgn0039805	1038	1000	1019	57	7	8.142857142857142	981
FBgn0039806	1032	1000	1000	64	11	5.818181818181818	968
FBgn0039807	1024	1000	926	122	14	8.714285714285714	902
FBgn0039808	1031	1000	990	72	11	6.545454545454546	959
FBgn0039811	1034	1000	1013	55	12	4.583333333333333	979
FBgn0039812	1015	1000	989	41	6	6.833333333333333	974
FBgn0039816	1014	1000	995	33	6	5.5	981
FBgn0039817	1012	1000	966	58	12	4.833333333333333	954
FBgn0039818	1034	1000	1009	59	9	6.555555555555555	975
FBgn0039820	1023	1000	1010	36	5	7.2	987
FBgn0039821	1006	1000	992	20	8	2.5	986
FBgn0039828	1010	1000	1000	20	3	6.666666666666667	990
FBgn0039829	1012	1000	994	30	6	5	982
FBgn0039830	1024	1000	961	87	15	5.8	937
FBgn0039831	1024	1000	961	87	15	5.8	937
FBgn0039833	1009	1000	998	20	5	4	989
FBgn0039835	1004	1000	1003	5	3	1.6666666666666667	999
FBgn0039836	1026	1000	1016	36	6	6	990
FBgn0039838	1008	1000	936	80	12	6.666666666666667	928
FBgn0039839	1000	1000	983	17	3	5.666666666666667	983
FBgn0039840	1026	1000	996	56	12	4.666666666666667	970
FBgn0039844	1014	1000	989	39	16	2.4375	975
FBgn0039846	1014	1000	1012	16	5	3.2	998
FBgn0039849	1003	1000	989	17	5	3.4	986
FBgn0039850	1007	1000	986	28	9	3.111111111111111	979
FBgn0039852	1033	1000	1028	38	5	7.6	995
FBgn0039856	684	684	674	10	3	3.3333333333333335	674
FBgn0039857	1038	1000	1022	54	7	7.714285714285714	984
FBgn0039858	1003	1000	993	13	4	3.25	990
FBgn0039859	1016	1000	1009	23	4	5.75	993
FBgn0039860	1005	1000	993	17	6	2.8333333333333335	988
FBgn0039863	1014	1000	981	47	9	5.222222222222222	967
FBgn0039864	715	715	703	12	4	3	703
FBgn0039867	1000	1000	992	8	1	8	992
FBgn0039868	1005	1000	1005	5	1	5	1000
FBgn0039869	1000	1000	1000	0	0	NA	1000
FBgn0039872	735	728	692	50	5	10	685
FBgn0039875	1006	1000	991	21	6	3.5	985
FBgn0039876	1011	1000	989	33	12	2.75	978
FBgn0039877	1004	1000	965	43	9	4.777777777777778	961
FBgn0039879	1019	1000	990	48	7	6.857142857142857	971
FBgn0039881	1000	1000	992	8	3	2.6666666666666665	992
FBgn0039882	809	807	804	7	4	1.75	802
FBgn0039883	1028	1000	1019	37	6	6.166666666666667	991
FBgn0039902	1026	1000	653	399	11	36.27272727272727	627
FBgn0039904	1018	1000	401	635	5	127	383
FBgn0039907	1041	1000	566	516	15	34.4	525
FBgn0039908	1017	1000	978	56	11	5.090909090909091	961
FBgn0039909	1011	1000	886	136	12	11.333333333333334	875
FBgn0039911	1000	1000	29	971	2	485.5	29
FBgn0039920	1013	1000	315	711	6	118.5	302
FBgn0039928	1071	1000	1027	115	21	5.476190476190476	956
FBgn0039929	1027	1000	937	117	18	6.5	910
FBgn0039936	1000	1000	70	930	2	465	70
FBgn0039938	1010	1000	591	429	10	42.9	581
FBgn0039941	1028	1000	749	307	12	25.583333333333332	721
FBgn0039942	1043	1000	1042	44	4	11	999
FBgn0039943	1005	1000	972	38	8	4.75	967
FBgn0039944	1105	1000	1041	169	18	9.38888888888889	936
FBgn0039965	1010	1000	978	42	6	7	968
FBgn0039966	1014	1000	986	42	4	10.5	972
FBgn0039970	1093	1000	567	619	15	41.266666666666666	474
FBgn0040007	1000	1000	271	729	3	243	271
FBgn0040011	1008	1000	516	500	11	45.45454545454545	508
FBgn0040031	1034	1000	974	94	18	5.222222222222222	940
FBgn0040063	1044	1000	1030	58	9	6.444444444444445	986
FBgn0040066	1010	1000	986	34	5	6.8	976
FBgn0040068	1050	1000	1027	73	10	7.3	977
FBgn0040069	1045	1000	997	93	16	5.8125	952
FBgn0040071	1027	1000	996	58	14	4.142857142857143	969
FBgn0040075	1094	1000	1077	111	10	11.1	983
FBgn0040078	1001	1000	998	4	3	1.3333333333333333	997
FBgn0040079	1031	1000	1018	44	8	5.5	987
FBgn0040080	1058	1000	1051	65	9	7.222222222222222	993
FBgn0040087	1005	1000	996	14	7	2	991
FBgn0040089	1019	1000	914	124	8	15.5	895
FBgn0040091	1010	1000	987	33	9	3.6666666666666665	977
FBgn0040092	1006	1000	992	20	6	3.3333333333333335	986
FBgn0040093	806	764	794	54	8	6.75	752
FBgn0040097	1058	1000	1036	80	8	10	978
FBgn0040099	1046	1000	868	224	7	32	822
FBgn0040102	1007	1000	1006	8	5	1.6	999
FBgn0040106	1012	1000	915	109	8	13.625	903
FBgn0040107	989	951	970	57	8	7.125	932
FBgn0040153	1051	1000	1036	66	9	7.333333333333333	985
FBgn0040207	1003	1000	1001	5	3	1.6666666666666667	998
FBgn0040208	1024	1000	1020	28	9	3.111111111111111	996
FBgn0040211	944	905	937	46	4	11.5	898
FBgn0040230	1021	1000	1011	31	10	3.1	990
FBgn0040234	1000	1000	982	18	3	6	982
FBgn0040236	1069	1000	1018	120	13	9.23076923076923	949
FBgn0040250	1001	1000	993	9	4	2.25	992
FBgn0040252	1026	1000	998	54	9	6	972
FBgn0040256	1055	1000	1027	83	14	5.928571428571429	972
FBgn0040260	787	751	766	57	15	3.8	730
FBgn0040262	945	887	920	83	13	6.384615384615385	862
FBgn0040268	783	783	767	16	3	5.333333333333333	767
FBgn0040271	1015	1000	994	36	5	7.2	979
FBgn0040273	1007	1000	999	15	5	3	992
FBgn0040281	1003	1000	339	667	4	166.75	336
FBgn0040283	1021	1000	961	81	11	7.363636363636363	940
FBgn0040285	1034	1000	1028	40	5	8	994
FBgn0040294	1044	1000	1027	61	9	6.777777777777778	983
FBgn0040296	1044	1000	940	148	16	9.25	896
FBgn0040299	1007	1000	975	39	6	6.5	968
FBgn0040305	1048	1000	1002	94	6	15.666666666666666	954
FBgn0040309	1007	1000	970	44	10	4.4	963
FBgn0040318	1016	1000	1009	23	8	2.875	993
FBgn0040319	1025	1000	1019	31	6	5.166666666666667	994
FBgn0040321	1013	1000	961	65	7	9.285714285714286	948
FBgn0040322	1026	1000	1008	44	6	7.333333333333333	982
FBgn0040323	1019	1000	1000	38	7	5.428571428571429	981
FBgn0040333	1022	1000	985	59	10	5.9	963
FBgn0040334	1007	1000	997	17	5	3.4	990
FBgn0040338	1013	1000	981	45	6	7.5	968
FBgn0040339	1001	1000	939	63	6	10.5	938
FBgn0040341	1015	1000	986	44	6	7.333333333333333	971
FBgn0040342	1031	1000	1020	42	9	4.666666666666667	989
FBgn0040345	929	929	898	31	6	5.166666666666667	898
FBgn0040346	1000	1000	996	4	2	2	996
FBgn0040347	1000	1000	996	4	2	2	996
FBgn0040348	991	955	979	48	7	6.857142857142857	943
FBgn0040349	1009	1000	989	29	9	3.2222222222222223	980
FBgn0040350	1012	1000	1000	24	4	6	988
FBgn0040351	1024	1000	960	88	5	17.6	936
FBgn0040352	1017	1000	945	89	14	6.357142857142857	928
FBgn0040353	1017	1000	987	47	15	3.1333333333333333	970
FBgn0040354	1007	1000	948	66	15	4.4	941
FBgn0040357	1006	1000	1000	12	4	3	994
FBgn0040358	1044	1000	1037	51	7	7.285714285714286	993
FBgn0040360	1012	1000	985	39	6	6.5	973
FBgn0040361	751	750	700	52	6	8.666666666666666	699
FBgn0040363	1038	1000	1036	40	6	6.666666666666667	998
FBgn0040364	1005	1000	944	66	12	5.5	939
FBgn0040366	1011	1000	1003	19	4	4.75	992
FBgn0040368	1011	1000	925	97	4	24.25	914
FBgn0040372	1004	1000	1002	6	3	2	998
FBgn0040373	1016	1000	972	60	7	8.571428571428571	956
FBgn0040375	1010	1000	997	23	5	4.6	987
FBgn0040376	1013	1000	961	65	15	4.333333333333333	948
FBgn0040377	1035	1000	972	98	22	4.454545454545454	937
FBgn0040383	1004	1000	998	10	4	2.5	994
FBgn0040385	1027	1000	1027	27	6	4.5	1000
FBgn0040388	1011	1000	972	50	11	4.545454545454546	961
FBgn0040389	888	884	847	45	11	4.090909090909091	843
FBgn0040392	1053	1000	971	135	25	5.4	918
FBgn0040393	1015	1000	900	130	19	6.842105263157895	885
FBgn0040394	1001	1000	978	24	5	4.8	977
FBgn0040395	1000	1000	982	18	5	3.6	982
FBgn0040396	1015	1000	950	80	19	4.2105263157894735	935
FBgn0040397	1023	1000	1021	25	7	3.5714285714285716	998
FBgn0040466	778	777	521	258	6	43	520
FBgn0040467	1000	1000	994	6	2	3	994
FBgn0040475	1048	1000	1031	65	10	6.5	983
FBgn0040477	1006	1000	1006	6	2	3	1000
FBgn0040487	1063	1000	988	138	12	11.5	925
FBgn0040491	1017	1000	997	37	10	3.7	980
FBgn0040502	1050	1000	1049	51	6	8.5	999
FBgn0040503	1016	1000	989	43	9	4.777777777777778	973
FBgn0040505	1021	1000	989	53	6	8.833333333333334	968
FBgn0040506	852	852	825	27	4	6.75	825
FBgn0040507	1017	1000	1013	21	5	4.2	996
FBgn0040508	1001	1000	998	4	3	1.3333333333333333	997
FBgn0040512	1017	1000	1011	23	5	4.6	994
FBgn0040524	1003	1000	998	8	4	2	995
FBgn0040529	828	827	827	2	2	1	826
FBgn0040531	1008	1000	1007	9	2	4.5	999
FBgn0040532	973	909	953	84	8	10.5	889
FBgn0040534	1001	1000	993	9	5	1.8	992
FBgn0040551	1027	1000	1001	53	12	4.416666666666667	974
FBgn0040569	1048	1000	523	573	8	71.625	475
FBgn0040575	1026	1000	969	83	8	10.375	943
FBgn0040582	1046	1000	1025	67	10	6.7	979
FBgn0040600	1061	1000	1046	76	10	7.6	985
FBgn0040601	1034	1000	997	71	10	7.1	963
FBgn0040602	1008	1000	1005	11	5	2.2	997
FBgn0040607	1035	1000	1007	63	9	7	972
FBgn0040608	828	789	734	133	11	12.090909090909092	695
FBgn0040609	1042	1000	1019	65	12	5.416666666666667	977
FBgn0040629	989	951	978	49	8	6.125	940
FBgn0040634	1000	1000	998	2	1	2	998
FBgn0040648	1007	1000	967	47	6	7.833333333333333	960
FBgn0040649	1010	1000	862	158	19	8.31578947368421	852
FBgn0040650	717	697	691	46	6	7.666666666666667	671
FBgn0040653	1030	1000	1015	45	15	3	985
FBgn0040660	825	809	581	260	5	52	565
FBgn0040674	1023	1000	1019	27	5	5.4	996
FBgn0040679	1024	1000	1018	30	6	5	994
FBgn0040688	1003	1000	483	523	4	130.75	480
FBgn0040694	1023	1000	1003	43	7	6.142857142857143	980
FBgn0040699	1020	1000	1007	33	7	4.714285714285714	987
FBgn0040705	1000	1000	974	26	4	6.5	974
FBgn0040717	735	725	704	41	4	10.25	694
FBgn0040718	1010	1000	977	43	6	7.166666666666667	967
FBgn0040725	1014	1000	998	30	7	4.285714285714286	984
FBgn0040726	1053	1000	1027	79	14	5.642857142857143	974
FBgn0040729	1058	1000	1054	62	9	6.888888888888889	996
FBgn0040730	1004	1000	441	567	9	63	437
FBgn0040733	1017	1000	981	53	9	5.888888888888889	964
FBgn0040737	1029	1000	940	118	9	13.11111111111111	911
FBgn0040743	1011	1000	998	24	6	4	987
FBgn0040747	1001	1000	987	15	9	1.6666666666666667	986
FBgn0040751	1000	1000	983	17	4	4.25	983
FBgn0040752	1007	1000	996	18	6	3	989
FBgn0040754	1015	1000	1014	16	5	3.2	999
FBgn0040755	1018	1000	1016	20	6	3.3333333333333335	998
FBgn0040759	1040	1000	1031	49	13	3.769230769230769	991
FBgn0040764	1028	1000	938	118	10	11.8	910
FBgn0040765	1011	1000	715	307	5	61.4	704
FBgn0040773	1048	1000	1012	84	10	8.4	964
FBgn0040777	1057	1000	1039	75	9	8.333333333333334	982
FBgn0040778	1009	1000	1006	12	3	4	997
FBgn0040793	1001	1000	1000	2	2	1	999
FBgn0040796	1013	1000	977	49	7	7	964
FBgn0040797	1066	1000	1065	67	7	9.571428571428571	999
FBgn0040805	1011	1000	735	287	11	26.09090909090909	724
FBgn0040809	1020	1000	487	553	7	79	467
FBgn0040812	1002	1000	821	183	2	91.5	819
FBgn0040814	1028	1000	993	63	6	10.5	965
FBgn0040817	1109	1000	1109	109	7	15.571428571428571	1000
FBgn0040823	1048	1000	1028	68	9	7.555555555555555	980
FBgn0040827	1031	1000	1002	60	13	4.615384615384615	971
FBgn0040828	1004	1000	1002	6	6	1	998
FBgn0040832	1023	1000	980	66	10	6.6	957
FBgn0040837	1030	1000	949	111	14	7.928571428571429	919
FBgn0040842	1006	1000	952	60	11	5.454545454545454	946
FBgn0040843	1022	1000	966	78	14	5.571428571428571	944
FBgn0040850	1026	1000	962	90	12	7.5	936
FBgn0040871	1029	1000	970	88	13	6.769230769230769	941
FBgn0040892	1037	1000	988	86	9	9.555555555555555	951
FBgn0040899	1001	1000	999	3	2	1.5	998
FBgn0040900	1003	1000	1001	5	2	2.5	998
FBgn0040905	1025	1000	1004	46	8	5.75	979
FBgn0040907	1030	1000	1017	43	9	4.777777777777778	987
FBgn0040918	1030	1000	1016	44	13	3.3846153846153846	986
FBgn0040928	1004	1000	945	63	9	7	941
FBgn0040929	1008	1000	1004	12	4	3	996
FBgn0040941	1025	1000	1001	49	8	6.125	976
FBgn0040942	1000	1000	934	66	9	7.333333333333333	934
FBgn0040958	816	772	763	97	18	5.388888888888889	719
FBgn0040964	1016	1000	1010	22	5	4.4	994
FBgn0040967	1007	1000	983	31	8	3.875	976
FBgn0040972	1001	1000	981	21	4	5.25	980
FBgn0040984	1070	1000	1037	103	18	5.722222222222222	967
FBgn0040985	1020	1000	1012	28	10	2.8	992
FBgn0040989	1003	1000	915	91	5	18.2	912
FBgn0040996	1048	1000	1029	67	12	5.583333333333333	981
FBgn0041087	1033	1000	915	151	23	6.565217391304348	882
FBgn0041092	1008	1000	993	23	8	2.875	985
FBgn0041094	1027	1000	984	70	16	4.375	957
FBgn0041096	1027	1000	988	66	14	4.714285714285714	961
FBgn0041097	1008	1000	1003	13	5	2.6	995
FBgn0041103	1025	1000	1009	41	9	4.555555555555555	984
FBgn0041105	1016	1000	984	48	9	5.333333333333333	968
FBgn0041111	1036	1000	997	75	11	6.818181818181818	961
FBgn0041150	914	900	866	62	13	4.769230769230769	852
FBgn0041156	1025	1000	1022	28	7	4	997
FBgn0041160	1006	1000	950	62	8	7.75	944
FBgn0041171	1010	1000	950	70	9	7.777777777777778	940
FBgn0041174	1001	1000	994	8	5	1.6	993
FBgn0041181	1019	1000	761	277	11	25.181818181818183	742
FBgn0041183	1008	1000	931	85	16	5.3125	923
FBgn0041184	1098	1000	1039	157	14	11.214285714285714	941
FBgn0041186	1002	1000	997	7	2	3.5	995
FBgn0041188	1000	1000	993	7	3	2.3333333333333335	993
FBgn0041191	1007	1000	993	21	6	3.5	986
FBgn0041194	1005	1000	977	33	8	4.125	972
FBgn0041195	1085	1000	1052	118	13	9.076923076923077	967
FBgn0041205	894	876	883	29	5	5.8	865
FBgn0041210	1049	1000	1047	51	5	10.2	998
FBgn0041224	1007	1000	989	25	6	4.166666666666667	982
FBgn0041225	1000	1000	997	3	1	3	997
FBgn0041229	1076	1000	991	161	12	13.416666666666666	915
FBgn0041231	1054	1000	1020	88	13	6.769230769230769	966
FBgn0041232	1001	1000	978	24	5	4.8	977
FBgn0041233	1009	1000	1009	9	1	9	1000
FBgn0041234	1000	1000	1000	0	0	NA	1000
FBgn0041237	1009	1000	952	66	10	6.6	943
FBgn0041238	1000	1000	1000	0	0	NA	1000
FBgn0041239	1000	1000	1000	0	0	NA	1000
FBgn0041240	1078	1000	938	218	8	27.25	860
FBgn0041242	1008	1000	995	21	7	3	987
FBgn0041246	1074	1000	1000	148	16	9.25	926
FBgn0041249	1084	1000	1046	122	10	12.2	962
FBgn0041250	925	918	885	47	6	7.833333333333333	878
FBgn0041252	1010	1000	984	36	6	6	974
FBgn0041337	1006	1000	733	279	3	93	727
FBgn0041342	1013	1000	1005	21	4	5.25	992
FBgn0041581	1035	1000	978	92	15	6.133333333333334	943
FBgn0041582	1001	1000	997	5	2	2.5	996
FBgn0041585	1028	1000	1019	37	11	3.3636363636363638	991
FBgn0041605	1000	1000	522	478	2	239	522
FBgn0041622	1013	1000	996	30	10	3	983
FBgn0041624	1028	1000	1019	37	10	3.7	991
FBgn0041625	1011	1000	1009	13	5	2.6	998
FBgn0041629	1052	1000	1005	99	12	8.25	953
FBgn0041702	1008	1000	984	32	5	6.4	976
FBgn0041706	1016	1000	1008	24	5	4.8	992
FBgn0041709	1043	1000	1023	63	10	6.3	980
FBgn0041711	1012	1000	1008	16	4	4	996
FBgn0041712	1005	1000	976	34	5	6.8	971
FBgn0041713	1001	1000	964	38	8	4.75	963
FBgn0041717	1004	1000	995	13	4	3.25	991
FBgn0041719	1007	1000	1004	10	5	2	997
FBgn0041721	1068	1000	1057	79	13	6.076923076923077	989
FBgn0041775	1004	1000	968	40	9	4.444444444444445	964
FBgn0041781	1004	1000	977	31	7	4.428571428571429	973
FBgn0041789	1007	1000	1007	7	2	3.5	1000
FBgn0042085	1014	1000	990	38	5	7.6	976
FBgn0042092	1039	1000	1026	52	4	13	987
FBgn0042101	861	834	836	52	5	10.4	809
FBgn0042103	1006	1000	1006	6	1	6	1000
FBgn0042110	1000	1000	969	31	3	10.333333333333334	969
FBgn0042111	1001	1000	969	33	9	3.6666666666666665	968
FBgn0042125	1000	1000	984	16	2	8	984
FBgn0042146	1070	1000	1017	123	10	12.3	947
FBgn0042179	1006	1000	930	82	11	7.454545454545454	924
FBgn0042185	1029	1000	982	76	6	12.666666666666666	953
FBgn0042189	770	756	719	65	10	6.5	705
FBgn0042198	1023	1000	989	57	11	5.181818181818182	966
FBgn0042201	1039	1000	983	95	12	7.916666666666667	944
FBgn0042205	1013	1000	1011	15	3	5	998
FBgn0042213	880	880	880	0	0	NA	880
FBgn0042630	1002	1000	999	5	3	1.6666666666666667	997
FBgn0042693	1056	1000	1014	98	11	8.909090909090908	958
FBgn0042712	1002	1000	972	32	6	5.333333333333333	970
FBgn0043001	1001	1000	719	283	7	40.42857142857143	718
FBgn0043002	1000	1000	999	1	1	1	999
FBgn0043005	895	871	816	103	12	8.583333333333334	792
FBgn0043010	1004	1000	1001	7	4	1.75	997
FBgn0043012	1000	1000	998	2	1	2	998
FBgn0043362	1024	1000	991	57	8	7.125	967
FBgn0043364	1002	1000	979	25	4	6.25	977
FBgn0043455	1011	1000	1010	12	3	4	999
FBgn0043456	1036	1000	1015	57	11	5.181818181818182	979
FBgn0043457	1016	1000	976	56	10	5.6	960
FBgn0043470	862	862	808	54	8	6.75	808
FBgn0043530	1048	1000	1033	63	10	6.3	985
FBgn0043532	1004	1000	976	32	8	4	972
FBgn0043539	1000	1000	956	44	7	6.285714285714286	956
FBgn0043550	1016	1000	950	82	7	11.714285714285714	934
FBgn0043575	1075	1000	1048	102	14	7.285714285714286	973
FBgn0043577	1025	1000	993	57	5	11.4	968
FBgn0043783	850	824	296	580	3	193.33333333333334	270
FBgn0043791	1062	1000	1059	65	5	13	997
FBgn0043792	1006	1000	1004	8	3	2.6666666666666665	998
FBgn0043796	1027	1000	979	75	11	6.818181818181818	952
FBgn0043806	1022	1000	936	108	11	9.818181818181818	914
FBgn0043841	1053	1000	996	110	15	7.333333333333333	943
FBgn0043854	1017	1000	966	68	10	6.8	949
FBgn0043884	1008	1000	1007	9	3	3	999
FBgn0043900	1000	1000	996	4	1	4	996
FBgn0043903	1004	1000	993	15	4	3.75	989
FBgn0044020	1015	1000	1012	18	7	2.5714285714285716	997
FBgn0044030	1008	1000	1000	16	4	4	992
FBgn0044046	1046	1000	994	98	22	4.454545454545454	948
FBgn0044047	1026	1000	920	132	13	10.153846153846153	894
FBgn0044048	1028	1000	1004	52	11	4.7272727272727275	976
FBgn0044049	1032	1000	1024	40	4	10	992
FBgn0044050	1027	1000	996	58	8	7.25	969
FBgn0044323	785	758	752	60	11	5.454545454545454	725
FBgn0044328	1027	1000	1008	46	10	4.6	981
FBgn0044452	1048	1000	976	120	7	17.142857142857142	928
FBgn0044511	1052	1000	1028	76	10	7.6	976
FBgn0044809	1001	1000	971	31	6	5.166666666666667	970
FBgn0044810	1014	1000	988	40	4	10	974
FBgn0044811	756	677	698	137	15	9.133333333333333	619
FBgn0044812	1006	1000	501	511	11	46.45454545454545	495
FBgn0044826	1003	1000	943	63	9	7	940
FBgn0044871	1027	1000	1013	41	6	6.833333333333333	986
FBgn0045035	1052	1000	1049	55	11	5	997
FBgn0045063	945	935	371	584	9	64.88888888888889	361
FBgn0045064	1018	1000	985	51	9	5.666666666666667	967
FBgn0045073	1001	1000	978	24	6	4	977
FBgn0045443	1028	1000	761	295	7	42.142857142857146	733
FBgn0045471	1001	1000	977	25	8	3.125	976
FBgn0045473	1000	1000	983	17	4	4.25	983
FBgn0045474	1009	1000	966	52	8	6.5	957
FBgn0045479	1037	1000	994	80	9	8.88888888888889	957
FBgn0045483	1046	1000	695	397	8	49.625	649
FBgn0045495	1058	1000	1044	72	11	6.545454545454546	986
FBgn0045497	1036	1000	1030	42	5	8.4	994
FBgn0045501	1023	1000	279	767	5	153.4	256
FBgn0045759	1008	1000	998	18	8	2.25	990
FBgn0045823	1020	1000	1007	33	4	8.25	987
FBgn0045842	1035	1000	919	151	22	6.863636363636363	884
FBgn0045843	1061	1000	1041	81	12	6.75	980
FBgn0045852	1060	1000	1054	66	8	8.25	994
FBgn0045862	1005	1000	982	28	5	5.6	977
FBgn0045866	1001	1000	995	7	5	1.4	994
FBgn0046113	1035	1000	1022	48	7	6.857142857142857	987
FBgn0046114	1011	1000	975	47	8	5.875	964
FBgn0046253	1039	1000	1023	55	8	6.875	984
FBgn0046258	1013	1000	934	92	9	10.222222222222221	921
FBgn0046294	1021	1000	998	44	9	4.888888888888889	977
FBgn0046297	1030	1000	982	78	8	9.75	952
FBgn0046301	1033	1000	734	332	10	33.2	701
FBgn0046302	1067	1000	985	149	16	9.3125	918
FBgn0046332	1015	1000	987	43	11	3.909090909090909	972
FBgn0046685	1013	1000	1009	17	2	8.5	996
FBgn0046689	1021	1000	1008	34	10	3.4	987
FBgn0046692	1023	1000	448	598	12	49.833333333333336	425
FBgn0046704	1004	1000	967	41	6	6.833333333333333	963
FBgn0046756	1031	1000	1008	54	11	4.909090909090909	977
FBgn0046763	866	855	862	15	3	5	851
FBgn0046873	1049	1000	720	378	6	63	671
FBgn0046875	1020	1000	1000	40	13	3.076923076923077	980
FBgn0046876	784	708	770	90	15	6	694
FBgn0046878	1036	1000	1020	52	8	6.5	984
FBgn0046879	1011	1000	1009	13	4	3.25	998
FBgn0046880	831	826	814	22	7	3.142857142857143	809
FBgn0046887	1050	1000	1023	77	9	8.555555555555555	973
FBgn0047000	1004	1000	982	26	9	2.888888888888889	978
FBgn0047092	1017	1000	1004	30	8	3.75	987
FBgn0047095	1007	1000	844	170	12	14.166666666666666	837
FBgn0047114	1000	1000	1000	0	0	NA	1000
FBgn0047135	1000	1000	994	6	2	3	994
FBgn0047178	1031	1000	1010	52	5	10.4	979
FBgn0047199	1002	1000	934	70	11	6.363636363636363	932
FBgn0047205	1053	1000	1027	79	7	11.285714285714286	974
FBgn0047338	1008	1000	962	54	7	7.714285714285714	954
FBgn0047351	1006	1000	999	13	4	3.25	993
FBgn0050000	1000	1000	991	9	3	3	991
FBgn0050008	1006	1000	1004	8	2	4	998
FBgn0050009	1019	1000	990	48	6	8	971
FBgn0050010	1009	1000	975	43	12	3.5833333333333335	966
FBgn0050016	1026	1000	970	82	9	9.11111111111111	944
FBgn0050021	787	747	773	54	11	4.909090909090909	733
FBgn0050033	1001	1000	999	3	2	1.5	998
FBgn0050037	1047	1000	971	123	13	9.461538461538462	924
FBgn0050039	1010	1000	977	43	11	3.909090909090909	967
FBgn0050042	1020	1000	1006	34	7	4.857142857142857	986
FBgn0050045	1006	1000	1000	12	4	3	994
FBgn0050047	719	714	716	8	3	2.6666666666666665	711
FBgn0050051	1005	1000	994	16	9	1.7777777777777777	989
FBgn0050054	1025	1000	965	85	9	9.444444444444445	940
FBgn0050055	1002	1000	997	7	5	1.4	995
FBgn0050067	1001	1000	997	5	3	1.6666666666666667	996
FBgn0050069	1014	1000	960	68	13	5.230769230769231	946
FBgn0050075	1002	1000	1002	2	2	1	1000
FBgn0050076	1004	1000	968	40	6	6.666666666666667	964
FBgn0050077	1012	1000	1004	20	6	3.3333333333333335	992
FBgn0050081	1007	1000	1007	7	2	3.5	1000
FBgn0050082	1041	1000	1041	41	1	41	1000
FBgn0050083	1014	1000	995	33	7	4.714285714285714	981
FBgn0050085	1030	1000	1026	34	8	4.25	996
FBgn0050089	1008	1000	990	26	7	3.7142857142857144	982
FBgn0050090	1046	1000	957	135	16	8.4375	911
FBgn0050091	1077	1000	1075	79	11	7.181818181818182	998
FBgn0050095	854	841	826	41	9	4.555555555555555	813
FBgn0050096	1000	1000	999	1	1	1	999
FBgn0050098	1042	1000	1023	61	5	12.2	981
FBgn0050103	754	696	665	147	14	10.5	607
FBgn0050104	1034	1000	575	493	11	44.81818181818182	541
FBgn0050105	1005	1000	987	23	6	3.8333333333333335	982
FBgn0050106	1004	1000	1001	7	5	1.4	997
FBgn0050110	1020	1000	821	219	8	27.375	801
FBgn0050114	1020	1000	1004	36	11	3.272727272727273	984
FBgn0050121	1022	1000	992	52	12	4.333333333333333	970
FBgn0050125	1012	1000	1005	19	5	3.8	993
FBgn0050145	702	669	689	46	7	6.571428571428571	656
FBgn0050147	1016	1000	968	64	6	10.666666666666666	952
FBgn0050151	1006	1000	971	41	7	5.857142857142857	965
FBgn0050157	1005	1000	993	17	9	1.8888888888888888	988
FBgn0050158	1025	1000	1017	33	8	4.125	992
FBgn0050160	1064	1000	1045	83	8	10.375	981
FBgn0050161	1001	1000	999	3	3	1	998
FBgn0050169	1000	1000	997	3	2	1.5	997
FBgn0050177	1043	1000	996	90	8	11.25	953
FBgn0050178	1003	1000	996	10	4	2.5	993
FBgn0050183	1011	1000	991	31	8	3.875	980
FBgn0050192	1019	1000	999	39	10	3.9	980
FBgn0050197	1054	1000	982	126	15	8.4	928
FBgn0050198	1006	1000	949	63	7	9	943
FBgn0050211	1006	1000	1003	9	4	2.25	997
FBgn0050215	970	892	904	144	11	13.090909090909092	826
FBgn0050222	1060	1000	1054	66	8	8.25	994
FBgn0050223	1029	1000	1014	44	11	4	985
FBgn0050227	1007	1000	989	25	7	3.5714285714285716	982
FBgn0050234	1003	1000	989	17	5	3.4	986
FBgn0050235	1004	1000	982	26	7	3.7142857142857144	978
FBgn0050241	1057	1000	1035	79	11	7.181818181818182	978
FBgn0050250	718	689	680	67	9	7.444444444444445	651
FBgn0050257	1008	1000	991	25	8	3.125	983
FBgn0050259	1018	1000	995	41	5	8.2	977
FBgn0050265	748	730	736	30	10	3	718
FBgn0050272	991	981	978	23	5	4.6	968
FBgn0050279	1022	1000	1016	28	5	5.6	994
FBgn0050280	1001	1000	975	27	4	6.75	974
FBgn0050284	1056	1000	1043	69	6	11.5	987
FBgn0050285	1011	1000	996	26	7	3.7142857142857144	985
FBgn0050289	1013	1000	605	421	10	42.1	592
FBgn0050296	1013	1000	1001	25	7	3.5714285714285716	988
FBgn0050299	1040	1000	1036	44	5	8.8	996
FBgn0050334	1035	1000	976	94	15	6.266666666666667	941
FBgn0050339	1000	1000	987	13	4	3.25	987
FBgn0050342	1000	1000	995	5	2	2.5	995
FBgn0050343	1041	1000	1009	73	8	9.125	968
FBgn0050355	1000	1000	991	9	2	4.5	991
FBgn0050361	1002	1000	1000	4	4	1	998
FBgn0050369	1018	1000	997	39	6	6.5	979
FBgn0050371	1058	1000	1050	66	8	8.25	992
FBgn0050372	1054	1000	1050	58	4	14.5	996
FBgn0050373	1000	1000	990	10	2	5	990
FBgn0050376	1009	1000	1005	13	5	2.6	996
FBgn0050379	1010	1000	999	21	7	3	989
FBgn0050380	1048	1000	1005	91	18	5.055555555555555	957
FBgn0050383	1025	1000	974	76	9	8.444444444444445	949
FBgn0050390	790	788	783	9	5	1.8	781
FBgn0050393	1004	1000	976	32	11	2.909090909090909	972
FBgn0050394	1046	1000	1028	64	9	7.111111111111111	982
FBgn0050395	894	834	868	86	8	10.75	808
FBgn0050398	1012	1000	999	25	7	3.5714285714285716	987
FBgn0050401	1002	1000	996	8	6	1.3333333333333333	994
FBgn0050404	1016	1000	1012	20	6	3.3333333333333335	996
FBgn0050406	1004	1000	963	45	7	6.428571428571429	959
FBgn0050407	1010	1000	983	37	4	9.25	973
FBgn0050409	1051	1000	1025	77	12	6.416666666666667	974
FBgn0050411	1020	1000	993	47	9	5.222222222222222	973
FBgn0050412	1029	1000	1012	46	11	4.181818181818182	983
FBgn0050413	1027	1000	987	67	6	11.166666666666666	960
FBgn0050416	1000	1000	995	5	2	2.5	995
FBgn0050417	1003	1000	1001	5	4	1.25	998
FBgn0050419	1007	1000	905	109	11	9.909090909090908	898
FBgn0050421	1008	1000	968	48	10	4.8	960
FBgn0050423	1043	1000	1033	53	9	5.888888888888889	990
FBgn0050430	1038	1000	850	226	8	28.25	812
FBgn0050431	920	891	913	36	5	7.2	884
FBgn0050438	1080	1000	1023	137	15	9.133333333333333	943
FBgn0050440	1080	1000	999	161	18	8.944444444444445	919
FBgn0050446	1011	1000	1011	11	2	5.5	1000
FBgn0050447	1028	1000	735	321	7	45.857142857142854	707
FBgn0050457	1007	1000	997	17	5	3.4	990
FBgn0050458	1002	1000	820	184	6	30.666666666666668	818
FBgn0050460	1011	1000	1007	15	5	3	996
FBgn0050463	1020	1000	994	46	8	5.75	974
FBgn0050466	1029	1000	1009	49	5	9.8	980
FBgn0050471	1001	1000	728	274	5	54.8	727
FBgn0050472	1000	1000	910	90	5	18	910
FBgn0050476	1000	1000	843	157	1	157	843
FBgn0050484	1005	1000	1001	9	7	1.2857142857142858	996
FBgn0050486	801	743	764	95	12	7.916666666666667	706
FBgn0050487	1007	1000	1001	13	4	3.25	994
FBgn0050491	1029	1000	997	61	6	10.166666666666666	968
FBgn0050493	1006	1000	996	16	2	8	990
FBgn0050502	1043	1000	890	196	12	16.333333333333332	847
FBgn0050506	1008	1000	1005	11	6	1.8333333333333333	997
FBgn0050509	1017	1000	1014	20	8	2.5	997
FBgn0051002	1024	1000	1006	42	6	7	982
FBgn0051004	1011	1000	970	52	7	7.428571428571429	959
FBgn0051005	1001	1000	1001	1	1	1	1000
FBgn0051010	1032	1000	1010	54	9	6	978
FBgn0051014	1009	1000	997	21	5	4.2	988
FBgn0051015	1011	1000	991	31	10	3.1	980
FBgn0051019	1051	1000	1038	64	4	16	987
FBgn0051023	1016	1000	1010	22	5	4.4	994
FBgn0051028	1000	1000	982	18	7	2.5714285714285716	982
FBgn0051029	867	846	805	83	8	10.375	784
FBgn0051036	1051	1000	1002	100	14	7.142857142857143	951
FBgn0051038	1006	1000	984	28	7	4	978
FBgn0051040	1011	1000	1004	18	5	3.6	993
FBgn0051044	1044	1000	1030	58	10	5.8	986
FBgn0051050	1000	1000	987	13	2	6.5	987
FBgn0051053	1003	1000	973	33	6	5.5	970
FBgn0051055	1010	1000	977	43	7	6.142857142857143	967
FBgn0051064	1000	1000	949	51	2	25.5	949
FBgn0051068	1000	1000	995	5	2	2.5	995
FBgn0051070	1000	1000	966	34	2	17	966
FBgn0051072	1015	1000	1015	15	3	5	1000
FBgn0051076	1018	1000	994	42	8	5.25	976
FBgn0051080	871	871	865	6	5	1.2	865
FBgn0051084	1006	1000	1003	9	2	4.5	997
FBgn0051087	845	835	791	64	10	6.4	781
FBgn0051092	1034	1000	1003	65	8	8.125	969
FBgn0051093	1010	1000	993	27	8	3.375	983
FBgn0051098	717	680	663	91	11	8.272727272727273	626
FBgn0051100	1006	1000	1006	6	1	6	1000
FBgn0051102	751	743	731	28	7	4	723
FBgn0051103	688	675	651	50	11	4.545454545454546	638
FBgn0051106	1062	1000	1046	78	13	6	984
FBgn0051111	1013	1000	1000	26	7	3.7142857142857144	987
FBgn0051115	1007	1000	996	18	5	3.6	989
FBgn0051116	1020	1000	973	67	9	7.444444444444445	953
FBgn0051121	1033	1000	1015	51	9	5.666666666666667	982
FBgn0051125	1001	1000	1000	2	2	1	999
FBgn0051126	986	960	978	34	5	6.8	952
FBgn0051128	1001	1000	965	37	7	5.285714285714286	964
FBgn0051130	1024	1000	877	171	10	17.1	853
FBgn0051140	1009	1000	996	22	6	3.6666666666666665	987
FBgn0051141	1004	1000	986	22	4	5.5	982
FBgn0051143	1019	1000	998	40	7	5.714285714285714	979
FBgn0051144	1001	1000	1001	1	1	1	1000
FBgn0051145	1024	1000	972	76	12	6.333333333333333	948
FBgn0051146	1072	1000	1009	135	15	9	937
FBgn0051148	1105	1000	1100	110	13	8.461538461538462	995
FBgn0051156	1000	1000	997	3	1	3	997
FBgn0051158	1014	1000	964	64	9	7.111111111111111	950
FBgn0051159	1000	1000	944	56	4	14	944
FBgn0051163	756	739	745	28	8	3.5	728
FBgn0051165	1049	1000	1012	86	9	9.555555555555555	963
FBgn0051174	1042	1000	1040	44	5	8.8	998
FBgn0051176	1004	1000	979	29	5	5.8	975
FBgn0051183	1004	1000	952	56	9	6.222222222222222	948
FBgn0051191	1028	1000	1008	48	10	4.8	980
FBgn0051195	1044	1000	848	240	14	17.142857142857142	804
FBgn0051198	1059	1000	1054	64	11	5.818181818181818	995
FBgn0051200	1035	1000	992	78	9	8.666666666666666	957
FBgn0051206	1001	1000	986	16	4	4	985
FBgn0051207	826	800	804	48	12	4	778
FBgn0051211	1049	1000	1042	56	9	6.222222222222222	993
FBgn0051215	798	777	760	59	14	4.214285714285714	739
FBgn0051216	837	829	818	27	9	3	810
FBgn0051220	1013	1000	1002	24	2	12	989
FBgn0051221	1015	1000	939	91	9	10.11111111111111	924
FBgn0051223	1000	1000	679	321	8	40.125	679
FBgn0051224	1003	1000	996	10	2	5	993
FBgn0051225	1006	1000	990	22	3	7.333333333333333	984
FBgn0051226	1038	1000	997	79	21	3.761904761904762	959
FBgn0051233	936	928	933	11	6	1.8333333333333333	925
FBgn0051251	1002	1000	952	52	8	6.5	950
FBgn0051262	1005	1000	993	17	6	2.8333333333333335	988
FBgn0051266	1002	1000	998	6	3	2	996
FBgn0051268	1045	1000	1026	64	10	6.4	981
FBgn0051269	1000	1000	998	2	1	2	998
FBgn0051272	817	811	791	32	9	3.5555555555555554	785
FBgn0051279	1014	1000	979	49	5	9.8	965
FBgn0051281	1003	1000	994	12	5	2.4	991
FBgn0051287	1020	1000	1020	20	4	5	1000
FBgn0051288	1009	1000	798	220	10	22	789
FBgn0051294	1002	1000	952	52	10	5.2	950
FBgn0051296	866	852	853	27	6	4.5	839
FBgn0051301	1000	1000	993	7	4	1.75	993
FBgn0051313	1077	977	1037	140	13	10.76923076923077	937
FBgn0051321	793	785	747	54	10	5.4	739
FBgn0051323	1064	1000	1056	72	6	12	992
FBgn0051324	1003	1000	983	23	7	3.2857142857142856	980
FBgn0051327	1053	1000	1042	64	7	9.142857142857142	989
FBgn0051331	1010	1000	960	60	8	7.5	950
FBgn0051337	1010	1000	989	31	8	3.875	979
FBgn0051342	1025	1000	966	84	13	6.461538461538462	941
FBgn0051343	1012	1000	1001	23	8	2.875	989
FBgn0051344	1028	1000	1025	31	4	7.75	997
FBgn0051345	1013	1000	1012	14	6	2.3333333333333335	999
FBgn0051347	1000	1000	1000	0	0	NA	1000
FBgn0051352	1020	1000	983	57	6	9.5	963
FBgn0051356	1042	1000	1022	62	13	4.769230769230769	980
FBgn0051357	1020	1000	1011	29	7	4.142857142857143	991
FBgn0051360	1018	1000	987	49	7	7	969
FBgn0051363	1002	1000	985	19	5	3.8	983
FBgn0051368	1002	1000	1001	3	2	1.5	999
FBgn0051374	1002	1000	981	23	9	2.5555555555555554	979
FBgn0051382	1000	1000	999	1	1	1	999
FBgn0051386	1000	1000	997	3	3	1	997
FBgn0051410	1001	1000	1001	1	1	1	1000
FBgn0051415	1012	1000	996	28	5	5.6	984
FBgn0051418	1001	1000	970	32	5	6.4	969
FBgn0051423	1037	1000	1009	65	9	7.222222222222222	972
FBgn0051431	1002	1000	996	8	5	1.6	994
FBgn0051432	1017	1000	988	46	6	7.666666666666667	971
FBgn0051437	1000	1000	976	24	5	4.8	976
FBgn0051438	982	939	898	127	14	9.071428571428571	855
FBgn0051446	1000	1000	970	30	4	7.5	970
FBgn0051457	756	756	753	3	2	1.5	753
FBgn0051459	1082	1000	1040	124	12	10.333333333333334	958
FBgn0051460	1003	1000	1000	6	4	1.5	997
FBgn0051464	1042	1000	979	105	13	8.076923076923077	937
FBgn0051467	909	901	904	13	3	4.333333333333333	896
FBgn0051471	1016	1000	980	52	11	4.7272727272727275	964
FBgn0051472	1009	1000	955	63	14	4.5	946
FBgn0051475	1014	1000	1004	24	9	2.6666666666666665	990
FBgn0051477	1006	1000	989	23	5	4.6	983
FBgn0051480	1016	1000	1007	25	8	3.125	991
FBgn0051481	1012	1000	992	32	10	3.2	980
FBgn0051482	1037	1000	1033	41	6	6.833333333333333	996
FBgn0051491	1030	1000	937	123	11	11.181818181818182	907
FBgn0051495	1034	1000	1010	58	7	8.285714285714286	976
FBgn0051496	1070	1000	1064	76	4	19	994
FBgn0051497	1024	1000	1005	43	8	5.375	981
FBgn0051506	1000	1000	989	11	3	3.6666666666666665	989
FBgn0051514	1023	1000	1003	43	8	5.375	980
FBgn0051515	1008	1000	945	71	13	5.461538461538462	937
FBgn0051522	1052	1000	1048	56	10	5.6	996
FBgn0051523	1000	1000	115	885	2	442.5	115
FBgn0051524	1000	1000	796	204	2	102	796
FBgn0051525	1006	1000	1003	9	2	4.5	997
FBgn0051528	1061	1000	594	528	8	66	533
FBgn0051548	1051	1000	1035	67	8	8.375	984
FBgn0051559	1025	1000	1000	50	8	6.25	975
FBgn0051561	928	893	903	60	8	7.5	868
FBgn0051575	1001	1000	981	21	6	3.5	980
FBgn0051579	702	686	666	52	10	5.2	650
FBgn0051588	1022	1000	927	117	10	11.7	905
FBgn0051591	1005	1000	979	31	4	7.75	974
FBgn0051609	1014	1000	1010	18	5	3.6	996
FBgn0051626	1001	1000	985	17	7	2.4285714285714284	984
FBgn0051632	1010	1000	909	111	4	27.75	899
FBgn0051634	1039	1000	1027	51	13	3.923076923076923	988
FBgn0051635	1043	1000	1040	46	3	15.333333333333334	997
FBgn0051636	1018	1000	1016	20	2	10	998
FBgn0051638	950	949	939	12	5	2.4	938
FBgn0051639	1019	1000	991	47	8	5.875	972
FBgn0051643	1017	1000	1015	19	5	3.8	998
FBgn0051644	1046	1000	1009	83	18	4.611111111111111	963
FBgn0051646	1006	1000	1003	9	3	3	997
FBgn0051647	1043	1000	1019	67	9	7.444444444444445	976
FBgn0051658	1001	1000	961	41	12	3.4166666666666665	960
FBgn0051663	937	934	852	88	11	8	849
FBgn0051665	1017	1000	1013	21	4	5.25	996
FBgn0051669	1014	1000	997	31	5	6.2	983
FBgn0051673	1097	1000	1001	193	11	17.545454545454547	904
FBgn0051676	1076	1000	1064	88	10	8.8	988
FBgn0051678	1027	1000	1027	27	4	6.75	1000
FBgn0051682	1009	1000	1006	12	3	4	997
FBgn0051690	1003	1000	985	21	5	4.2	982
FBgn0051694	1003	1000	954	52	7	7.428571428571429	951
FBgn0051698	1052	1000	1035	69	12	5.75	983
FBgn0051700	1037	1000	1013	61	14	4.357142857142857	976
FBgn0051706	949	913	949	36	4	9	913
FBgn0051708	1014	1000	1010	18	7	2.5714285714285716	996
FBgn0051710	1013	1000	990	36	10	3.6	977
FBgn0051716	1016	1000	1011	21	4	5.25	995
FBgn0051717	1006	1000	1004	8	4	2	998
FBgn0051718	1004	1000	995	13	3	4.333333333333333	991
FBgn0051719	1050	1000	1028	72	19	3.789473684210526	978
FBgn0051720	1101	1000	1044	158	20	7.9	943
FBgn0051721	1010	1000	975	45	13	3.4615384615384617	965
FBgn0051729	706	706	287	419	3	139.66666666666666	287
FBgn0051730	1010	1000	987	33	7	4.714285714285714	977
FBgn0051735	1034	1000	1003	65	8	8.125	969
FBgn0051741	846	795	834	63	12	5.25	783
FBgn0051769	1029	1000	992	66	11	6	963
FBgn0051774	1013	1000	947	79	13	6.076923076923077	934
FBgn0051776	1025	1000	1022	28	3	9.333333333333334	997
FBgn0051778	1001	1000	954	48	6	8	953
FBgn0051781	1013	1000	977	49	9	5.444444444444445	964
FBgn0051784	1021	1000	986	56	12	4.666666666666667	965
FBgn0051785	1003	1000	741	265	8	33.125	738
FBgn0051787	1002	1000	923	81	4	20.25	921
FBgn0051789	1027	1000	1005	49	14	3.5	978
FBgn0051792	1072	1000	958	186	17	10.941176470588236	886
FBgn0051793	983	911	968	87	12	7.25	896
FBgn0051797	1018	1000	1006	30	7	4.285714285714286	988
FBgn0051798	1025	1000	963	87	6	14.5	938
FBgn0051800	1011	1000	1006	16	7	2.2857142857142856	995
FBgn0051803	881	881	868	13	4	3.25	868
FBgn0051804	1007	1000	972	42	10	4.2	965
FBgn0051807	1016	1000	936	96	14	6.857142857142857	920
FBgn0051812	1042	1000	995	89	12	7.416666666666667	953
FBgn0051813	1002	1000	987	17	7	2.4285714285714284	985
FBgn0051814	1013	1000	987	39	9	4.333333333333333	974
FBgn0051816	1006	1000	999	13	7	1.8571428571428572	993
FBgn0051820	1008	1000	993	23	6	3.8333333333333335	985
FBgn0051824	1060	1000	1032	88	12	7.333333333333333	972
FBgn0051832	1030	1000	761	299	8	37.375	731
FBgn0051835	1079	1000	1020	138	13	10.615384615384615	941
FBgn0051840	1027	1000	1024	30	8	3.75	997
FBgn0051845	1020	1000	1005	35	6	5.833333333333333	985
FBgn0051848	1001	1000	859	143	5	28.6	858
FBgn0051862	1017	1000	994	40	8	5	977
FBgn0051870	1076	1000	1011	141	12	11.75	935
FBgn0051871	1046	1000	1037	55	9	6.111111111111111	991
FBgn0051876	1030	1000	995	65	10	6.5	965
FBgn0051882	1007	1000	954	60	10	6	947
FBgn0051885	1035	1000	1011	59	11	5.363636363636363	976
FBgn0051889	1042	1000	1016	68	9	7.555555555555555	974
FBgn0051890	1000	1000	991	9	2	4.5	991
FBgn0051892	1030	1000	1026	34	5	6.8	996
FBgn0051901	1041	1000	975	107	19	5.631578947368421	934
FBgn0051907	1000	1000	992	8	4	2	992
FBgn0051908	1009	1000	1009	9	1	9	1000
FBgn0051910	1030	1000	1022	38	7	5.428571428571429	992
FBgn0051912	1000	1000	997	3	1	3	997
FBgn0051913	1037	1000	1001	73	6	12.166666666666666	964
FBgn0051921	1001	1000	965	37	6	6.166666666666667	964
FBgn0051922	1002	1000	991	13	2	6.5	989
FBgn0051928	1003	1000	997	9	5	1.8	994
FBgn0051933	1043	1000	948	138	6	23	905
FBgn0051935	1042	1000	1006	78	8	9.75	964
FBgn0051940	1045	1000	1032	58	9	6.444444444444445	987
FBgn0051942	1000	1000	972	28	9	3.111111111111111	972
FBgn0051946	1010	1000	977	43	9	4.777777777777778	967
FBgn0051950	1002	1000	989	15	5	3	987
FBgn0051952	1021	1000	975	67	15	4.466666666666667	954
FBgn0051955	1008	1000	957	59	11	5.363636363636363	949
FBgn0051960	1017	1000	1007	27	6	4.5	990
FBgn0051961	1006	1000	1002	10	5	2	996
FBgn0051971	1004	1000	1003	5	3	1.6666666666666667	999
FBgn0051974	1018	1000	1012	24	6	4	994
FBgn0051997	1016	1000	736	296	17	17.41176470588235	720
FBgn0051999	834	827	582	259	6	43.166666666666664	575
FBgn0052006	1092	1000	739	445	14	31.785714285714285	647
FBgn0052022	1000	1000	917	83	4	20.75	917
FBgn0052023	1000	1000	975	25	5	5	975
FBgn0052024	1003	1000	997	9	3	3	994
FBgn0052029	1013	1000	996	30	10	3	983
FBgn0052034	1010	1000	934	86	11	7.818181818181818	924
FBgn0052036	982	929	961	74	7	10.571428571428571	908
FBgn0052037	1030	1000	983	77	11	7	953
FBgn0052039	1006	1000	1005	7	3	2.3333333333333335	999
FBgn0052040	1000	1000	998	2	2	1	998
FBgn0052056	1037	1000	1027	47	9	5.222222222222222	990
FBgn0052057	1023	1000	1010	36	10	3.6	987
FBgn0052058	1001	1000	983	19	3	6.333333333333333	982
FBgn0052061	1082	1000	1074	90	14	6.428571428571429	992
FBgn0052062	1003	1000	1000	6	4	1.5	997
FBgn0052066	1092	1000	1017	167	16	10.4375	925
FBgn0052071	1080	1000	989	171	22	7.7727272727272725	909
FBgn0052074	1008	1000	1006	10	3	3.3333333333333335	998
FBgn0052076	1041	1000	418	664	7	94.85714285714286	377
FBgn0052079	972	954	920	70	12	5.833333333333333	902
FBgn0052082	718	707	673	56	7	8	662
FBgn0052085	1024	1000	947	101	11	9.181818181818182	923
FBgn0052091	1033	1000	1003	63	9	7	970
FBgn0052100	1006	1000	982	30	9	3.3333333333333335	976
FBgn0052105	1007	1000	915	99	5	19.8	908
FBgn0052111	1048	1000	1003	93	10	9.3	955
FBgn0052112	731	720	682	60	6	10	671
FBgn0052113	1020	1000	1015	25	6	4.166666666666667	995
FBgn0052117	1000	1000	949	51	9	5.666666666666667	949
FBgn0052121	1023	1000	1016	30	4	7.5	993
FBgn0052123	1003	1000	1000	6	5	1.2	997
FBgn0052126	755	742	674	94	8	11.75	661
FBgn0052129	1000	1000	987	13	2	6.5	987
FBgn0052133	1029	1000	1014	44	12	3.6666666666666665	985
FBgn0052137	1007	1000	990	24	8	3	983
FBgn0052150	1013	1000	946	80	12	6.666666666666667	933
FBgn0052160	1003	1000	992	14	6	2.3333333333333335	989
FBgn0052163	1000	1000	987	13	3	4.333333333333333	987
FBgn0052174	927	910	916	28	6	4.666666666666667	899
FBgn0052176	1017	1000	1005	29	8	3.625	988
FBgn0052182	1048	1000	965	131	12	10.916666666666666	917
FBgn0052183	1009	1000	988	30	6	5	979
FBgn0052188	1000	1000	198	802	3	267.3333333333333	198
FBgn0052196	1033	1000	895	171	11	15.545454545454545	862
FBgn0052198	1024	1000	981	67	14	4.785714285714286	957
FBgn0052202	1012	1000	776	248	4	62	764
FBgn0052204	1004	1000	1002	6	4	1.5	998
FBgn0052206	1015	1000	971	59	6	9.833333333333334	956
FBgn0052207	1042	1000	1029	55	10	5.5	987
FBgn0052220	1040	962	1006	112	19	5.894736842105263	928
FBgn0052221	1000	1000	977	23	3	7.666666666666667	977
FBgn0052224	1045	1000	889	201	11	18.272727272727273	844
FBgn0052226	1010	1000	1004	16	4	4	994
FBgn0052227	721	711	630	101	6	16.833333333333332	620
FBgn0052228	1036	1000	962	110	14	7.857142857142857	926
FBgn0052237	1011	1000	978	44	6	7.333333333333333	967
FBgn0052240	1025	1000	955	95	10	9.5	930
FBgn0052241	1002	1000	996	8	4	2	994
FBgn0052243	1045	1000	1000	90	16	5.625	955
FBgn0052246	1027	1000	1004	50	11	4.545454545454546	977
FBgn0052248	961	952	960	10	3	3.3333333333333335	951
FBgn0052249	1023	1000	1004	42	7	6	981
FBgn0052251	1045	1000	1034	56	8	7	989
FBgn0052252	1002	1000	981	23	8	2.875	979
FBgn0052259	1076	1000	1030	122	14	8.714285714285714	954
FBgn0052263	1002	1000	981	23	7	3.2857142857142856	979
FBgn0052266	1065	1000	1008	122	16	7.625	943
FBgn0052267	1017	1000	913	121	5	24.2	896
FBgn0052268	1002	1000	990	14	5	2.8	988
FBgn0052278	846	845	844	3	3	1	843
FBgn0052279	1002	1000	998	6	4	1.5	996
FBgn0052280	1000	1000	999	1	1	1	999
FBgn0052288	1046	1000	1034	58	4	14.5	988
FBgn0052296	1025	1000	1017	33	7	4.714285714285714	992
FBgn0052301	1031	1000	870	192	8	24	839
FBgn0052303	1043	1000	1023	63	10	6.3	980
FBgn0052311	1025	1000	1009	41	7	5.857142857142857	984
FBgn0052313	1028	1000	1014	42	7	6	986
FBgn0052333	1064	1000	1056	72	12	6	992
FBgn0052357	1000	1000	996	4	2	2	996
FBgn0052360	1000	1000	985	15	4	3.75	985
FBgn0052362	1000	1000	967	33	5	6.6	967
FBgn0052364	1017	1000	987	47	6	7.833333333333333	970
FBgn0052365	1017	1000	985	49	14	3.5	968
FBgn0052368	1005	1000	778	232	2	116	773
FBgn0052369	1047	1000	1026	68	12	5.666666666666667	979
FBgn0052370	1012	1000	999	25	11	2.272727272727273	987
FBgn0052373	1031	1000	989	73	15	4.866666666666666	958
FBgn0052376	1045	1000	1026	64	10	6.4	981
FBgn0052380	1006	1000	990	22	5	4.4	984
FBgn0052382	1015	1000	988	42	5	8.4	973
FBgn0052392	1048	1000	986	110	13	8.461538461538462	938
FBgn0052405	1002	1000	995	9	4	2.25	993
FBgn0052406	1000	1000	997	3	1	3	997
FBgn0052407	1054	1000	1037	71	10	7.1	983
FBgn0052413	1008	1000	995	21	5	4.2	987
FBgn0052423	1011	1000	962	60	9	6.666666666666667	951
FBgn0052428	1002	1000	995	9	4	2.25	993
FBgn0052432	1034	1000	1017	51	8	6.375	983
FBgn0052436	1003	1000	976	30	6	5	973
FBgn0052437	1027	1000	939	115	13	8.846153846153847	912
FBgn0052438	1004	1000	987	21	4	5.25	983
FBgn0052442	1069	1000	1034	104	15	6.933333333333334	965
FBgn0052447	1020	1000	1012	28	5	5.6	992
FBgn0052448	1018	1000	746	290	21	13.80952380952381	728
FBgn0052449	1072	1000	1063	81	13	6.230769230769231	991
FBgn0052450	1034	1000	1034	34	4	8.5	1000
FBgn0052452	1007	1000	969	45	11	4.090909090909091	962
FBgn0052457	1010	1000	223	797	5	159.4	213
FBgn0052459	1011	1000	922	100	14	7.142857142857143	911
FBgn0052476	1001	1000	709	293	6	48.833333333333336	708
FBgn0052479	1021	1000	977	65	7	9.285714285714286	956
FBgn0052480	1025	1000	991	59	4	14.75	966
FBgn0052481	802	762	760	82	14	5.857142857142857	720
FBgn0052483	1023	1000	991	55	7	7.857142857142857	968
FBgn0052484	1045	1000	1004	86	8	10.75	959
FBgn0052485	698	668	688	40	8	5	658
FBgn0052487	1000	1000	982	18	5	3.6	982
FBgn0052506	1063	1000	960	166	18	9.222222222222221	897
FBgn0052512	1011	1000	929	93	13	7.153846153846154	918
FBgn0052523	1048	1000	1003	93	14	6.642857142857143	955
FBgn0052528	958	935	856	125	9	13.88888888888889	833
FBgn0052529	1013	1000	994	32	5	6.4	981
FBgn0052548	1041	1000	946	136	14	9.714285714285714	905
FBgn0052549	1022	1000	954	90	12	7.5	932
FBgn0052551	731	716	696	50	11	4.545454545454546	681
FBgn0052553	1022	1000	990	54	13	4.153846153846154	968
FBgn0052557	963	947	960	19	7	2.7142857142857144	944
FBgn0052563	792	731	757	96	8	12	696
FBgn0052564	1008	1000	965	51	9	5.666666666666667	957
FBgn0052568	1027	1000	938	116	11	10.545454545454545	911
FBgn0052569	1024	1000	977	71	10	7.1	953
FBgn0052570	1021	1000	989	53	11	4.818181818181818	968
FBgn0052571	1015	1000	974	56	7	8	959
FBgn0052574	718	670	699	67	6	11.166666666666666	651
FBgn0052576	1008	1000	1002	14	6	2.3333333333333335	994
FBgn0052579	1027	1000	1020	34	4	8.5	993
FBgn0052581	1018	1000	972	64	6	10.666666666666666	954
FBgn0052582	1009	1000	962	56	9	6.222222222222222	953
FBgn0052590	1012	1000	984	40	11	3.6363636363636362	972
FBgn0052591	1016	1000	972	60	13	4.615384615384615	956
FBgn0052600	1141	1000	1068	214	20	10.7	927
FBgn0052602	1005	1000	973	37	8	4.625	968
FBgn0052603	1016	1000	916	116	14	8.285714285714286	900
FBgn0052626	1043	1000	991	95	15	6.333333333333333	948
FBgn0052631	1027	1000	984	70	10	7	957
FBgn0052633	1013	1000	972	54	10	5.4	959
FBgn0052638	1044	1000	1033	55	6	9.166666666666666	989
FBgn0052642	1030	1000	1026	34	5	6.8	996
FBgn0052643	1023	1000	990	56	13	4.3076923076923075	967
FBgn0052647	1011	1000	961	61	15	4.066666666666666	950
FBgn0052655	1000	1000	975	25	6	4.166666666666667	975
FBgn0052666	1034	1000	1003	65	11	5.909090909090909	969
FBgn0052668	1012	1000	955	69	10	6.9	943
FBgn0052675	1007	1000	998	16	9	1.7777777777777777	991
FBgn0052676	1000	1000	984	16	2	8	984
FBgn0052679	1010	1000	976	44	8	5.5	966
FBgn0052681	1007	1000	993	21	7	3	986
FBgn0052683	1000	1000	973	27	4	6.75	973
FBgn0052685	1007	1000	807	207	11	18.818181818181817	800
FBgn0052686	1000	1000	997	3	1	3	997
FBgn0052687	1016	1000	944	88	11	8	928
FBgn0052693	1037	1000	1034	40	4	10	997
FBgn0052694	1000	1000	986	14	4	3.5	986
FBgn0052698	1003	1000	892	114	12	9.5	889
FBgn0052699	1068	1000	1042	94	16	5.875	974
FBgn0052702	1026	1000	982	70	15	4.666666666666667	956
FBgn0052703	847	807	778	109	15	7.266666666666667	738
FBgn0052704	681	675	628	59	11	5.363636363636363	622
FBgn0052712	842	835	798	51	11	4.636363636363637	791
FBgn0052713	1035	1000	885	185	26	7.115384615384615	850
FBgn0052718	1045	1000	1018	72	9	8	973
FBgn0052719	1018	1000	967	69	7	9.857142857142858	949
FBgn0052726	1016	1000	1000	32	12	2.6666666666666665	984
FBgn0052732	1023	1000	1000	46	8	5.75	977
FBgn0052740	1014	1000	1004	24	8	3	990
FBgn0052748	1046	1000	1009	83	9	9.222222222222221	963
FBgn0052758	1067	1000	1012	122	18	6.777777777777778	945
FBgn0052762	1035	1000	1006	64	12	5.333333333333333	971
FBgn0052767	1015	1000	979	51	13	3.923076923076923	964
FBgn0052773	1037	1000	886	188	18	10.444444444444445	849
FBgn0052774	1034	1000	1014	54	11	4.909090909090909	980
FBgn0052792	1070	1000	978	162	22	7.363636363636363	908
FBgn0052801	1064	1000	980	148	12	12.333333333333334	916
FBgn0052808	1003	1000	1000	6	4	1.5	997
FBgn0052813	1006	1000	957	55	11	5	951
FBgn0052815	1007	1000	1007	7	2	3.5	1000
FBgn0052816	1002	1000	699	305	6	50.833333333333336	697
FBgn0052826	1076	1000	1033	119	17	7	957
FBgn0052832	1025	1000	1014	36	8	4.5	989
FBgn0052835	1032	1000	960	104	10	10.4	928
FBgn0052843	1127	1000	1095	159	12	13.25	968
FBgn0052845	1007	1000	1004	10	4	2.5	997
FBgn0052846	1071	1000	1064	78	7	11.142857142857142	993
FBgn0052856	1000	1000	997	3	1	3	997
FBgn0052944	1053	1000	968	138	21	6.571428571428571	915
FBgn0052982	1055	1000	1032	78	14	5.571428571428571	977
FBgn0052985	1017	1000	1005	29	4	7.25	988
FBgn0052986	1015	1000	993	37	7	5.285714285714286	978
FBgn0053002	1000	1000	966	34	3	11.333333333333334	966
FBgn0053003	1021	1000	1013	29	5	5.8	992
FBgn0053012	774	773	628	147	6	24.5	627
FBgn0053017	1001	1000	989	13	5	2.6	988
FBgn0053062	1005	1000	377	633	3	211	372
FBgn0053080	1028	1000	972	84	17	4.9411764705882355	944
FBgn0053093	811	792	802	28	5	5.6	783
FBgn0053100	1004	1000	991	17	6	2.8333333333333335	987
FBgn0053107	1003	1000	1001	5	3	1.6666666666666667	998
FBgn0053108	908	908	904	4	4	1	904
FBgn0053110	1065	1000	1054	76	12	6.333333333333333	989
FBgn0053113	766	766	762	4	1	4	762
FBgn0053116	814	808	784	36	11	3.272727272727273	778
FBgn0053120	1018	1000	942	94	13	7.230769230769231	924
FBgn0053121	1037	1000	1022	52	12	4.333333333333333	985
FBgn0053124	1016	1000	999	33	9	3.6666666666666665	983
FBgn0053125	1000	1000	972	28	3	9.333333333333334	972
FBgn0053126	1000	1000	954	46	7	6.571428571428571	954
FBgn0053129	1016	1000	1007	25	5	5	991
FBgn0053136	1025	1000	989	61	11	5.545454545454546	964
FBgn0053137	756	743	672	97	6	16.166666666666668	659
FBgn0053138	936	919	929	24	6	4	912
FBgn0053143	1016	1000	1011	21	7	3	995
FBgn0053144	1045	1000	1033	57	15	3.8	988
FBgn0053147	1023	1000	1012	34	13	2.6153846153846154	989
FBgn0053156	1010	1000	985	35	10	3.5	975
FBgn0053158	1000	1000	824	176	2	88	824
FBgn0053160	1082	1000	1051	113	9	12.555555555555555	969
FBgn0053177	951	941	913	48	11	4.363636363636363	903
FBgn0053179	1030	1000	1027	33	9	3.6666666666666665	997
FBgn0053181	1059	1000	1017	101	17	5.9411764705882355	958
FBgn0053182	1021	1000	996	46	11	4.181818181818182	975
FBgn0053192	1010	1000	999	21	10	2.1	989
FBgn0053193	1013	1000	1003	23	8	2.875	990
FBgn0053196	1033	1000	1032	34	3	11.333333333333334	999
FBgn0053198	1003	1000	991	15	4	3.75	988
FBgn0053200	717	717	710	7	5	1.4	710
FBgn0053202	1001	1000	990	12	4	3	989
FBgn0053203	1009	1000	1009	9	1	9	1000
FBgn0053207	1019	1000	1016	22	7	3.142857142857143	997
FBgn0053208	1043	1000	1018	68	16	4.25	975
FBgn0053223	1020	1000	955	85	12	7.083333333333333	935
FBgn0053225	1008	1000	925	91	10	9.1	917
FBgn0053229	1044	1000	1008	80	15	5.333333333333333	964
FBgn0053233	1014	1000	974	54	4	13.5	960
FBgn0053236	1057	1000	1021	93	13	7.153846153846154	964
FBgn0053257	1001	1000	622	380	7	54.285714285714285	621
FBgn0053258	1012	1000	1005	19	3	6.333333333333333	993
FBgn0053260	1018	1000	983	53	10	5.3	965
FBgn0053262	1026	1000	970	82	15	5.466666666666667	944
FBgn0053267	1048	1000	1007	89	14	6.357142857142857	959
FBgn0053270	1128	1000	1063	193	22	8.772727272727273	935
FBgn0053271	833	791	799	76	11	6.909090909090909	757
FBgn0053272	1004	1000	449	559	4	139.75	445
FBgn0053281	1005	1000	996	14	6	2.3333333333333335	991
FBgn0053282	1070	1000	1051	89	15	5.933333333333334	981
FBgn0053284	930	926	882	52	8	6.5	878
FBgn0053286	1026	1000	1000	52	14	3.7142857142857144	974
FBgn0053288	1006	1000	997	15	3	5	991
FBgn0053289	1051	1000	968	134	27	4.962962962962963	917
FBgn0053290	1058	1000	1011	105	13	8.076923076923077	953
FBgn0053299	686	686	680	6	1	6	680
FBgn0053301	1069	1000	1002	136	17	8	933
FBgn0053303	1017	1000	1008	26	5	5.2	991
FBgn0053306	692	673	683	28	6	4.666666666666667	664
FBgn0053309	1014	1000	1012	16	4	4	998
FBgn0053325	1018	1000	1003	33	6	5.5	985
FBgn0053329	1030	1000	1008	52	10	5.2	978
FBgn0053333	1010	992	508	520	6	86.66666666666667	490
FBgn0053339	1005	1000	1002	8	4	2	997
FBgn0053341	1002	1000	1002	2	1	2	1000
FBgn0053346	1054	1000	1031	77	8	9.625	977
FBgn0053453	1056	1000	1037	75	17	4.411764705882353	981
FBgn0053454	934	878	867	123	13	9.461538461538462	811
FBgn0053458	1023	1000	977	69	17	4.0588235294117645	954
FBgn0053465	1096	1000	969	223	23	9.695652173913043	873
FBgn0053467	1009	1000	694	324	6	54	685
FBgn0053508	1057	1000	1000	114	11	10.363636363636363	943
FBgn0053512	1005	1000	983	27	7	3.857142857142857	978
FBgn0053513	1012	1000	1000	24	5	4.8	988
FBgn0053517	1055	1000	1001	109	7	15.571428571428571	946
FBgn0053519	727	718	685	51	8	6.375	676
FBgn0053526	1010	1000	984	36	11	3.272727272727273	974
FBgn0053530	1000	1000	996	4	4	1	996
FBgn0053531	1001	1000	973	29	4	7.25	972
FBgn0053534	1039	1000	1034	44	5	8.8	995
FBgn0053536	1048	1000	1011	85	13	6.538461538461538	963
FBgn0053542	1033	1000	1013	53	14	3.7857142857142856	980
FBgn0053544	1054	1000	1035	73	15	4.866666666666666	981
FBgn0053547	1026	1000	979	73	16	4.5625	953
FBgn0053548	1054	1000	1021	87	8	10.875	967
FBgn0053551	983	980	949	37	4	9.25	946
FBgn0053556	1000	1000	143	857	2	428.5	143
FBgn0053557	1009	1000	855	163	13	12.538461538461538	846
FBgn0053629	714	714	681	33	3	11	681
FBgn0053632	919	838	901	99	11	9	820
FBgn0053635	1011	1000	1004	18	8	2.25	993
FBgn0053639	1018	1000	978	58	8	7.25	960
FBgn0053647	1009	1000	430	588	17	34.588235294117645	421
FBgn0053648	1017	1000	978	56	10	5.6	961
FBgn0053653	1038	1000	990	86	15	5.733333333333333	952
FBgn0053654	1011	1000	999	23	3	7.666666666666667	988
FBgn0053658	1027	1000	1003	51	12	4.25	976
FBgn0053673	1023	1000	994	52	11	4.7272727272727275	971
FBgn0053679	1066	1000	1050	82	10	8.2	984
FBgn0053687	1021	1000	949	93	15	6.2	928
FBgn0053696	1014	1000	1006	22	5	4.4	992
FBgn0053700	1022	1000	974	70	8	8.75	952
FBgn0053704	1012	1000	963	61	8	7.625	951
FBgn0053723	1016	1000	981	51	8	6.375	965
FBgn0053725	1028	1000	978	78	13	6	950
FBgn0053764	1015	1000	934	96	10	9.6	919
FBgn0053766	1012	1000	902	122	11	11.090909090909092	890
FBgn0053772	1002	1000	1000	4	4	1	998
FBgn0053773	1014	1000	1002	26	5	5.2	988
FBgn0053774	733	705	702	59	12	4.916666666666667	674
FBgn0053775	1061	1000	1023	99	18	5.5	962
FBgn0053777	1017	1000	993	41	9	4.555555555555555	976
FBgn0053792	1015	1000	1011	19	4	4.75	996
FBgn0053795	1041	1000	979	103	16	6.4375	938
FBgn0053912	1036	1000	742	330	9	36.666666666666664	706
FBgn0053922	1026	1000	951	101	11	9.181818181818182	925
FBgn0053923	1015	1000	953	77	13	5.923076923076923	938
FBgn0053929	1006	1000	667	345	8	43.125	661
FBgn0053958	1084	1000	1053	115	16	7.1875	969
FBgn0053969	1014	1000	1001	27	9	3	987
FBgn0053978	1041	1000	529	553	13	42.53846153846154	488
FBgn0053983	1015	1000	1005	25	7	3.5714285714285716	990
FBgn0053988	1006	1000	778	234	5	46.8	772
FBgn0053993	1077	1000	1057	97	10	9.7	980
FBgn0054005	1002	1000	993	11	4	2.75	991
FBgn0054007	1044	1000	1019	69	9	7.666666666666667	975
FBgn0054008	1013	977	998	51	8	6.375	962
FBgn0054012	1010	1000	935	85	5	17	925
FBgn0054015	1016	1000	908	124	8	15.5	892
FBgn0054024	1016	1000	966	66	8	8.25	950
FBgn0054025	1012	1000	1012	12	2	6	1000
FBgn0054026	1006	1000	954	58	12	4.833333333333333	948
FBgn0054028	1022	1000	969	75	16	4.6875	947
FBgn0054029	1018	1000	928	108	8	13.5	910
FBgn0054033	1017	1000	988	46	12	3.8333333333333335	971
FBgn0054034	1043	1000	1012	74	10	7.4	969
FBgn0054040	757	747	749	18	5	3.6	739
FBgn0054043	1052	1000	1007	97	14	6.928571428571429	955
FBgn0054046	1002	1000	627	377	6	62.833333333333336	625
FBgn0054047	1001	1000	995	7	4	1.75	994
FBgn0054049	1012	1000	953	71	15	4.733333333333333	941
FBgn0054052	1028	1000	950	106	21	5.0476190476190474	922
FBgn0054054	862	842	833	49	11	4.454545454545454	813
FBgn0054056	1020	1000	1008	32	7	4.571428571428571	988
FBgn0058002	1002	1000	336	668	7	95.42857142857143	334
FBgn0058005	1035	1000	771	299	19	15.736842105263158	736
FBgn0058006	1040	1000	991	89	13	6.846153846153846	951
FBgn0058172	1010	1000	993	27	8	3.375	983
FBgn0060296	768	742	728	66	9	7.333333333333333	702
FBgn0061188	1005	1000	947	63	4	15.75	942
FBgn0061197	1023	1000	962	84	11	7.636363636363637	939
FBgn0061198	1008	1000	971	45	9	5	963
FBgn0061200	1070	1000	1004	136	14	9.714285714285714	934
FBgn0061435	1037	1000	1016	58	6	9.666666666666666	979
FBgn0061469	1005	1000	1005	5	1	5	1000
FBgn0061476	1010	1000	1007	13	3	4.333333333333333	997
FBgn0061492	1028	1000	1024	32	10	3.2	996
FBgn0061515	1007	1000	982	32	7	4.571428571428571	975
FBgn0062411	1001	1000	994	8	3	2.6666666666666665	993
FBgn0062413	1000	1000	999	1	1	1	999
FBgn0062440	1006	1000	959	53	11	4.818181818181818	953
FBgn0062442	1000	1000	996	4	2	2	996
FBgn0062449	1032	1000	983	81	10	8.1	951
FBgn0062517	741	734	729	19	4	4.75	722
FBgn0062961	1100	1000	1093	107	16	6.6875	993
FBgn0063083	1040	1000	1022	58	8	7.25	982
FBgn0063298	1012	1000	997	27	5	5.4	985
FBgn0063449	1041	1000	1032	50	4	12.5	991
FBgn0063494	715	708	634	88	11	8	627
FBgn0063649	1004	1000	995	13	6	2.1666666666666665	991
FBgn0063670	1014	1000	469	559	6	93.16666666666667	455
FBgn0064237	1007	1000	983	31	10	3.1	976
FBgn0064766	1002	1000	968	36	4	9	966
FBgn0065035	1000	1000	587	413	2	206.5	587
FBgn0065046	1000	1000	791	209	9	23.22222222222222	791
FBgn0065098	1004	1000	987	21	4	5.25	983
FBgn0065104	859	857	838	23	7	3.2857142857142856	836
FBgn0066084	1000	1000	991	9	2	4.5	991
FBgn0066101	1017	1000	998	36	5	7.2	981
FBgn0067052	1025	1000	984	66	8	8.25	959
FBgn0067102	1039	1000	1020	58	12	4.833333333333333	981
FBgn0067312	1037	1000	949	125	20	6.25	912
FBgn0067317	1000	1000	977	23	5	4.6	977
FBgn0067407	1022	1000	1002	42	8	5.25	980
FBgn0067783	1072	1000	999	145	10	14.5	927
FBgn0067905	1030	1000	1015	45	15	3	985
FBgn0069354	824	823	781	44	8	5.5	780
FBgn0069913	1016	1000	974	58	10	5.8	958
FBgn0069973	1011	1000	594	428	13	32.92307692307692	583
FBgn0082585	1039	1000	1035	43	11	3.909090909090909	996
FBgn0082598	1000	1000	586	414	2	207	586
FBgn0082831	1006	1000	994	18	5	3.6	988
FBgn0082922	1008	1000	980	36	8	4.5	972
FBgn0083039	1037	1000	1026	48	7	6.857142857142857	989
FBgn0083068	1017	1000	957	77	7	11	940
FBgn0083120	1049	1000	1020	78	12	6.5	971
FBgn0083123	1011	1000	1005	17	5	3.4	994
FBgn0083141	1049	1000	888	210	11	19.09090909090909	839
FBgn0083167	1039	1000	997	81	5	16.2	958
FBgn0083228	1039	1000	1012	66	10	6.6	973
FBgn0083938	1004	1000	979	29	7	4.142857142857143	975
FBgn0083940	1000	1000	982	18	2	9	982
FBgn0083943	1000	1000	979	21	2	10.5	979
FBgn0083945	1005	1000	974	36	10	3.6	969
FBgn0083946	1080	1000	1020	140	19	7.368421052631579	940
FBgn0083949	863	856	838	32	7	4.571428571428571	831
FBgn0083950	1057	1000	1039	75	13	5.769230769230769	982
FBgn0083951	1027	1000	952	102	14	7.285714285714286	925
FBgn0083952	906	903	897	12	2	6	894
FBgn0083956	1017	1000	618	416	6	69.33333333333333	601
FBgn0083962	1007	1000	997	17	3	5.666666666666667	990
FBgn0083963	1027	1000	733	321	8	40.125	706
FBgn0083965	1010	1000	944	76	12	6.333333333333333	934
FBgn0083968	1001	1000	974	28	3	9.333333333333334	973
FBgn0083969	1014	1000	1006	22	5	4.4	992
FBgn0083972	1072	1000	1033	111	9	12.333333333333334	961
FBgn0083974	1012	1000	1005	19	3	6.333333333333333	993
FBgn0083975	1002	1000	947	57	8	7.125	945
FBgn0083978	1018	1000	983	53	8	6.625	965
FBgn0083981	1022	1000	971	73	4	18.25	949
FBgn0083983	1011	1000	1004	18	8	2.25	993
FBgn0083986	1024	1000	1019	29	7	4.142857142857143	995
FBgn0083987	1003	1000	998	8	6	1.3333333333333333	995
FBgn0083991	1011	1000	972	50	10	5	961
FBgn0083992	1005	1000	974	36	5	7.2	969
FBgn0083994	1059	1000	736	382	11	34.72727272727273	677
FBgn0084001	1079	1000	1016	142	16	8.875	937
FBgn0085188	1015	1000	991	39	10	3.9	976
FBgn0085190	1006	1000	998	14	5	2.8	992
FBgn0085191	1036	1000	1036	36	4	9	1000
FBgn0085192	1012	1000	1007	17	5	3.4	995
FBgn0085194	728	697	720	39	4	9.75	689
FBgn0085195	1015	1000	954	76	15	5.066666666666666	939
FBgn0085198	1015	1000	956	74	9	8.222222222222221	941
FBgn0085199	1000	1000	996	4	3	1.3333333333333333	996
FBgn0085201	1017	1000	1013	21	7	3	996
FBgn0085202	1040	1000	741	339	15	22.6	701
FBgn0085203	1023	1000	990	56	8	7	967
FBgn0085204	1031	1000	966	96	9	10.666666666666666	935
FBgn0085205	1043	1000	1020	66	8	8.25	977
FBgn0085209	1002	1000	987	17	6	2.8333333333333335	985
FBgn0085210	1009	1000	1004	14	6	2.3333333333333335	995
FBgn0085217	1030	1000	1005	55	7	7.857142857142857	975
FBgn0085218	1000	1000	998	2	1	2	998
FBgn0085220	1000	1000	997	3	1	3	997
FBgn0085222	1015	1000	999	31	5	6.2	984
FBgn0085225	1016	1000	990	42	9	4.666666666666667	974
FBgn0085228	1036	1000	1030	42	6	7	994
FBgn0085229	1001	1000	108	894	5	178.8	107
FBgn0085230	1063	1000	1046	80	10	8	983
FBgn0085232	1005	1000	993	17	6	2.8333333333333335	988
FBgn0085233	1021	1000	967	75	17	4.411764705882353	946
FBgn0085234	1015	1000	1006	24	4	6	991
FBgn0085235	1018	1000	1015	21	5	4.2	997
FBgn0085237	717	713	700	21	5	4.2	696
FBgn0085239	1040	1000	1026	54	7	7.714285714285714	986
FBgn0085240	1014	1000	645	383	9	42.55555555555556	631
FBgn0085241	1004	1000	986	22	5	4.4	982
FBgn0085242	1005	1000	991	19	8	2.375	986
FBgn0085244	1001	1000	955	47	5	9.4	954
FBgn0085246	689	689	659	30	4	7.5	659
FBgn0085250	1075	1000	1056	94	9	10.444444444444445	981
FBgn0085257	1022	1000	1015	29	7	4.142857142857143	993
FBgn0085259	717	707	691	36	6	6	681
FBgn0085260	1043	1000	1030	56	14	4	987
FBgn0085261	1060	1000	1003	117	15	7.8	943
FBgn0085263	1012	1000	1009	15	2	7.5	997
FBgn0085265	1014	1000	1004	24	14	1.7142857142857142	990
FBgn0085267	1035	1000	961	109	12	9.083333333333334	926
FBgn0085271	1008	1000	967	49	7	7	959
FBgn0085273	1001	1000	936	66	4	16.5	935
FBgn0085274	1030	1000	1017	43	6	7.166666666666667	987
FBgn0085276	1019	1000	1013	25	5	5	994
FBgn0085277	1003	1000	997	9	3	3	994
FBgn0085280	1090	1000	1080	100	10	10	990
FBgn0085285	1010	1000	1009	11	2	5.5	999
FBgn0085288	1016	1000	896	136	9	15.11111111111111	880
FBgn0085289	1010	1000	997	23	6	3.8333333333333335	987
FBgn0085290	695	694	684	12	2	6	683
FBgn0085294	790	783	774	23	10	2.3	767
FBgn0085295	1009	1000	986	32	9	3.5555555555555554	977
FBgn0085300	1001	1000	999	3	2	1.5	998
FBgn0085302	1004	1000	1000	8	3	2.6666666666666665	996
FBgn0085303	1023	1000	1007	39	6	6.5	984
FBgn0085307	1039	1000	940	138	16	8.625	901
FBgn0085310	1066	1000	1041	91	12	7.583333333333333	975
FBgn0085311	1016	1000	999	33	11	3	983
FBgn0085312	1053	1000	665	441	12	36.75	612
FBgn0085313	1021	1000	1008	34	9	3.7777777777777777	987
FBgn0085314	1000	1000	998	2	2	1	998
FBgn0085315	1018	1000	936	100	6	16.666666666666668	918
FBgn0085316	1003	1000	989	17	5	3.4	986
FBgn0085317	1014	1000	1012	16	6	2.6666666666666665	998
FBgn0085318	1006	1000	942	70	7	10	936
FBgn0085319	1001	1000	989	13	6	2.1666666666666665	988
FBgn0085320	1005	1000	989	21	5	4.2	984
FBgn0085321	1000	1000	988	12	5	2.4	988
FBgn0085322	1017	1000	1007	27	5	5.4	990
FBgn0085324	1024	1000	996	52	6	8.666666666666666	972
FBgn0085326	1006	1000	668	344	7	49.142857142857146	662
FBgn0085329	1077	1000	1039	115	20	5.75	962
FBgn0085330	1000	1000	993	7	2	3.5	993
FBgn0085332	1006	1000	733	279	10	27.9	727
FBgn0085334	1079	1000	922	236	20	11.8	843
FBgn0085336	1000	1000	1000	0	0	NA	1000
FBgn0085340	1016	1000	682	350	8	43.75	666
FBgn0085349	1007	1000	783	231	9	25.666666666666668	776
FBgn0085351	1000	1000	986	14	3	4.666666666666667	986
FBgn0085353	1024	1000	1002	46	13	3.5384615384615383	978
FBgn0085358	1043	1000	842	244	12	20.333333333333332	799
FBgn0085359	1057	1000	1014	100	14	7.142857142857143	957
FBgn0085360	1048	1000	957	139	15	9.266666666666667	909
FBgn0085362	1031	1000	1017	45	6	7.5	986
FBgn0085366	1012	1000	952	72	13	5.538461538461538	940
FBgn0085367	1033	1000	991	75	13	5.769230769230769	958
FBgn0085369	1021	1000	1009	33	8	4.125	988
FBgn0085370	1012	1000	992	32	6	5.333333333333333	980
FBgn0085371	1032	1000	1005	59	14	4.214285714285714	973
FBgn0085374	1070	1000	1011	129	15	8.6	941
FBgn0085376	1034	1000	1009	59	8	7.375	975
FBgn0085377	1020	1000	1000	40	7	5.714285714285714	980
FBgn0085380	1014	1000	996	32	7	4.571428571428571	982
FBgn0085382	1031	1000	1023	39	11	3.5454545454545454	992
FBgn0085383	1036	1000	1020	52	8	6.5	984
FBgn0085384	1005	1000	989	21	3	7	984
FBgn0085385	1023	1000	903	143	11	13	880
FBgn0085387	1006	1000	974	38	7	5.428571428571429	968
FBgn0085390	1027	1000	984	70	11	6.363636363636363	957
FBgn0085391	1017	1000	1005	29	10	2.9	988
FBgn0085395	1013	1000	1007	19	7	2.7142857142857144	994
FBgn0085396	913	904	886	36	7	5.142857142857143	877
FBgn0085397	1049	1000	1044	54	6	9	995
FBgn0085398	1000	1000	877	123	6	20.5	877
FBgn0085400	1022	1000	1011	33	11	3	989
FBgn0085404	1012	1000	1008	16	3	5.333333333333333	996
FBgn0085405	1014	1000	1012	16	6	2.6666666666666665	998
FBgn0085407	1013	1000	1001	25	10	2.5	988
FBgn0085408	1063	1000	1031	95	17	5.588235294117647	968
FBgn0085409	1000	1000	985	15	3	5	985
FBgn0085410	1065	1000	1002	128	16	8	937
FBgn0085411	1012	1000	949	75	11	6.818181818181818	937
FBgn0085414	1001	1000	990	12	2	6	989
FBgn0085415	1020	1000	890	150	11	13.636363636363637	870
FBgn0085417	1034	1000	1016	52	9	5.777777777777778	982
FBgn0085419	1005	1000	997	13	3	4.333333333333333	992
FBgn0085420	1013	1000	1010	16	6	2.6666666666666665	997
FBgn0085422	1019	1000	1017	21	4	5.25	998
FBgn0085424	1004	1000	990	18	5	3.6	986
FBgn0085425	1020	1000	921	119	11	10.818181818181818	901
FBgn0085426	1002	1000	903	101	17	5.9411764705882355	901
FBgn0085427	1007	1000	992	22	4	5.5	985
FBgn0085428	1019	1000	1006	32	5	6.4	987
FBgn0085430	1000	1000	1000	0	0	NA	1000
FBgn0085431	714	714	657	57	3	19	657
FBgn0085432	1012	1000	947	77	15	5.133333333333334	935
FBgn0085434	1022	1000	1022	22	4	5.5	1000
FBgn0085436	1025	1000	1010	40	8	5	985
FBgn0085437	831	806	807	49	8	6.125	782
FBgn0085443	1066	1000	1033	99	12	8.25	967
FBgn0085444	1005	1000	1001	9	3	3	996
FBgn0085446	1019	1000	1000	38	13	2.923076923076923	981
FBgn0085447	793	793	789	4	3	1.3333333333333333	789
FBgn0085450	1045	1000	998	92	16	5.75	953
FBgn0085455	1000	1000	950	50	3	16.666666666666668	950
FBgn0085456	1000	1000	981	19	4	4.75	981
FBgn0085457	1008	1000	1006	10	4	2.5	998
FBgn0085461	1008	1000	978	38	10	3.8	970
FBgn0085465	1029	1000	1022	36	7	5.142857142857143	993
FBgn0085468	1043	1000	1039	47	6	7.833333333333333	996
FBgn0085474	810	738	762	120	10	12	690
FBgn0085476	1034	1000	1023	45	8	5.625	989
FBgn0085478	1002	1000	998	6	4	1.5	996
FBgn0085480	1045	1000	1045	45	4	11.25	1000
FBgn0085481	882	871	878	15	4	3.75	867
FBgn0085482	1007	1000	744	270	11	24.545454545454547	737
FBgn0085484	860	825	814	81	10	8.1	779
FBgn0085486	1027	1000	1020	34	7	4.857142857142857	993
FBgn0085488	1018	1000	960	76	14	5.428571428571429	942
FBgn0085491	1001	1000	992	10	7	1.4285714285714286	991
FBgn0085582	1011	1000	968	54	11	4.909090909090909	957
FBgn0086074	694	679	687	22	6	3.6666666666666665	672
FBgn0086200	1003	1000	996	10	4	2.5	993
FBgn0086253	1001	1000	989	13	4	3.25	988
FBgn0086266	1015	1000	744	286	9	31.77777777777778	729
FBgn0086346	1005	1000	984	26	4	6.5	979
FBgn0086347	1000	1000	994	6	3	2	994
FBgn0086350	1000	1000	975	25	3	8.333333333333334	975
FBgn0086355	694	675	684	29	5	5.8	665
FBgn0086356	1002	1000	982	22	6	3.6666666666666665	980
FBgn0086358	1007	1000	999	15	8	1.875	992
FBgn0086362	1006	1000	996	16	7	2.2857142857142856	990
FBgn0086365	1041	1000	1023	59	12	4.916666666666667	982
FBgn0086367	1052	1000	1025	79	17	4.647058823529412	973
FBgn0086368	1015	1000	953	77	12	6.416666666666667	938
FBgn0086370	1001	1000	998	4	4	1	997
FBgn0086371	1016	1000	989	43	12	3.5833333333333335	973
FBgn0086372	1018	1000	1006	30	9	3.3333333333333335	988
FBgn0086384	1050	1000	986	114	12	9.5	936
FBgn0086442	1015	1000	1008	22	6	3.6666666666666665	993
FBgn0086443	1034	1000	1021	47	6	7.833333333333333	987
FBgn0086444	1012	1000	916	108	7	15.428571428571429	904
FBgn0086445	1012	1000	1002	22	6	3.6666666666666665	990
FBgn0086446	1038	1000	1025	51	7	7.285714285714286	987
FBgn0086447	1030	1000	1008	52	11	4.7272727272727275	978
FBgn0086448	1005	1000	962	48	10	4.8	957
FBgn0086450	1040	1000	962	118	17	6.9411764705882355	922
FBgn0086472	1029	1000	1023	35	2	17.5	994
FBgn0086532	1006	1000	945	67	8	8.375	939
FBgn0086604	1032	1000	993	71	15	4.733333333333333	961
FBgn0086608	1115	1000	1036	194	17	11.411764705882353	921
FBgn0086655	1034	1000	1026	42	8	5.25	992
FBgn0086656	1004	1000	1001	7	2	3.5	997
FBgn0086657	1016	1000	999	33	6	5.5	983
FBgn0086659	1024	1000	1000	48	11	4.363636363636363	976
FBgn0086673	1019	1000	998	40	11	3.6363636363636362	979
FBgn0086675	1028	1000	974	82	20	4.1	946
FBgn0086677	1020	1000	975	65	8	8.125	955
FBgn0086679	1013	1000	978	48	12	4	965
FBgn0086680	1060	1000	1029	91	10	9.1	969
FBgn0086681	1002	1000	955	49	7	7	953
FBgn0086683	1023	1000	466	580	10	58	443
FBgn0086686	1056	1000	768	344	15	22.933333333333334	712
FBgn0086687	1020	1000	1010	30	9	3.3333333333333335	990
FBgn0086690	1008	1000	918	98	11	8.909090909090908	910
FBgn0086691	1007	1000	818	196	8	24.5	811
FBgn0086693	1021	1000	1016	26	6	4.333333333333333	995
FBgn0086695	1000	1000	932	68	2	34	932
FBgn0086698	1035	1000	994	76	12	6.333333333333333	959
FBgn0086704	1023	1000	999	47	11	4.2727272727272725	976
FBgn0086707	729	676	706	76	11	6.909090909090909	653
FBgn0086708	1011	1000	1002	20	11	1.8181818181818181	991
FBgn0086711	1044	1000	1013	75	12	6.25	969
FBgn0086712	1015	1000	973	57	12	4.75	958
FBgn0086757	1028	1000	921	135	10	13.5	893
FBgn0086758	1037	1000	1017	57	11	5.181818181818182	980
FBgn0086778	1099	1000	1026	172	16	10.75	927
FBgn0086779	1003	1000	622	384	3	128	619
FBgn0086782	1024	1000	942	106	12	8.833333333333334	918
FBgn0086784	1012	1000	980	44	5	8.8	968
FBgn0086785	1006	1000	987	25	6	4.166666666666667	981
FBgn0086855	1015	1000	1011	19	2	9.5	996
FBgn0086856	1036	1000	1020	52	6	8.666666666666666	984
FBgn0086895	1001	1000	1000	2	2	1	999
FBgn0086898	1000	1000	1000	0	0	NA	1000
FBgn0086904	1019	1000	1018	20	4	5	999
FBgn0086906	1029	1000	1012	46	8	5.75	983
FBgn0086907	1048	1000	1035	61	10	6.1	987
FBgn0086909	1011	1000	1000	22	7	3.142857142857143	989
FBgn0086912	1032	1000	1016	48	13	3.6923076923076925	984
FBgn0086916	1001	1000	989	13	8	1.625	988
FBgn0086917	1000	1000	35	965	2	482.5	35
FBgn0087002	1065	1000	1052	78	13	6	987
FBgn0087007	1009	1000	1008	10	5	2	999
FBgn0087008	1085	1000	996	174	22	7.909090909090909	911
FBgn0087013	1000	1000	47	953	2	476.5	47
FBgn0087021	1008	1000	992	24	11	2.1818181818181817	984
FBgn0243511	1087	1000	1068	106	9	11.777777777777779	981
FBgn0243513	1004	1000	1004	4	1	4	1000
FBgn0243514	1053	1000	976	130	14	9.285714285714286	923
FBgn0243516	1002	1000	1001	3	3	1	999
FBgn0243586	1020	1000	1019	21	3	7	999
FBgn0250732	1034	1000	1028	40	4	10	994
FBgn0250746	851	793	815	94	14	6.714285714285714	757
FBgn0250753	1017	1000	1012	22	8	2.75	995
FBgn0250754	1014	1000	970	58	9	6.444444444444445	956
FBgn0250755	1026	1000	1023	29	4	7.25	997
FBgn0250757	1010	1000	1010	10	5	2	1000
FBgn0250786	1019	1000	1015	23	6	3.8333333333333335	996
FBgn0250788	1025	1000	1003	47	10	4.7	978
FBgn0250791	787	758	778	38	11	3.4545454545454546	749
FBgn0250815	1018	1000	1008	28	5	5.6	990
FBgn0250817	1023	1000	956	90	10	9	933
FBgn0250821	1019	1000	440	598	6	99.66666666666667	421
FBgn0250822	1010	1000	998	22	5	4.4	988
FBgn0250823	1033	1000	1032	34	2	17	999
FBgn0250825	1024	1000	989	59	12	4.916666666666667	965
FBgn0250827	1004	1000	954	54	6	9	950
FBgn0250831	1042	1000	1032	52	10	5.2	990
FBgn0250833	1076	1000	1070	82	9	9.11111111111111	994
FBgn0250835	1018	1000	1004	32	5	6.4	986
FBgn0250837	1000	1000	795	205	1	205	795
FBgn0250838	1009	1000	993	25	4	6.25	984
FBgn0250839	1042	1000	935	149	11	13.545454545454545	893
FBgn0250841	1013	1000	986	40	7	5.714285714285714	973
FBgn0250843	1010	1000	1002	18	4	4.5	992
FBgn0250844	1016	1000	1000	32	4	8	984
FBgn0250845	1009	1000	970	48	6	8	961
FBgn0250846	1061	1000	970	152	10	15.2	909
FBgn0250847	1036	1000	985	87	13	6.6923076923076925	949
FBgn0250848	1042	1000	993	91	15	6.066666666666666	951
FBgn0250850	1002	1000	996	8	4	2	994
FBgn0250867	1056	1000	1020	92	16	5.75	964
FBgn0250868	827	826	808	20	4	5	807
FBgn0250869	1003	1000	1003	3	2	1.5	1000
FBgn0250874	1076	1000	968	184	5	36.8	892
FBgn0250906	1003	1000	998	8	5	1.6	995
FBgn0250908	1055	1000	1019	91	10	9.1	964
FBgn0250910	1019	1000	1006	32	6	5.333333333333333	987
FBgn0259098	1006	1000	980	32	10	3.2	974
FBgn0259099	1025	1000	946	104	12	8.666666666666666	921
FBgn0259108	1016	1000	998	34	3	11.333333333333334	982
FBgn0259110	1034	1000	940	128	16	8	906
FBgn0259112	1000	1000	1000	0	0	NA	1000
FBgn0259113	1070	1000	1051	89	14	6.357142857142857	981
FBgn0259139	1010	1000	945	75	8	9.375	935
FBgn0259143	1009	1000	990	28	8	3.5	981
FBgn0259145	1010	1000	1001	19	7	2.7142857142857144	991
FBgn0259146	1002	1000	982	22	4	5.5	980
FBgn0259148	1034	1000	1008	60	10	6	974
FBgn0259149	700	688	650	62	10	6.2	638
FBgn0259150	1005	1000	936	74	11	6.7272727272727275	931
FBgn0259152	1000	1000	1000	0	0	NA	1000
FBgn0259162	1066	1000	1027	105	18	5.833333333333333	961
FBgn0259163	1022	1000	977	67	8	8.375	955
FBgn0259167	1029	1000	1003	55	10	5.5	974
FBgn0259168	1008	1000	968	48	8	6	960
FBgn0259173	1030	1000	949	111	14	7.928571428571429	919
FBgn0259174	1000	1000	963	37	3	12.333333333333334	963
FBgn0259175	1007	1000	937	77	9	8.555555555555555	930
FBgn0259176	1023	1000	983	63	18	3.5	960
FBgn0259178	1021	1000	1006	36	7	5.142857142857143	985
FBgn0259183	1005	1000	928	82	11	7.454545454545454	923
FBgn0259185	1040	1000	1028	52	14	3.7142857142857144	988
FBgn0259188	1037	1000	1036	38	6	6.333333333333333	999
FBgn0259190	994	963	947	78	13	6	916
FBgn0259193	1048	1000	954	142	17	8.352941176470589	906
FBgn0259209	1021	1000	987	55	7	7.857142857142857	966
FBgn0259210	1006	1000	965	47	3	15.666666666666666	959
FBgn0259211	1027	1000	1018	36	8	4.5	991
FBgn0259213	1014	1000	986	42	11	3.8181818181818183	972
FBgn0259214	1018	1000	421	615	5	123	403
FBgn0259215	1030	1000	1004	56	8	7	974
FBgn0259221	1061	1000	1024	98	9	10.88888888888889	963
FBgn0259222	1014	1000	994	34	6	5.666666666666667	980
FBgn0259223	1044	1000	791	297	13	22.846153846153847	747
FBgn0259224	1026	1000	1008	44	12	3.6666666666666665	982
FBgn0259226	1031	1000	985	77	9	8.555555555555555	954
FBgn0259227	975	961	970	19	6	3.1666666666666665	956
FBgn0259228	1021	1000	1021	21	5	4.2	1000
FBgn0259229	1026	1000	992	60	8	7.5	966
FBgn0259230	1000	1000	985	15	4	3.75	985
FBgn0259233	1058	1000	1011	105	12	8.75	953
FBgn0259236	1007	1000	997	17	6	2.8333333333333335	990
FBgn0259237	1007	1000	983	31	11	2.8181818181818183	976
FBgn0259242	1012	1000	1010	14	4	3.5	998
FBgn0259243	1003	1000	1003	3	3	1	1000
FBgn0259244	1054	1000	984	124	14	8.857142857142858	930
FBgn0259245	1067	1000	977	157	15	10.466666666666667	910
FBgn0259246	752	725	736	43	8	5.375	709
FBgn0259481	1002	1000	870	134	5	26.8	868
FBgn0259483	1007	1000	999	15	4	3.75	992
FBgn0259677	1016	1000	990	42	9	4.666666666666667	974
FBgn0259678	1004	1000	994	14	6	2.3333333333333335	990
FBgn0259685	1022	1000	1015	29	8	3.625	993
FBgn0259701	1020	1000	1016	24	5	4.8	996
FBgn0259702	1027	1000	997	57	9	6.333333333333333	970
FBgn0259710	772	756	749	39	8	4.875	733
FBgn0259712	1013	1000	1005	21	5	4.2	992
FBgn0259714	1000	1000	965	35	7	5	965
FBgn0259722	1087	1000	1047	127	16	7.9375	960
FBgn0259734	1088	1000	1079	97	13	7.461538461538462	991
FBgn0259735	1047	1000	1036	58	6	9.666666666666666	989
FBgn0259736	1024	1000	1018	30	4	7.5	994
FBgn0259739	1000	1000	32	968	2	484	32
FBgn0259740	1017	1000	1002	32	10	3.2	985
FBgn0259742	1004	1000	995	13	4	3.25	991
FBgn0259745	1031	1000	985	77	14	5.5	954
FBgn0259749	923	894	897	55	11	5	868
FBgn0259785	1011	1000	998	24	5	4.8	987
FBgn0259791	1014	1000	1010	18	4	4.5	996
FBgn0259794	1036	1000	972	100	14	7.142857142857143	936
FBgn0259795	1021	1000	950	92	15	6.133333333333334	929
FBgn0259821	1000	1000	359	641	5	128.2	359
FBgn0259823	1051	1000	1034	68	9	7.555555555555555	983
FBgn0259831	1051	1000	1032	70	10	7	981
FBgn0259832	1028	1000	999	57	6	9.5	971
FBgn0259876	1056	1000	1017	95	13	7.3076923076923075	961
FBgn0259878	1020	1000	953	87	16	5.4375	933
FBgn0259896	1012	1000	999	25	8	3.125	987
FBgn0259922	1002	1000	998	6	5	1.2	996
FBgn0259926	814	796	689	143	10	14.3	671
FBgn0259935	1016	1000	988	44	7	6.285714285714286	972
FBgn0259936	679	670	662	26	7	3.7142857142857144	653
FBgn0259937	1009	1000	999	19	3	6.333333333333333	990
FBgn0259938	1024	1000	1006	42	9	4.666666666666667	982
FBgn0259950	1002	1000	660	344	4	86	658
FBgn0259954	1017	1000	1011	23	5	4.6	994
FBgn0259958	1002	1000	984	20	6	3.3333333333333335	982
FBgn0259959	1034	1000	907	161	16	10.0625	873
FBgn0259962	1001	1000	968	34	6	5.666666666666667	967
FBgn0259964	1046	1000	935	157	10	15.7	889
FBgn0259965	1000	1000	540	460	4	115	540
FBgn0259966	1047	992	991	111	12	9.25	936
FBgn0259969	1020	1000	1009	31	6	5.166666666666667	989
FBgn0259970	788	788	769	19	4	4.75	769
FBgn0259971	977	906	649	399	10	39.9	578
FBgn0259972	1024	1000	1005	43	5	8.6	981
FBgn0259973	1031	1000	873	189	8	23.625	842
FBgn0259974	1040	1000	1008	72	11	6.545454545454546	968
FBgn0259977	1011	1000	1011	11	4	2.75	1000
FBgn0259982	1008	1000	995	21	6	3.5	987
FBgn0259984	1021	1000	1002	40	10	4	981
FBgn0259985	1041	1000	1036	46	5	9.2	995
FBgn0259986	1032	1000	1017	47	10	4.7	985
FBgn0259992	1020	1000	1011	29	7	4.142857142857143	991
FBgn0259994	1032	1000	974	90	14	6.428571428571429	942
FBgn0259996	1006	1000	987	25	7	3.5714285714285716	981
FBgn0259998	1043	1000	1005	81	10	8.1	962
FBgn0260000	1003	1000	973	33	5	6.6	970
FBgn0260003	1055	1000	1012	98	9	10.88888888888889	957
FBgn0260004	1044	1000	984	104	14	7.428571428571429	940
FBgn0260005	1005	1000	977	33	6	5.5	972
FBgn0260006	1012	1000	954	70	12	5.833333333333333	942
FBgn0260008	1002	1000	143	861	3	287	141
FBgn0260012	1036	1000	1026	46	5	9.2	990
FBgn0260027	1023	1000	1012	34	8	4.25	989
FBgn0260049	1000	1000	744	256	1	256	744
FBgn0260243	1001	1000	999	3	2	1.5	998
FBgn0260392	1001	1000	998	4	2	2	997
FBgn0260393	1010	1000	910	110	9	12.222222222222221	900
FBgn0260396	1022	1000	998	46	8	5.75	976
FBgn0260399	1006	1000	971	41	5	8.2	965
FBgn0260407	1000	1000	988	12	5	2.4	988
FBgn0260428	1000	1000	979	21	3	7	979
FBgn0260429	1033	1000	1018	48	7	6.857142857142857	985
FBgn0260430	1011	1000	985	37	3	12.333333333333334	974
FBgn0260431	1060	1000	922	198	9	22	862
FBgn0260436	1020	1000	1005	35	6	5.833333333333333	985
FBgn0260437	1016	1000	632	400	7	57.142857142857146	616
FBgn0260442	1001	1000	928	74	5	14.8	927
FBgn0260444	1031	1000	1011	51	11	4.636363636363637	980
FBgn0260446	1022	1000	982	62	13	4.769230769230769	960
FBgn0260462	1053	1000	430	676	10	67.6	377
FBgn0260474	1021	1000	1013	29	9	3.2222222222222223	992
FBgn0260475	998	995	964	37	15	2.466666666666667	961
FBgn0260482	1025	1000	998	52	13	4	973
FBgn0260487	1003	1000	984	22	4	5.5	981
FBgn0260632	1034	1000	980	88	11	8	946
FBgn0260639	1017	1000	1002	32	6	5.333333333333333	985
FBgn0260642	1004	1000	786	222	6	37	782
FBgn0260643	1016	1000	1015	17	3	5.666666666666667	999
FBgn0260648	1015	1000	999	31	11	2.8181818181818183	984
FBgn0260655	1014	1000	981	47	8	5.875	967
FBgn0260657	1017	1000	990	44	10	4.4	973
FBgn0260658	1057	1000	1030	84	10	8.4	973
FBgn0260659	1014	1000	1007	21	4	5.25	993
FBgn0260660	1020	1000	1013	27	7	3.857142857142857	993
FBgn0260713	1009	1000	965	53	9	5.888888888888889	956
FBgn0260720	1000	1000	996	4	2	2	996
FBgn0260742	1005	1000	1002	8	3	2.6666666666666665	997
FBgn0260743	1032	1000	1029	35	7	5	997
FBgn0260745	1003	1000	926	80	7	11.428571428571429	923
FBgn0260746	1009	1000	955	63	13	4.846153846153846	946
FBgn0260753	1053	1000	889	217	19	11.421052631578947	836
FBgn0260755	1004	1000	973	35	11	3.1818181818181817	969
FBgn0260766	1028	1000	1001	55	14	3.9285714285714284	973
FBgn0260768	898	865	791	140	13	10.76923076923077	758
FBgn0260771	1019	1000	1005	33	9	3.6666666666666665	986
FBgn0260777	1011	1000	990	32	7	4.571428571428571	979
FBgn0260779	1000	1000	998	2	2	1	998
FBgn0260789	1015	1000	1009	21	4	5.25	994
FBgn0260795	1007	1000	1003	11	6	1.8333333333333333	996
FBgn0260817	1007	1000	1002	12	4	3	995
FBgn0260855	1031	1000	1025	37	13	2.8461538461538463	994
FBgn0260856	1003	1000	995	11	7	1.5714285714285714	992
FBgn0260858	1000	1000	998	2	2	1	998
FBgn0260861	1001	1000	984	18	4	4.5	983
FBgn0260866	1065	1000	1002	128	15	8.533333333333333	937
FBgn0260873	1017	1000	849	185	11	16.818181818181817	832
FBgn0260932	1030	1000	1028	32	7	4.571428571428571	998
FBgn0260935	1040	1000	1020	60	12	5	980
FBgn0260938	724	724	722	2	1	2	722
FBgn0260940	1056	1000	1019	93	15	6.2	963
FBgn0260941	1006	1000	974	38	11	3.4545454545454546	968
FBgn0260942	1024	1000	940	108	13	8.307692307692308	916
FBgn0260943	943	898	932	56	6	9.333333333333334	887
FBgn0260944	1002	1000	986	18	5	3.6	984
FBgn0260945	1014	1000	760	268	15	17.866666666666667	746
FBgn0260959	928	921	864	71	9	7.888888888888889	857
FBgn0260960	1065	1000	1014	116	17	6.823529411764706	949
FBgn0260962	1067	1000	1009	125	16	7.8125	942
FBgn0260964	1018	1000	993	43	13	3.3076923076923075	975
FBgn0260965	1010	1000	986	34	6	5.666666666666667	976
FBgn0260969	1013	1000	998	28	7	4	985
FBgn0260971	1004	1000	987	21	9	2.3333333333333335	983
FBgn0260972	1022	1000	1004	40	9	4.444444444444445	982
FBgn0260985	985	982	975	13	5	2.6	972
FBgn0260986	1001	1000	957	45	7	6.428571428571429	956
FBgn0260987	806	798	318	496	8	62	310
FBgn0260991	1000	1000	996	4	2	2	996
FBgn0261020	1009	1000	974	44	10	4.4	965
FBgn0261046	1017	1000	963	71	9	7.888888888888889	946
FBgn0261049	1013	1000	1006	20	7	2.857142857142857	993
FBgn0261053	1000	1000	939	61	6	10.166666666666666	939
FBgn0261054	1039	1000	1015	63	11	5.7272727272727275	976
FBgn0261055	1011	1000	983	39	8	4.875	972
FBgn0261059	1085	1000	1062	108	11	9.818181818181818	977
FBgn0261065	1061	1000	1034	88	15	5.866666666666666	973
FBgn0261067	1001	1000	820	182	4	45.5	819
FBgn0261068	1026	1000	1012	40	8	5	986
FBgn0261085	1022	1000	1012	32	10	3.2	990
FBgn0261086	1022	1000	1015	29	7	4.142857142857143	993
FBgn0261090	1027	1000	997	57	9	6.333333333333333	970
FBgn0261109	1007	1000	1007	7	3	2.3333333333333335	1000
FBgn0261111	1030	1000	1020	40	3	13.333333333333334	990
FBgn0261113	1122	1000	1098	146	21	6.9523809523809526	976
FBgn0261119	1014	1000	992	36	7	5.142857142857143	978
FBgn0261238	1028	1000	1007	49	5	9.8	979
FBgn0261243	1025	1000	871	179	10	17.9	846
FBgn0261245	1033	1000	1015	51	8	6.375	982
FBgn0261258	1079	1000	1050	108	12	9	971
FBgn0261260	1009	1000	911	107	15	7.133333333333334	902
FBgn0261261	1036	1000	1009	63	10	6.3	973
FBgn0261262	1043	1000	972	114	14	8.142857142857142	929
FBgn0261266	1005	1000	1005	5	2	2.5	1000
FBgn0261268	1066	1000	1012	120	18	6.666666666666667	946
FBgn0261269	1001	1000	999	3	3	1	998
FBgn0261270	1027	1000	1022	32	4	8	995
FBgn0261274	1056	1000	1008	104	20	5.2	952
FBgn0261277	1001	1000	952	50	6	8.333333333333334	951
FBgn0261283	1006	1000	993	19	7	2.7142857142857144	987
FBgn0261284	1017	1000	999	35	7	5	982
FBgn0261285	1040	1000	969	111	11	10.090909090909092	929
FBgn0261286	1011	1000	1005	17	8	2.125	994
FBgn0261289	1065	1000	1017	113	13	8.692307692307692	952
FBgn0261290	1047	1000	1033	61	9	6.777777777777778	986
FBgn0261291	1000	1000	980	20	4	5	980
FBgn0261292	1023	1000	990	56	15	3.7333333333333334	967
FBgn0261293	687	686	543	145	6	24.166666666666668	542
FBgn0261294	1038	1000	1021	55	12	4.583333333333333	983
FBgn0261341	1011	1000	963	59	9	6.555555555555555	952
FBgn0261363	1041	1000	1009	73	10	7.3	968
FBgn0261373	1000	1000	1000	0	0	NA	1000
FBgn0261380	1006	1000	977	35	8	4.375	971
FBgn0261383	1001	1000	977	25	3	8.333333333333334	976
FBgn0261385	1033	1000	1018	48	10	4.8	985
FBgn0261395	1033	1000	1020	46	11	4.181818181818182	987
FBgn0261397	1007	1000	1006	8	4	2	999
FBgn0261401	1010	1000	1007	13	5	2.6	997
FBgn0261429	1001	1000	981	21	8	2.625	980
FBgn0261434	1023	1000	1023	23	5	4.6	1000
FBgn0261436	1017	1000	559	475	11	43.18181818181818	542
FBgn0261437	1001	1000	1000	2	2	1	999
FBgn0261446	1059	1000	986	132	14	9.428571428571429	927
FBgn0261456	1059	1000	1038	80	11	7.2727272727272725	979
FBgn0261461	1021	1000	978	64	13	4.923076923076923	957
FBgn0261477	1019	1000	926	112	10	11.2	907
FBgn0261479	1001	1000	1000	2	2	1	999
FBgn0261501	1004	1000	986	22	3	7.333333333333333	982
FBgn0261502	1000	1000	790	210	2	105	790
FBgn0261509	1018	1000	996	40	9	4.444444444444445	978
FBgn0261523	720	695	689	56	4	14	664
FBgn0261524	1006	1000	986	26	10	2.6	980
FBgn0261526	1028	1000	997	59	8	7.375	969
FBgn0261529	685	677	665	28	5	5.6	657
FBgn0261530	1013	1000	971	55	5	11	958
FBgn0261545	1052	1000	1043	61	10	6.1	991
FBgn0261550	1082	1000	525	639	11	58.09090909090909	443
FBgn0261552	1017	1000	994	40	13	3.076923076923077	977
FBgn0261553	729	724	679	55	6	9.166666666666666	674
FBgn0261554	1006	1000	1000	12	3	4	994
FBgn0261555	1065	1000	1048	82	9	9.11111111111111	983
FBgn0261556	1059	1000	1024	94	12	7.833333333333333	965
FBgn0261560	796	785	790	17	6	2.8333333333333335	779
FBgn0261561	1039	1000	976	102	9	11.333333333333334	937
FBgn0261562	1012	1000	1000	24	5	4.8	988
FBgn0261564	1021	1000	1010	32	5	6.4	989
FBgn0261568	1030	1000	1026	34	4	8.5	996
FBgn0261570	1000	1000	1000	0	0	NA	1000
FBgn0261571	1017	1000	1002	32	6	5.333333333333333	985
FBgn0261573	1001	1000	991	11	4	2.75	990
FBgn0261574	762	751	746	27	6	4.5	735
FBgn0261582	1041	1000	1016	66	9	7.333333333333333	975
FBgn0261583	1002	1000	693	311	6	51.833333333333336	691
FBgn0261584	1015	1000	982	48	13	3.6923076923076925	967
FBgn0261586	1001	1000	983	19	7	2.7142857142857144	982
FBgn0261587	1022	1000	993	51	5	10.2	971
FBgn0261588	1026	1000	1013	39	9	4.333333333333333	987
FBgn0261592	1023	1000	994	52	9	5.777777777777778	971
FBgn0261602	1063	1000	968	158	18	8.777777777777779	905
FBgn0261610	1004	1000	954	54	11	4.909090909090909	950
FBgn0261611	1060	1000	1036	84	14	6	976
FBgn0261612	1013	1000	898	128	9	14.222222222222221	885
FBgn0261614	716	699	695	38	3	12.666666666666666	678
FBgn0261615	1006	1000	978	34	11	3.090909090909091	972
FBgn0261616	716	694	665	73	9	8.11111111111111	643
FBgn0261618	912	852	908	64	10	6.4	848
FBgn0261627	1014	1000	994	34	6	5.666666666666667	980
FBgn0261628	1041	1000	1007	75	15	5	966
FBgn0261630	1032	1000	1030	34	6	5.666666666666667	998
FBgn0261633	1030	1000	988	72	14	5.142857142857143	958
FBgn0261634	1023	1000	946	100	13	7.6923076923076925	923
FBgn0261635	1011	1000	964	58	6	9.666666666666666	953
FBgn0261636	1025	1000	625	425	7	60.714285714285715	600
FBgn0261641	1010	1000	906	114	9	12.666666666666666	896
FBgn0261647	1012	1000	1005	19	5	3.8	993
FBgn0261648	1016	1000	1015	17	4	4.25	999
FBgn0261649	1024	1000	1016	32	5	6.4	992
FBgn0261671	1021	1000	1015	27	10	2.7	994
FBgn0261673	968	956	906	74	12	6.166666666666667	894
FBgn0261674	1003	1000	929	77	8	9.625	926
FBgn0261675	1051	1000	1042	60	12	5	991
FBgn0261700	1038	1000	1020	56	9	6.222222222222222	982
FBgn0261705	1000	1000	654	346	2	173	654
FBgn0261707	1025	1000	999	51	9	5.666666666666667	974
FBgn0261709	1012	1000	911	113	6	18.833333333333332	899
FBgn0261710	1004	1000	994	14	5	2.8	990
FBgn0261714	1001	1000	991	11	3	3.6666666666666665	990
FBgn0261722	1027	1000	990	64	10	6.4	963
FBgn0261723	1024	1000	987	61	9	6.777777777777778	963
FBgn0261786	1000	1000	988	12	4	3	988
FBgn0261789	1024	1000	1021	27	5	5.4	997
FBgn0261791	1050	1000	1031	69	14	4.928571428571429	981
FBgn0261792	1027	1000	1006	48	8	6	979
FBgn0261793	1082	1000	1075	89	14	6.357142857142857	993
FBgn0261794	968	953	965	18	7	2.5714285714285716	950
FBgn0261797	1000	1000	994	6	2	3	994
FBgn0261799	1031	1000	988	74	11	6.7272727272727275	957
FBgn0261800	1109	1000	1097	121	13	9.307692307692308	988
FBgn0261801	1013	1000	1007	19	8	2.375	994
FBgn0261803	1041	1000	948	134	18	7.444444444444445	907
FBgn0261804	1000	1000	990	10	2	5	990
FBgn0261805	1000	985	975	40	6	6.666666666666667	960
FBgn0261806	1010	1000	962	58	11	5.2727272727272725	952
FBgn0261807	702	683	635	86	6	14.333333333333334	616
FBgn0261811	1021	1000	979	63	13	4.846153846153846	958
FBgn0261813	1066	1000	1016	116	20	5.8	950
FBgn0261816	1002	1000	970	34	7	4.857142857142857	968
FBgn0261817	1000	1000	972	28	2	14	972
FBgn0261823	1023	1000	1008	38	10	3.8	985
FBgn0261832	1030	1000	992	68	12	5.666666666666667	962
FBgn0261833	1042	1000	975	109	7	15.571428571428571	933
FBgn0261836	1003	1000	987	19	6	3.1666666666666665	984
FBgn0261850	1003	1000	812	194	6	32.333333333333336	809
FBgn0261854	1000	1000	983	17	5	3.4	983
FBgn0261857	1138	1000	1113	163	10	16.3	975
FBgn0261860	1026	1000	978	74	8	9.25	952
FBgn0261861	1001	1000	981	21	6	3.5	980
FBgn0261871	1008	1000	1000	16	7	2.2857142857142856	992
FBgn0261872	1015	1000	1001	29	4	7.25	986
FBgn0261873	1025	1000	962	88	12	7.333333333333333	937
FBgn0261881	1022	1000	987	57	10	5.7	965
FBgn0261885	1055	1000	1031	79	18	4.388888888888889	976
FBgn0261924	1011	1000	993	29	5	5.8	982
FBgn0261927	1035	1000	986	84	10	8.4	951
FBgn0261929	1003	1000	969	37	10	3.7	966
FBgn0261930	1014	1000	979	49	11	4.454545454545454	965
FBgn0261931	1004	1000	992	16	7	2.2857142857142856	988
FBgn0261932	1000	1000	993	7	2	3.5	993
FBgn0261933	1040	1000	1018	62	9	6.888888888888889	978
FBgn0261938	1007	1000	1005	9	3	3	998
FBgn0261952	1054	1000	1017	91	14	6.5	963
FBgn0261953	1012	1000	1009	15	3	5	997
FBgn0261955	1022	1000	1021	23	5	4.6	999
FBgn0261963	1000	1000	807	193	3	64.33333333333333	807
FBgn0261976	1000	1000	993	7	3	2.3333333333333335	993
FBgn0261983	1001	1000	996	6	3	2	995
FBgn0261984	1002	1000	990	14	2	7	988
FBgn0261986	1007	1000	964	50	9	5.555555555555555	957
FBgn0261987	1056	1000	1033	79	18	4.388888888888889	977
FBgn0261988	1029	1000	1020	38	6	6.333333333333333	991
FBgn0261990	1072	1000	1054	90	14	6.428571428571429	982
FBgn0261994	1000	1000	993	7	3	2.3333333333333335	993
FBgn0261999	1018	1000	962	74	7	10.571428571428571	944
FBgn0262000	1001	1000	956	46	7	6.571428571428571	955
FBgn0262001	759	753	666	99	9	11	660
FBgn0262003	740	714	714	52	9	5.777777777777778	688
FBgn0262005	1003	961	985	60	6	10	943
FBgn0262006	1026	1000	1007	45	8	5.625	981
FBgn0262007	1032	1000	786	278	11	25.272727272727273	754
FBgn0262008	1023	1000	1004	42	11	3.8181818181818183	981
FBgn0262009	1033	1000	1007	59	13	4.538461538461538	974
FBgn0262018	1003	1000	835	171	8	21.375	832
FBgn0262020	1045	1000	1031	59	13	4.538461538461538	986
FBgn0262021	1038	1000	1003	73	17	4.294117647058823	965
FBgn0262022	1017	1000	945	89	13	6.846153846153846	928
FBgn0262025	1000	1000	965	35	5	7	965
FBgn0262028	1012	1000	1003	21	3	7	991
FBgn0262030	1006	1000	962	50	8	6.25	956
FBgn0262033	1025	1000	1008	42	5	8.4	983
FBgn0262057	1060	1000	974	146	14	10.428571428571429	914
FBgn0262081	1006	1000	1000	12	6	2	994
FBgn0262097	1060	1000	1042	78	7	11.142857142857142	982
FBgn0262098	1004	1000	992	16	4	4	988
FBgn0262100	1064	1000	1024	104	14	7.428571428571429	960
FBgn0262102	1017	1000	994	40	8	5	977
FBgn0262104	1011	1000	957	65	10	6.5	946
FBgn0262105	1022	1000	1013	31	5	6.2	991
FBgn0262106	925	868	861	121	7	17.285714285714285	804
FBgn0262107	1023	1000	1002	44	11	4	979
FBgn0262108	1001	1000	887	115	8	14.375	886
FBgn0262112	1023	1000	986	60	12	5	963
FBgn0262114	1082	1000	1066	98	13	7.538461538461538	984
FBgn0262125	1003	1000	798	208	4	52	795
FBgn0262127	930	897	902	61	13	4.6923076923076925	869
FBgn0262141	1110	1000	1028	192	21	9.142857142857142	918
FBgn0262146	1007	1000	1004	10	4	2.5	997
FBgn0262149	1005	1000	998	12	4	3	993
FBgn0262150	1049	1000	998	100	10	10	949
FBgn0262160	1040	1000	1012	68	11	6.181818181818182	972
FBgn0262166	1000	1000	983	17	3	5.666666666666667	983
FBgn0262167	926	923	872	57	3	19	869
FBgn0262169	1013	1000	1003	23	7	3.2857142857142856	990
FBgn0262170	1002	1000	998	6	4	1.5	996
FBgn0262172	1005	1000	913	97	7	13.857142857142858	908
FBgn0262178	1046	1000	1023	69	11	6.2727272727272725	977
FBgn0262181	1093	1000	953	233	19	12.263157894736842	860
FBgn0262215	1033	1000	949	117	12	9.75	916
FBgn0262223	1001	1000	985	17	5	3.4	984
FBgn0262256	1000	1000	919	81	6	13.5	919
FBgn0262263	1015	1000	1005	25	6	4.166666666666667	990
FBgn0262266	1060	1000	755	365	15	24.333333333333332	695
FBgn0262302	1010	1000	985	35	8	4.375	975
FBgn0262314	1082	1000	858	306	18	17	776
FBgn0262334	872	848	791	105	14	7.5	767
FBgn0262338	1037	1000	978	96	27	3.5555555555555554	941
FBgn0262352	1006	1000	939	73	9	8.11111111111111	933
FBgn0262353	1020	1000	959	81	14	5.785714285714286	939
FBgn0262354	1009	1000	1003	15	8	1.875	994
FBgn0262356	1005	1000	833	177	5	35.4	828
FBgn0262357	1019	1000	999	39	7	5.571428571428571	980
FBgn0262358	1020	1000	980	60	11	5.454545454545454	960
FBgn0262360	1014	1000	877	151	15	10.066666666666666	863
FBgn0262361	1029	1000	1021	37	8	4.625	992
FBgn0262364	1000	1000	991	9	4	2.25	991
FBgn0262374	1010	1000	979	41	14	2.9285714285714284	969
FBgn0262376	1019	1000	1004	34	6	5.666666666666667	985
FBgn0262383	1041	1000	1041	41	8	5.125	1000
FBgn0262388	1049	1000	1023	75	9	8.333333333333334	974
FBgn0262390	1000	1000	980	20	6	3.3333333333333335	980
FBgn0262396	1045	1000	993	97	9	10.777777777777779	948
FBgn0262400	1006	1000	977	35	8	4.375	971
FBgn0262401	1013	1000	991	35	4	8.75	978
FBgn0262415	1006	1000	999	13	4	3.25	993
FBgn0262428	1015	1000	994	36	6	6	979
FBgn0262433	1019	1000	965	73	13	5.615384615384615	946
FBgn0262437	1005	1000	956	54	8	6.75	951
FBgn0262440	1011	1000	962	60	9	6.666666666666667	951
FBgn0262445	1031	1000	969	93	11	8.454545454545455	938
FBgn0262446	1038	1000	962	114	16	7.125	924
FBgn0262467	1003	1000	974	32	6	5.333333333333333	971
FBgn0262473	1036	1000	991	81	12	6.75	955
FBgn0262475	1010	1000	1003	17	7	2.4285714285714284	993
FBgn0262476	1025	1000	1017	33	8	4.125	992
FBgn0262480	779	770	761	27	8	3.375	752
FBgn0262483	1025	1000	1019	31	8	3.875	994
FBgn0262484	1021	1000	989	53	14	3.7857142857142856	968
FBgn0262486	1029	1000	973	85	10	8.5	944
FBgn0262487	1003	1000	983	23	10	2.3	980
FBgn0262508	1033	1000	1019	47	10	4.7	986
FBgn0262512	1077	1000	1075	79	11	7.181818181818182	998
FBgn0262515	1005	1000	994	16	4	4	989
FBgn0262517	1000	1000	1000	0	0	NA	1000
FBgn0262518	1015	1000	975	55	7	7.857142857142857	960
FBgn0262519	1002	1000	1002	2	2	1	1000
FBgn0262524	1000	1000	998	2	1	2	998
FBgn0262529	1007	1000	984	30	8	3.75	977
FBgn0262534	1032	1000	1017	47	11	4.2727272727272725	985
FBgn0262535	1025	1000	998	52	8	6.5	973
FBgn0262541	1078	1000	1058	98	11	8.909090909090908	980
FBgn0262544	1020	1000	988	52	9	5.777777777777778	968
FBgn0262546	1001	1000	871	131	3	43.666666666666664	870
FBgn0262547	1005	1000	960	50	8	6.25	955
FBgn0262559	1034	1000	1011	57	11	5.181818181818182	977
FBgn0262562	1021	1000	997	45	8	5.625	976
FBgn0262564	1023	1000	1005	41	9	4.555555555555555	982
FBgn0262567	1027	1000	1012	42	6	7	985
FBgn0262568	1008	1000	975	41	9	4.555555555555555	967
FBgn0262569	1016	1000	977	55	5	11	961
FBgn0262571	1013	1000	984	42	14	3	971
FBgn0262572	1001	1000	668	334	9	37.111111111111114	667
FBgn0262574	1028	1000	977	79	8	9.875	949
FBgn0262575	1013	1000	386	640	6	106.66666666666667	373
FBgn0262576	1007	1000	966	48	7	6.857142857142857	959
FBgn0262577	814	814	807	7	4	1.75	807
FBgn0262580	1027	1000	969	85	11	7.7272727272727275	942
FBgn0262581	1008	1000	968	48	7	6.857142857142857	960
FBgn0262592	1035	1000	963	107	11	9.727272727272727	928
FBgn0262593	1019	1000	1002	36	8	4.5	983
FBgn0262594	1001	1000	997	5	3	1.6666666666666667	996
FBgn0262598	1019	1000	989	49	11	4.454545454545454	970
FBgn0262599	1054	1000	1041	67	12	5.583333333333333	987
FBgn0262601	1011	1000	1008	14	4	3.5	997
FBgn0262604	1042	1000	977	107	12	8.916666666666666	935
FBgn0262605	1000	1000	971	29	6	4.833333333333333	971
FBgn0262608	1037	1000	1018	56	11	5.090909090909091	981
FBgn0262609	745	719	700	71	6	11.833333333333334	674
FBgn0262611	1040	1000	994	86	15	5.733333333333333	954
FBgn0262612	1025	1000	1007	43	6	7.166666666666667	982
FBgn0262616	1008	1000	870	146	13	11.23076923076923	862
FBgn0262619	1022	1000	1013	31	6	5.166666666666667	991
FBgn0262622	1003	1000	989	17	4	4.25	986
FBgn0262623	1028	1000	1020	36	9	4	992
FBgn0262624	1009	1000	965	53	8	6.625	956
FBgn0262636	1060	1000	1054	66	7	9.428571428571429	994
FBgn0262647	1008	1000	1008	8	2	4	1000
FBgn0262679	1075	1000	981	169	12	14.083333333333334	906
FBgn0262680	1028	956	953	147	16	9.1875	881
FBgn0262683	775	773	340	437	3	145.66666666666666	338
FBgn0262685	1030	1000	958	102	15	6.8	928
FBgn0262686	1027	1000	916	138	15	9.2	889
FBgn0262690	1058	1000	1021	95	8	11.875	963
FBgn0262699	1008	1000	979	37	10	3.7	971
FBgn0262716	1008	1000	993	23	6	3.8333333333333335	985
FBgn0262730	1019	1000	986	52	8	6.5	967
FBgn0262731	1029	1000	824	234	8	29.25	795
FBgn0262734	1014	1000	957	71	7	10.142857142857142	943
FBgn0262736	686	683	653	36	9	4	650
FBgn0262737	1007	1000	976	38	7	5.428571428571429	969
FBgn0262738	1020	1000	966	74	12	6.166666666666667	946
FBgn0262740	1021	1000	970	72	10	7.2	949
FBgn0262743	1010	1000	1010	10	4	2.5	1000
FBgn0262782	1018	1000	1018	18	4	4.5	1000
FBgn0262786	1009	1000	932	86	5	17.2	923
FBgn0262787	1032	1000	998	66	8	8.25	966
FBgn0262788	1000	1000	986	14	4	3.5	986
FBgn0262794	1005	1000	981	29	4	7.25	976
FBgn0262801	1069	1000	1057	81	12	6.75	988
FBgn0262808	1026	1000	572	480	5	96	546
FBgn0262810	924	892	919	37	9	4.111111111111111	887
FBgn0262811	1002	1000	937	67	8	8.375	935
FBgn0262813	1035	1000	1013	57	11	5.181818181818182	978
FBgn0262817	1020	1000	1008	32	10	3.2	988
FBgn0262819	1004	1000	993	15	4	3.75	989
FBgn0262820	1000	1000	999	1	1	1	999
FBgn0262821	1028	1000	1007	49	16	3.0625	979
FBgn0262822	1018	1000	885	151	6	25.166666666666668	867
FBgn0262827	1021	1000	945	97	11	8.818181818181818	924
FBgn0262838	966	941	936	55	16	3.4375	911
FBgn0262840	1004	1000	1004	4	1	4	1000
FBgn0262842	1000	1000	984	16	5	3.2	984
FBgn0262843	1007	1000	978	36	6	6	971
FBgn0262858	1012	1000	1000	24	8	3	988
FBgn0262869	1006	1000	1005	7	4	1.75	999
FBgn0262871	1037	1000	1020	54	10	5.4	983
FBgn0262872	1004	1000	1004	4	1	4	1000
FBgn0262875	1016	1000	984	48	6	8	968
FBgn0262876	1003	1000	992	14	4	3.5	989
FBgn0262877	1031	1000	1016	46	5	9.2	985
FBgn0262880	1050	1000	1049	51	4	12.75	999
FBgn0262881	1021	1000	930	112	13	8.615384615384615	909
FBgn0262882	1006	1000	962	50	6	8.333333333333334	956
FBgn0262883	1035	1000	1018	52	7	7.428571428571429	983
FBgn0262885	1065	1000	881	249	17	14.647058823529411	816
FBgn0262887	1023	1000	848	198	10	19.8	825
FBgn0262888	1002	1000	965	39	10	3.9	963
FBgn0262889	1077	1000	1040	114	15	7.6	963
FBgn0262890	1013	1000	971	55	13	4.230769230769231	958
FBgn0262891	1029	1000	1023	35	10	3.5	994
FBgn0262892	1000	1000	997	3	2	1.5	997
FBgn0262893	1026	1000	1022	30	8	3.75	996
FBgn0262895	1005	1000	975	35	5	7	970
FBgn0262896	1003	1000	970	36	8	4.5	967
FBgn0262899	1060	1000	1033	87	10	8.7	973
FBgn0262902	1006	1000	958	54	4	13.5	952
FBgn0262903	1005	1000	979	31	7	4.428571428571429	974
FBgn0262904	1040	1000	1017	63	6	10.5	977
FBgn0262937	1004	1000	1004	4	2	2	1000
FBgn0262944	1026	1000	882	170	13	13.076923076923077	856
FBgn0262947	1092	1000	1031	153	18	8.5	939
FBgn0262951	1020	1000	1002	38	9	4.222222222222222	982
FBgn0262955	1005	1000	992	18	6	3	987
FBgn0262960	1036	1000	986	86	15	5.733333333333333	950
FBgn0262962	1002	1000	998	6	4	1.5	996
FBgn0262963	1006	1000	992	20	5	4	986
FBgn0262967	1029	1000	981	77	13	5.923076923076923	952
FBgn0262969	1032	1000	945	119	10	11.9	913
FBgn0262972	1000	1000	983	17	4	4.25	983
FBgn0262976	1044	1000	973	115	10	11.5	929
FBgn0262979	1003	1000	967	39	7	5.571428571428571	964
FBgn0262981	1002	1000	992	12	5	2.4	990
FBgn0262984	1008	1000	980	36	6	6	972
FBgn0262986	1002	1000	977	27	5	5.4	975
FBgn0262987	1012	1000	1010	14	4	3.5	998
FBgn0262988	1000	1000	998	2	1	2	998
FBgn0262989	1046	1000	1026	66	17	3.8823529411764706	980
FBgn0262990	1062	1000	1020	104	13	8	958
FBgn0262992	1032	1000	976	88	7	12.571428571428571	944
FBgn0262994	1012	1000	977	47	4	11.75	965
FBgn0262995	1046	1000	1030	62	11	5.636363636363637	984
FBgn0262996	1017	1000	967	67	8	8.375	950
FBgn0262998	1000	1000	835	165	3	55	835
FBgn0262999	757	738	742	34	8	4.25	723
FBgn0263004	1034	1000	1033	35	6	5.833333333333333	999
FBgn0263006	1021	1000	1014	28	6	4.666666666666667	993
FBgn0263019	1035	1000	980	90	8	11.25	945
FBgn0263022	1022	1000	1002	42	9	4.666666666666667	980
FBgn0263026	1015	1000	1000	30	6	5	985
FBgn0263027	916	871	889	72	10	7.2	844
FBgn0263034	1009	1000	414	604	7	86.28571428571429	405
FBgn0263037	719	719	715	4	2	2	715
FBgn0263038	1014	1000	1010	18	6	3	996
FBgn0263040	1006	1000	995	17	6	2.8333333333333335	989
FBgn0263072	1027	1000	979	75	9	8.333333333333334	952
FBgn0263076	1044	1000	1041	47	6	7.833333333333333	997
FBgn0263077	1083	1000	1073	93	7	13.285714285714286	990
FBgn0263080	1046	1000	1021	71	10	7.1	975
FBgn0263082	1012	1000	1007	17	6	2.8333333333333335	995
FBgn0263083	1010	1000	998	22	4	5.5	988
FBgn0263084	1054	1000	990	118	12	9.833333333333334	936
FBgn0263086	1039	1000	1007	71	10	7.1	968
FBgn0263088	962	926	938	60	13	4.615384615384615	902
FBgn0263089	1061	1000	1048	74	13	5.6923076923076925	987
FBgn0263090	1045	1000	1017	73	9	8.11111111111111	972
FBgn0263092	1000	1000	86	914	2	457	86
FBgn0263093	1043	1000	938	148	22	6.7272727272727275	895
FBgn0263095	1010	1000	990	30	5	6	980
FBgn0263102	1009	1000	1007	11	2	5.5	998
FBgn0263108	1002	1000	980	24	4	6	978
FBgn0263109	1062	1000	1059	65	9	7.222222222222222	997
FBgn0263110	1037	1000	1037	37	5	7.4	1000
FBgn0263114	1001	1000	998	4	2	2	997
FBgn0263116	1012	1000	1004	20	6	3.3333333333333335	992
FBgn0263118	1051	1000	1015	87	8	10.875	964
FBgn0263120	1092	1000	997	187	14	13.357142857142858	905
FBgn0263130	1008	1000	1000	16	5	3.2	992
FBgn0263131	1012	1000	993	31	9	3.4444444444444446	981
FBgn0263132	1022	1000	977	67	13	5.153846153846154	955
FBgn0263143	918	918	915	3	1	3	915
FBgn0263144	1033	1000	1024	42	7	6	991
FBgn0263197	1006	1000	988	24	5	4.8	982
FBgn0263198	1004	1000	1000	8	4	2	996
FBgn0263199	1018	1000	998	38	6	6.333333333333333	980
FBgn0263200	1050	1000	1039	61	8	7.625	989
FBgn0263216	826	799	776	77	10	7.7	749
FBgn0263217	1003	1000	936	70	10	7	933
FBgn0263220	1020	1000	1006	34	9	3.7777777777777777	986
FBgn0263233	1010	1000	873	147	9	16.333333333333332	863
FBgn0263234	1005	1000	947	63	6	10.5	942
FBgn0263236	1003	1000	976	30	6	5	973
FBgn0263237	1033	1000	945	121	14	8.642857142857142	912
FBgn0263239	1029	1000	1023	35	5	7	994
FBgn0263240	1011	1000	1000	22	7	3.142857142857143	989
FBgn0263241	1125	1000	1077	173	23	7.521739130434782	952
FBgn0263246	1029	1000	1021	37	7	5.285714285714286	992
FBgn0263247	1008	913	952	151	17	8.882352941176471	857
FBgn0263248	909	830	884	104	11	9.454545454545455	805
FBgn0263249	1024	1000	1000	48	10	4.8	976
FBgn0263256	1005	1000	995	15	6	2.5	990
FBgn0263257	1038	1000	943	133	17	7.823529411764706	905
FBgn0263258	1018	1000	900	136	9	15.11111111111111	882
FBgn0263289	1036	1000	983	89	14	6.357142857142857	947
FBgn0263320	1044	1000	1035	53	10	5.3	991
FBgn0263321	1000	1000	971	29	8	3.625	971
FBgn0263322	1021	1000	1014	28	9	3.111111111111111	993
FBgn0263323	1002	1000	941	63	5	12.6	939
FBgn0263325	1006	1000	978	34	11	3.090909090909091	972
FBgn0263327	1141	1000	1126	156	12	13	985
FBgn0263328	1041	1000	1024	58	6	9.666666666666666	983
FBgn0263330	1020	1000	973	67	10	6.7	953
FBgn0263331	1026	1000	1012	40	10	4	986
FBgn0263332	1010	1000	986	34	3	11.333333333333334	976
FBgn0263333	1060	1000	1014	106	11	9.636363636363637	954
FBgn0263334	1075	1000	962	188	17	11.058823529411764	887
FBgn0263335	1016	1000	909	123	7	17.571428571428573	893
FBgn0263337	1032	1000	982	82	12	6.833333333333333	950
FBgn0263338	1002	1000	998	6	5	1.2	996
FBgn0263340	1002	1000	993	11	4	2.75	991
FBgn0263341	1001	1000	995	7	3	2.3333333333333335	994
FBgn0263342	1015	1000	1003	27	8	3.375	988
FBgn0263344	1000	1000	405	595	4	148.75	405
FBgn0263351	1001	1000	993	9	3	3	992
FBgn0263352	1042	1000	1005	79	12	6.583333333333333	963
FBgn0263353	1025	1000	1003	47	9	5.222222222222222	978
FBgn0263376	1011	1000	979	43	9	4.777777777777778	968
FBgn0263378	1000	1000	968	32	10	3.2	968
FBgn0263379	1028	1000	1012	44	7	6.285714285714286	984
FBgn0263380	1088	1000	1048	128	15	8.533333333333333	960
FBgn0263381	1065	1000	1045	85	14	6.071428571428571	980
FBgn0263383	1031	1000	882	180	9	20	851
FBgn0263384	1020	1000	1005	35	6	5.833333333333333	985
FBgn0263385	1034	1000	944	124	11	11.272727272727273	910
FBgn0263386	1008	1000	958	58	11	5.2727272727272725	950
FBgn0263388	1010	1000	981	39	7	5.571428571428571	971
FBgn0263390	1003	1000	947	59	14	4.214285714285714	944
FBgn0263391	1000	1000	892	108	5	21.6	892
FBgn0263392	1080	1000	1063	97	12	8.083333333333334	983
FBgn0263396	1038	1000	997	79	11	7.181818181818182	959
FBgn0263398	1002	1000	988	16	7	2.2857142857142856	986
FBgn0263399	1015	1000	973	57	10	5.7	958
FBgn0263400	1004	1000	993	15	6	2.5	989
FBgn0263401	1082	1000	1062	102	13	7.846153846153846	980
FBgn0263402	1023	1000	956	90	12	7.5	933
FBgn0263403	1002	1000	976	28	4	7	974
FBgn0263404	1012	1000	972	52	3	17.333333333333332	960
FBgn0263405	1025	1000	988	62	8	7.75	963
FBgn0263407	1030	1000	1024	36	9	4	994
FBgn0263408	1000	1000	985	15	3	5	985
FBgn0263409	1019	1000	971	67	10	6.7	952
FBgn0263410	1001	1000	959	43	7	6.142857142857143	958
FBgn0263413	1066	1000	1042	90	14	6.428571428571429	976
FBgn0263414	1023	1000	957	89	15	5.933333333333334	934
FBgn0263441	1061	1000	1035	87	10	8.7	974
FBgn0263442	1019	1000	965	73	9	8.11111111111111	946
FBgn0263443	1046	1000	1013	79	7	11.285714285714286	967
FBgn0263444	1004	1000	1003	5	3	1.6666666666666667	999
FBgn0263446	1054	1000	999	109	17	6.411764705882353	945
FBgn0263447	1002	1000	1001	3	3	1	999
FBgn0263448	794	785	784	19	8	2.375	775
FBgn0263449	1051	1000	1043	59	8	7.375	992
FBgn0263452	1036	1000	1028	44	7	6.285714285714286	992
FBgn0263453	1009	1000	991	27	6	4.5	982
FBgn0263454	1014	1000	1011	17	3	5.666666666666667	997
FBgn0263455	1040	1000	978	102	8	12.75	938
FBgn0263456	1068	1000	1037	99	13	7.615384615384615	969
FBgn0263457	1001	1000	994	8	3	2.6666666666666665	993
FBgn0263459	1012	1000	975	49	8	6.125	963
FBgn0263490	1000	1000	980	20	5	4	980
FBgn0263492	1006	1000	1000	12	7	1.7142857142857142	994
FBgn0263493	1020	1000	1014	26	8	3.25	994
FBgn0263494	1020	1000	1001	39	9	4.333333333333333	981
FBgn0263495	1001	1000	978	24	6	4	977
FBgn0263496	1034	1000	1033	35	5	7	999
FBgn0263498	1021	1000	985	57	12	4.75	964
FBgn0263500	1003	1000	998	8	4	2	995
FBgn0263501	1017	1000	982	52	8	6.5	965
FBgn0263502	1019	1000	1009	29	9	3.2222222222222223	990
FBgn0263503	1010	1000	950	70	12	5.833333333333333	940
FBgn0263505	1037	1000	1015	59	10	5.9	978
FBgn0263506	1044	1000	1032	56	11	5.090909090909091	988
FBgn0263507	1017	1000	1014	20	7	2.857142857142857	997
FBgn0263509	1023	1000	952	94	16	5.875	929
FBgn0263510	1060	1000	991	129	12	10.75	931
FBgn0263511	1015	1000	958	72	10	7.2	943
FBgn0263512	1003	1000	1000	6	4	1.5	997
FBgn0263517	1030	1000	1030	30	2	15	1000
FBgn0263528	1000	1000	1000	0	0	NA	1000
FBgn0263539	1043	1000	1026	60	8	7.5	983
FBgn0263543	1004	1000	990	18	8	2.25	986
FBgn0263548	1044	1000	1037	51	11	4.636363636363637	993
FBgn0263552	1008	1000	1005	11	2	5.5	997
FBgn0263556	1000	1000	997	3	1	3	997
FBgn0263562	1000	1000	997	3	1	3	997
FBgn0263581	1006	1000	966	46	7	6.571428571428571	960
FBgn0263582	1031	1000	1012	50	9	5.555555555555555	981
FBgn0263584	1007	1000	963	51	10	5.1	956
FBgn0263585	1080	1000	1054	106	12	8.833333333333334	974
FBgn0263586	1024	1000	992	56	10	5.6	968
FBgn0263587	1031	1000	953	109	8	13.625	922
FBgn0263588	1005	1000	952	58	9	6.444444444444445	947
FBgn0263589	1000	1000	919	81	18	4.5	919
FBgn0263590	1009	1000	1002	16	3	5.333333333333333	993
FBgn0263595	1021	1000	994	48	12	4	973
FBgn0263599	1023	1000	1021	25	4	6.25	998
FBgn0263600	1004	1000	979	29	11	2.6363636363636362	975
FBgn0263601	1026	1000	982	70	17	4.117647058823529	956
FBgn0263603	1004	1000	715	293	6	48.833333333333336	711
FBgn0263605	1019	1000	1014	24	3	8	995
FBgn0263611	1023	1000	996	50	11	4.545454545454546	973
FBgn0263612	1008	1000	842	174	8	21.75	834
FBgn0263613	1026	1000	1022	30	6	5	996
FBgn0263615	1096	1000	1080	112	12	9.333333333333334	984
FBgn0263616	1088	1000	1079	97	9	10.777777777777779	991
FBgn0263618	1005	1000	948	62	4	15.5	943
FBgn0263619	1040	1000	773	307	10	30.7	733
FBgn0263623	762	762	759	3	3	1	759
FBgn0263624	1016	1000	1002	30	5	6	986
FBgn0263625	1010	1000	1008	12	3	4	998
FBgn0263649	1005	1000	983	27	7	3.857142857142857	978
FBgn0263650	1021	1000	1006	36	9	4	985
FBgn0263652	1003	1000	999	7	5	1.4	996
FBgn0263655	1010	998	964	58	7	8.285714285714286	952
FBgn0263657	1025	1000	997	53	10	5.3	972
FBgn0263658	1006	1000	962	50	4	12.5	956
FBgn0263659	1027	1000	973	81	9	9	946
FBgn0263660	1021	1000	1017	25	3	8.333333333333334	996
FBgn0263661	1000	1000	962	38	5	7.6	962
FBgn0263662	1012	1000	988	36	3	12	976
FBgn0263663	1008	1000	995	21	6	3.5	987
FBgn0263664	1011	1000	989	33	5	6.6	978
FBgn0263667	1022	1000	996	48	8	6	974
FBgn0263697	1002	1000	991	13	5	2.6	989
FBgn0263706	1007	1000	968	46	7	6.571428571428571	961
FBgn0263708	1004	1000	962	46	7	6.571428571428571	958
FBgn0263709	1010	1000	1005	15	5	3	995
FBgn0263743	1008	1000	993	23	4	5.75	985
FBgn0263745	1010	1000	292	728	4	182	282
FBgn0263746	870	869	851	20	3	6.666666666666667	850
FBgn0263764	1017	1000	979	55	8	6.875	962
FBgn0263765	1009	1000	972	46	8	5.75	963
FBgn0263766	1002	1000	978	26	9	2.888888888888889	976
FBgn0263769	1006	1000	950	62	9	6.888888888888889	944
FBgn0263773	1094	1000	1088	100	10	10	994
FBgn0263774	1008	1000	957	59	6	9.833333333333334	949
FBgn0263780	1013	1000	527	499	10	49.9	514
FBgn0263782	1029	1000	1024	34	7	4.857142857142857	995
FBgn0263802	1029	1000	979	79	14	5.642857142857143	950
FBgn0263830	1000	1000	200	800	1	800	200
FBgn0263831	1004	1000	999	9	4	2.25	995
FBgn0263832	1008	1000	1008	8	4	2	1000
FBgn0263838	1009	1000	961	57	10	5.7	952
FBgn0263839	1037	1000	1034	40	6	6.666666666666667	997
FBgn0263841	1007	1000	988	26	7	3.7142857142857144	981
FBgn0263843	1002	1000	986	18	6	3	984
FBgn0263845	905	826	873	111	8	13.875	794
FBgn0263846	1007	1000	977	37	5	7.4	970
FBgn0263852	1021	1000	1018	24	3	8	997
FBgn0263864	1009	1000	945	73	11	6.636363636363637	936
FBgn0263866	1007	1000	932	82	7	11.714285714285714	925
FBgn0263868	1037	1000	1005	69	13	5.3076923076923075	968
FBgn0263871	1000	1000	984	16	6	2.6666666666666665	984
FBgn0263872	1000	1000	929	71	4	17.75	929
FBgn0263873	1028	1000	995	61	12	5.083333333333333	967
FBgn0263874	1021	1000	992	50	7	7.142857142857143	971
FBgn0263911	1037	1000	707	367	2	183.5	670
FBgn0263916	1029	1000	1017	41	10	4.1	988
FBgn0263929	1018	1000	1010	26	10	2.6	992
FBgn0263930	1015	1000	959	71	9	7.888888888888889	944
FBgn0263934	1081	1000	1057	105	9	11.666666666666666	976
FBgn0263967	1001	1000	993	9	2	4.5	992
FBgn0263970	1042	1000	1001	83	8	10.375	959
FBgn0263971	1003	1000	981	25	7	3.5714285714285716	978
FBgn0263973	1026	1000	1000	52	6	8.666666666666666	974
FBgn0263975	1008	1000	864	152	6	25.333333333333332	856
FBgn0263976	1000	1000	953	47	4	11.75	953
FBgn0263979	1038	1000	1015	61	8	7.625	977
FBgn0263980	1012	1000	981	43	4	10.75	969
FBgn0263981	842	835	836	13	3	4.333333333333333	829
FBgn0263988	1019	1000	926	112	9	12.444444444444445	907
FBgn0263992	1009	1000	991	27	3	9	982
FBgn0263995	1011	1000	986	36	10	3.6	975
FBgn0263999	1009	1000	680	338	8	42.25	671
FBgn0264001	1014	1000	1004	24	4	6	990
FBgn0264002	1001	1000	982	20	8	2.5	981
FBgn0264005	1024	1000	1021	27	6	4.5	997
FBgn0264006	1001	1000	944	58	8	7.25	943
FBgn0264075	1004	1000	985	23	6	3.8333333333333335	981
FBgn0264078	1007	1000	998	16	5	3.2	991
FBgn0264081	1044	1000	1005	83	10	8.3	961
FBgn0264083	1021	1000	942	100	17	5.882352941176471	921
FBgn0264084	1017	1000	1009	25	7	3.5714285714285716	992
FBgn0264085	1001	1000	948	54	6	9	947
FBgn0264087	1040	1000	1027	53	8	6.625	987
FBgn0264089	1016	1000	1010	22	6	3.6666666666666665	994
FBgn0264090	1037	1000	997	77	11	7	960
FBgn0264260	1019	1000	945	93	15	6.2	926
FBgn0264261	1003	1000	983	23	5	4.6	980
FBgn0264262	1062	1000	728	396	7	56.57142857142857	666
FBgn0264263	1003	1000	983	23	8	2.875	980
FBgn0264264	1009	1000	980	38	6	6.333333333333333	971
FBgn0264265	1005	1000	995	15	4	3.75	990
FBgn0264266	1061	1000	1051	71	15	4.733333333333333	990
FBgn0264267	1057	1000	1044	70	8	8.75	987
FBgn0264268	1004	1000	983	25	7	3.5714285714285716	979
FBgn0264270	1005	1000	982	28	7	4	977
FBgn0264271	1015	1000	977	53	10	5.3	962
FBgn0264272	1010	1000	980	40	5	8	970
FBgn0264273	1014	1000	921	107	15	7.133333333333334	907
FBgn0264291	1001	1000	975	27	4	6.75	974
FBgn0264294	1015	1000	994	36	9	4	979
FBgn0264296	762	722	701	101	12	8.416666666666666	661
FBgn0264307	1013	1000	969	57	6	9.5	956
FBgn0264308	1024	1000	1018	30	6	5	994
FBgn0264325	1007	1000	976	38	7	5.428571428571429	969
FBgn0264326	1022	1000	977	67	13	5.153846153846154	955
FBgn0264327	1009	1000	1001	17	5	3.4	992
FBgn0264337	1042	1000	1035	49	8	6.125	993
FBgn0264338	1015	1000	930	100	10	10	915
FBgn0264339	1032	1000	1011	53	11	4.818181818181818	979
FBgn0264341	1027	1000	1004	50	8	6.25	977
FBgn0264343	1030	1000	996	64	8	8	966
FBgn0264345	1072	1000	1025	119	12	9.916666666666666	953
FBgn0264346	1013	1000	985	41	6	6.833333333333333	972
FBgn0264347	1005	892	965	153	17	9	852
FBgn0264349	1000	1000	982	18	5	3.6	982
FBgn0264350	1005	1000	1003	7	2	3.5	998
FBgn0264351	1038	1000	1011	65	11	5.909090909090909	973
FBgn0264352	1008	1000	970	46	7	6.571428571428571	962
FBgn0264353	1011	1000	992	30	8	3.75	981
FBgn0264357	726	699	686	67	4	16.75	659
FBgn0264359	1012	1000	999	25	7	3.5714285714285716	987
FBgn0264360	1000	1000	996	4	1	4	996
FBgn0264361	1026	1000	1006	46	8	5.75	980
FBgn0264365	1044	1000	1017	71	8	8.875	973
FBgn0264366	1009	1000	973	45	12	3.75	964
FBgn0264367	1010	1000	1005	15	3	5	995
FBgn0264368	1069	1000	1039	99	14	7.071428571428571	970
FBgn0264369	1045	1000	1004	86	12	7.166666666666667	959
FBgn0264370	1043	1000	1019	67	11	6.090909090909091	976
FBgn0264371	1005	1000	981	29	5	5.8	976
FBgn0264372	1015	1000	1004	26	6	4.333333333333333	989
FBgn0264374	1022	1000	1003	41	8	5.125	981
FBgn0264377	1001	1000	985	17	3	5.666666666666667	984
FBgn0264378	1041	1000	1005	77	9	8.555555555555555	964
FBgn0264379	1002	1000	922	82	5	16.4	920
FBgn0264380	1040	1000	980	100	10	10	940
FBgn0264381	1003	1000	989	17	8	2.125	986
FBgn0264382	1026	1000	986	66	16	4.125	960
FBgn0264384	1007	1000	981	33	6	5.5	974
FBgn0264385	1065	1000	1032	98	13	7.538461538461538	967
FBgn0264386	1017	1000	1013	21	6	3.5	996
FBgn0264389	1045	1000	1029	61	11	5.545454545454546	984
FBgn0264390	1090	1000	518	662	14	47.285714285714285	428
FBgn0264391	1001	1000	760	242	3	80.66666666666667	759
FBgn0264392	1007	1000	974	40	11	3.6363636363636362	967
FBgn0264394	1026	1000	660	392	10	39.2	634
FBgn0264428	1039	1000	1029	49	5	9.8	990
FBgn0264429	1018	1000	1004	32	10	3.2	986
FBgn0264430	1011	1000	989	33	8	4.125	978
FBgn0264433	1011	1000	976	46	8	5.75	965
FBgn0264434	1028	1000	935	121	9	13.444444444444445	907
FBgn0264435	1007	1000	988	26	9	2.888888888888889	981
FBgn0264436	733	729	723	14	7	2	719
FBgn0264438	1030	1000	996	64	10	6.4	966
FBgn0264439	1036	1000	936	136	11	12.363636363636363	900
FBgn0264440	1035	1000	1029	41	9	4.555555555555555	994
FBgn0264441	1051	1000	985	117	14	8.357142857142858	934
FBgn0264442	1012	1000	984	40	9	4.444444444444445	972
FBgn0264445	1067	1000	1063	71	10	7.1	996
FBgn0264446	895	865	892	33	3	11	862
FBgn0264447	1008	1000	996	20	7	2.857142857142857	988
FBgn0264460	1053	1000	1031	75	9	8.333333333333334	978
FBgn0264467	1002	1000	779	225	9	25	777
FBgn0264468	1000	1000	976	24	2	12	976
FBgn0264469	910	881	910	29	1	29	881
FBgn0264470	1028	1000	1015	41	10	4.1	987
FBgn0264472	1037	1000	992	82	14	5.857142857142857	955
FBgn0264474	1024	1000	955	93	8	11.625	931
FBgn0264475	1032	1000	931	133	16	8.3125	899
FBgn0264477	1000	1000	969	31	3	10.333333333333334	969
FBgn0264478	1002	1000	998	6	4	1.5	996
FBgn0264480	1055	1000	1044	66	14	4.714285714285714	989
FBgn0264481	1014	1000	1011	17	5	3.4	997
FBgn0264483	1000	1000	977	23	2	11.5	977
FBgn0264484	1012	1000	1007	17	4	4.25	995
FBgn0264485	1013	1000	945	81	7	11.571428571428571	932
FBgn0264489	1050	1000	1008	92	11	8.363636363636363	958
FBgn0264490	1000	1000	974	26	9	2.888888888888889	974
FBgn0264491	1001	1000	999	3	2	1.5	998
FBgn0264493	1031	1000	1001	61	13	4.6923076923076925	970
FBgn0264494	1001	1000	993	9	4	2.25	992
FBgn0264495	1069	1000	1031	107	18	5.944444444444445	962
FBgn0264496	1010	1000	995	25	8	3.125	985
FBgn0264500	1057	1000	1030	84	10	8.4	973
FBgn0264502	1050	1000	1024	76	16	4.75	974
FBgn0264503	1027	1000	950	104	17	6.117647058823529	923
FBgn0264504	1008	1000	991	25	5	5	983
FBgn0264505	1011	1000	940	82	15	5.466666666666667	929
FBgn0264506	1025	1000	989	61	7	8.714285714285714	964
FBgn0264508	1018	1000	1018	18	6	3	1000
FBgn0264509	1031	1000	979	83	16	5.1875	948
FBgn0264510	1007	1000	985	29	12	2.4166666666666665	978
FBgn0264514	823	768	814	64	8	8	759
FBgn0264515	1016	1000	1005	27	10	2.7	989
FBgn0264516	1008	1000	979	37	8	4.625	971
FBgn0264518	1058	1000	997	119	11	10.818181818181818	939
FBgn0264539	1027	1000	1014	40	6	6.666666666666667	987
FBgn0264540	1074	1000	987	161	16	10.0625	913
FBgn0264542	1025	1000	1018	32	7	4.571428571428571	993
FBgn0264543	1032	1000	1026	38	5	7.6	994
FBgn0264546	1005	1000	994	16	10	1.6	989
FBgn0264550	1000	1000	937	63	8	7.875	937
FBgn0264551	1053	1000	992	114	11	10.363636363636363	939
FBgn0264552	1006	1000	931	81	9	9	925
FBgn0264560	1000	1000	998	2	1	2	998
FBgn0264561	1050	1000	987	113	9	12.555555555555555	937
FBgn0264563	1002	1000	978	26	8	3.25	976
FBgn0264566	1009	1000	993	25	10	2.5	984
FBgn0264567	1040	1000	1015	65	7	9.285714285714286	975
FBgn0264573	1030	1000	926	134	10	13.4	896
FBgn0264574	1002	1000	970	34	6	5.666666666666667	968
FBgn0264598	1018	1000	1006	30	8	3.75	988
FBgn0264599	1000	1000	994	6	2	3	994
FBgn0264600	1099	1000	1034	164	12	13.666666666666666	935
FBgn0264601	1016	1000	905	127	9	14.11111111111111	889
FBgn0264602	1077	1000	1052	102	9	11.333333333333334	975
FBgn0264606	1010	1000	995	25	5	5	985
FBgn0264607	1010	1000	475	545	9	60.55555555555556	465
FBgn0264617	1000	1000	702	298	3	99.33333333333333	702
FBgn0264674	1019	1000	1000	38	9	4.222222222222222	981
FBgn0264676	1025	1000	749	301	8	37.625	724
FBgn0264677	1018	1000	966	70	10	7	948
FBgn0264679	1024	1000	991	57	8	7.125	967
FBgn0264694	1000	1000	989	11	6	1.8333333333333333	989
FBgn0264695	1002	1000	985	19	5	3.8	983
FBgn0264696	1006	1000	1004	8	4	2	998
FBgn0264697	1052	1000	1048	56	7	8	996
FBgn0264700	1011	1000	974	48	7	6.857142857142857	963
FBgn0264702	1077	1000	1071	83	10	8.3	994
FBgn0264705	1043	1000	1011	75	11	6.818181818181818	968
FBgn0264707	984	869	958	141	15	9.4	843
FBgn0264708	1000	1000	967	33	2	16.5	967
FBgn0264709	1040	1000	1028	52	7	7.428571428571429	988
FBgn0264710	1000	1000	1000	0	0	NA	1000
FBgn0264712	1061	1000	1057	65	14	4.642857142857143	996
FBgn0264713	720	685	702	53	10	5.3	667
FBgn0264714	1024	1000	983	65	13	5	959
FBgn0264715	1001	1000	972	30	8	3.75	971
FBgn0264719	1029	1000	876	182	8	22.75	847
FBgn0264720	1030	1000	893	167	13	12.846153846153847	863
FBgn0264721	1007	1000	1006	8	4	2	999
FBgn0264722	1016	1000	1014	18	5	3.6	998
FBgn0264724	1005	1000	948	62	9	6.888888888888889	943
FBgn0264725	1003	1000	950	56	6	9.333333333333334	947
FBgn0264726	1075	1000	1057	93	8	11.625	982
FBgn0264738	1024	1000	998	50	9	5.555555555555555	974
FBgn0264751	1013	1000	1007	19	8	2.375	994
FBgn0264753	1002	1000	989	15	3	5	987
FBgn0264775	1004	1000	923	85	10	8.5	919
FBgn0264785	1038	1000	1011	65	11	5.909090909090909	973
FBgn0264787	1016	1000	916	116	12	9.666666666666666	900
FBgn0264788	1001	1000	975	27	6	4.5	974
FBgn0264789	1083	1000	1057	109	13	8.384615384615385	974
FBgn0264790	1042	1000	1037	47	8	5.875	995
FBgn0264791	1005	1000	997	13	3	4.333333333333333	992
FBgn0264792	1014	1000	979	49	9	5.444444444444445	965
FBgn0264793	1009	1000	953	65	14	4.642857142857143	944
FBgn0264794	730	729	726	5	3	1.6666666666666667	725
FBgn0264810	1025	1000	1004	46	7	6.571428571428571	979
FBgn0264815	1006	1000	970	42	6	7	964
FBgn0264816	1055	1000	991	119	11	10.818181818181818	936
FBgn0264818	1028	1000	996	60	12	5	968
FBgn0264819	1011	1000	938	84	6	14	927
FBgn0264821	1009	1000	929	89	7	12.714285714285714	920
FBgn0264823	1054	1000	670	438	11	39.81818181818182	616
FBgn0264824	1006	1000	1006	6	1	6	1000
FBgn0264825	1003	1000	960	46	4	11.5	957
FBgn0264828	1003	1000	996	10	4	2.5	993
FBgn0264832	1028	1000	1021	35	5	7	993
FBgn0264838	1000	1000	988	12	3	4	988
FBgn0264839	1020	1000	1018	22	6	3.6666666666666665	998
FBgn0264840	1011	1000	994	28	7	4	983
FBgn0264841	1005	1000	993	17	5	3.4	988
FBgn0264844	1014	1000	982	46	10	4.6	968
FBgn0264845	719	710	121	607	3	202.33333333333334	112
FBgn0264848	1004	1000	1000	8	6	1.3333333333333333	996
FBgn0264857	1000	1000	994	6	1	6	994
FBgn0264863	713	705	568	153	9	17	560
FBgn0264864	1012	1000	975	49	10	4.9	963
FBgn0264865	1036	1000	1021	51	11	4.636363636363637	985
FBgn0264866	1080	1000	1076	84	13	6.461538461538462	996
FBgn0264867	1022	1000	1013	31	9	3.4444444444444446	991
FBgn0264868	1043	1000	1041	45	4	11.25	998
FBgn0264869	1013	1000	998	28	6	4.666666666666667	985
FBgn0264870	1035	1000	1029	41	7	5.857142857142857	994
FBgn0264871	1001	1000	956	46	4	11.5	955
FBgn0264872	1022	1000	1003	41	8	5.125	981
FBgn0264873	1022	1000	990	54	6	9	968
FBgn0264874	1000	1000	928	72	6	12	928
FBgn0264876	1016	1000	1007	25	9	2.7777777777777777	991
FBgn0264877	1014	1000	968	60	7	8.571428571428571	954
FBgn0264878	1086	1000	1071	101	6	16.833333333333332	985
FBgn0264880	1013	1000	1001	25	6	4.166666666666667	988
FBgn0264883	1046	1000	1028	64	7	9.142857142857142	982
FBgn0264884	1003	1000	985	21	8	2.625	982
FBgn0264885	1006	1000	948	64	16	4	942
FBgn0264886	1026	1000	934	118	14	8.428571428571429	908
FBgn0264887	1048	1000	977	119	17	7	929
FBgn0264888	1024	1000	1008	40	4	10	984
FBgn0264889	1030	1000	1018	42	6	7	988
FBgn0264890	1013	1000	979	47	10	4.7	966
FBgn0264891	1042	1000	1018	66	9	7.333333333333333	976
FBgn0264892	1000	1000	967	33	4	8.25	967
FBgn0264893	1002	1000	973	31	7	4.428571428571429	971
FBgn0264894	1014	1000	991	37	8	4.625	977
FBgn0264896	1011	1000	994	28	3	9.333333333333334	983
FBgn0264898	1013	1000	1005	21	7	3	992
FBgn0264899	1072	1000	1059	85	6	14.166666666666666	987
FBgn0264902	1001	1000	983	19	5	3.8	982
FBgn0264903	1019	1000	969	69	15	4.6	950
FBgn0264905	1004	1000	981	27	4	6.75	977
FBgn0264907	1082	1000	1062	102	14	7.285714285714286	980
FBgn0264912	1040	1000	972	108	10	10.8	932
FBgn0264915	1005	1000	995	15	4	3.75	990
FBgn0264916	1055	1000	983	127	11	11.545454545454545	928
FBgn0264922	1077	1000	1033	121	18	6.722222222222222	956
FBgn0264939	1000	1000	1000	0	0	NA	1000
FBgn0264940	1015	1000	980	50	11	4.545454545454546	965
FBgn0264941	1000	1000	971	29	6	4.833333333333333	971
FBgn0264942	1033	1000	920	146	15	9.733333333333333	887
FBgn0264943	1014	1000	998	30	7	4.285714285714286	984
FBgn0264944	1031	1000	1026	36	9	4	995
FBgn0264945	1040	1000	1033	47	10	4.7	993
FBgn0264946	1011	1000	982	40	5	8	971
FBgn0264947	1032	1000	1028	36	4	9	996
FBgn0264950	1027	1000	1027	27	3	9	1000
FBgn0264952	1000	1000	994	6	1	6	994
FBgn0264953	1021	1000	965	77	8	9.625	944
FBgn0264955	1044	1000	1007	81	10	8.1	963
FBgn0264956	1052	1000	679	425	8	53.125	627
FBgn0264959	1009	1000	497	521	11	47.36363636363637	488
FBgn0264960	1132	1000	1077	187	22	8.5	945
FBgn0264961	1057	1000	637	477	14	34.07142857142857	580
FBgn0264962	1039	1000	1027	51	11	4.636363636363637	988
FBgn0264975	1013	1000	975	51	8	6.375	962
FBgn0264978	1070	1000	994	146	9	16.22222222222222	924
FBgn0264979	1020	1000	996	44	9	4.888888888888889	976
FBgn0264985	1011	1000	993	29	10	2.9	982
FBgn0264988	1022	1000	985	59	13	4.538461538461538	963
FBgn0264993	1002	1000	971	33	5	6.6	969
FBgn0264995	1002	1000	960	44	10	4.4	958
FBgn0264996	1000	1000	1000	0	0	NA	1000
FBgn0264997	1011	1000	1011	11	2	5.5	1000
FBgn0264998	1033	1000	1006	60	8	7.5	973
FBgn0264999	1006	1000	931	81	11	7.363636363636363	925
FBgn0265002	1010	1000	976	44	11	4	966
FBgn0265003	1012	1000	732	292	7	41.714285714285715	720
FBgn0265017	1000	1000	918	82	6	13.666666666666666	918
FBgn0265038	1001	1000	210	792	4	198	209
FBgn0265039	1031	1000	989	73	12	6.083333333333333	958
FBgn0265042	1012	1000	913	111	11	10.090909090909092	901
FBgn0265043	1007	1000	905	109	4	27.25	898
FBgn0265044	1038	1000	927	149	21	7.095238095238095	889
FBgn0265050	1001	1000	987	15	6	2.5	986
FBgn0265051	1021	1000	985	57	10	5.7	964
FBgn0265053	1012	1000	1008	16	5	3.2	996
FBgn0265058	1032	1000	1027	37	8	4.625	995
FBgn0265059	1050	1000	1009	91	9	10.11111111111111	959
FBgn0265062	1017	1000	1004	30	9	3.3333333333333335	987
FBgn0265063	1030	1000	998	62	12	5.166666666666667	968
FBgn0265064	1003	1000	904	102	9	11.333333333333334	901
FBgn0265067	1000	1000	993	7	2	3.5	993
FBgn0265070	1002	1000	958	46	9	5.111111111111111	956
FBgn0265071	1009	1000	989	29	4	7.25	980
FBgn0265072	1005	1000	990	20	8	2.5	985
FBgn0265076	1020	1000	989	51	8	6.375	969
FBgn0265078	1024	1000	1020	28	8	3.5	996
FBgn0265079	1023	1000	1017	29	5	5.8	994
FBgn0265080	1002	1000	990	14	7	2	988
FBgn0265081	1024	1000	1016	32	5	6.4	992
FBgn0265085	1004	1000	974	34	7	4.857142857142857	970
FBgn0265087	1010	1000	986	34	8	4.25	976
FBgn0265088	1142	1000	1112	172	19	9.052631578947368	970
FBgn0265089	1003	1000	989	17	4	4.25	986
FBgn0265097	1010	1000	963	57	12	4.75	953
FBgn0265098	1001	1000	964	38	10	3.8	963
FBgn0265099	1026	1000	993	59	9	6.555555555555555	967
FBgn0265102	1002	1000	981	23	9	2.5555555555555554	979
FBgn0265103	976	950	969	33	7	4.714285714285714	943
FBgn0265104	1001	1000	975	27	5	5.4	974
FBgn0265105	1003	1000	999	7	3	2.3333333333333335	996
FBgn0265106	1016	1000	981	51	7	7.285714285714286	965
FBgn0265107	1051	1000	1036	66	10	6.6	985
FBgn0265137	968	927	916	93	11	8.454545454545455	875
FBgn0265139	1000	1000	962	38	8	4.75	962
FBgn0265142	1018	1000	993	43	6	7.166666666666667	975
FBgn0265143	1006	1000	1004	8	3	2.6666666666666665	998
FBgn0265145	1024	1000	1005	43	9	4.777777777777778	981
FBgn0265147	1016	1000	997	35	6	5.833333333333333	981
FBgn0265148	1011	1000	922	100	12	8.333333333333334	911
FBgn0265149	1013	1000	994	32	9	3.5555555555555554	981
FBgn0265150	1005	1000	867	143	6	23.833333333333332	862
FBgn0265152	1014	1000	1000	28	5	5.6	986
FBgn0265153	1049	1000	1048	50	9	5.555555555555555	999
FBgn0265155	1062	1000	1017	107	11	9.727272727272727	955
FBgn0265156	1021	1000	1015	27	7	3.857142857142857	994
FBgn0265157	1008	1000	988	28	9	3.111111111111111	980
FBgn0265160	1028	1000	1027	29	4	7.25	999
FBgn0265161	1027	1000	960	94	14	6.714285714285714	933
FBgn0265162	1049	1000	1000	98	18	5.444444444444445	951
FBgn0265165	1005	1000	985	25	5	5	980
FBgn0265166	1020	1000	946	94	8	11.75	926
FBgn0265167	1014	1000	971	57	7	8.142857142857142	957
FBgn0265169	1000	1000	976	24	6	4	976
FBgn0265174	1000	1000	999	1	1	1	999
FBgn0265177	1009	1000	1006	12	3	4	997
FBgn0265182	1039	1000	1030	48	7	6.857142857142857	991
FBgn0265187	1004	1000	983	25	7	3.5714285714285716	979
FBgn0265192	1000	1000	982	18	6	3	982
FBgn0265193	1016	1000	1002	30	5	6	986
FBgn0265196	1022	1000	1000	44	6	7.333333333333333	978
FBgn0265197	1005	1000	979	31	6	5.166666666666667	974
FBgn0265198	1021	1000	972	70	10	7	951
FBgn0265200	1015	1000	1005	25	6	4.166666666666667	990
FBgn0265202	1010	1000	988	32	8	4	978
FBgn0265203	1013	1000	979	47	10	4.7	966
FBgn0265204	1020	1000	1012	28	10	2.8	992
FBgn0265205	1002	1000	932	72	5	14.4	930
FBgn0265253	1030	1000	1010	50	9	5.555555555555555	980
FBgn0265255	1007	1000	750	264	4	66	743
FBgn0265256	1000	1000	985	15	7	2.142857142857143	985
FBgn0265257	1012	1000	984	40	11	3.6363636363636362	972
FBgn0265262	1034	1000	1030	38	7	5.428571428571429	996
FBgn0265265	1010	1000	905	115	10	11.5	895
FBgn0265266	1009	1000	999	19	6	3.1666666666666665	990
FBgn0265267	1002	1000	809	195	5	39	807
FBgn0265268	1049	1000	1007	91	12	7.583333333333333	958
FBgn0265269	1029	1000	1009	49	6	8.166666666666666	980
FBgn0265271	1009	1000	960	58	6	9.666666666666666	951
FBgn0265274	1005	1000	975	35	6	5.833333333333333	970
FBgn0265276	1018	1000	997	39	4	9.75	979
FBgn0265295	1002	1000	992	12	6	2	990
FBgn0265296	1051	1000	1040	62	10	6.2	989
FBgn0265297	855	841	846	23	6	3.8333333333333335	832
FBgn0265298	1000	1000	995	5	3	1.6666666666666667	995
FBgn0265299	1018	1000	1002	34	10	3.4	984
FBgn0265301	1083	999	1059	108	12	9	975
FBgn0265302	1000	1000	985	15	4	3.75	985
FBgn0265304	1008	1000	991	25	8	3.125	983
FBgn0265305	1034	1000	1024	44	9	4.888888888888889	990
FBgn0265306	1089	1000	1059	119	14	8.5	970
FBgn0265308	1020	1000	978	62	12	5.166666666666667	958
FBgn0265309	1069	1000	1063	75	12	6.25	994
FBgn0265310	1032	1000	1032	32	3	10.666666666666666	1000
FBgn0265311	1007	1000	847	167	10	16.7	840
FBgn0265312	1015	1000	1006	24	6	4	991
FBgn0265314	1000	1000	959	41	3	13.666666666666666	959
FBgn0265315	1010	1000	969	51	9	5.666666666666667	959
FBgn0265316	1032	1000	1027	37	10	3.7	995
FBgn0265317	1026	1000	972	80	12	6.666666666666667	946
FBgn0265318	1016	1000	1009	23	6	3.8333333333333335	993
FBgn0265338	1018	1000	1009	27	7	3.857142857142857	991
FBgn0265339	1030	1000	989	71	7	10.142857142857142	959
FBgn0265340	1000	1000	995	5	1	5	995
FBgn0265341	1000	1000	967	33	5	6.6	967
FBgn0265345	1005	1000	1005	5	3	1.6666666666666667	1000
FBgn0265348	1031	1000	897	165	21	7.857142857142857	866
FBgn0265349	1027	1000	978	76	12	6.333333333333333	951
FBgn0265356	1017	1000	1011	23	4	5.75	994
FBgn0265363	1011	1000	1009	13	2	6.5	998
FBgn0265364	1013	1000	975	51	9	5.666666666666667	962
FBgn0265365	1021	1000	974	68	13	5.230769230769231	953
FBgn0265366	1003	1000	746	260	4	65	743
FBgn0265367	1000	1000	963	37	4	9.25	963
FBgn0265368	1017	1000	987	47	5	9.4	970
FBgn0265369	1016	1000	982	50	10	5	966
FBgn0265371	1088	1000	1079	97	13	7.461538461538462	991
FBgn0265372	1032	1000	1004	60	11	5.454545454545454	972
FBgn0265373	1029	1000	988	70	17	4.117647058823529	959
FBgn0265375	1008	1000	1001	15	4	3.75	993
FBgn0265376	1067	1000	845	289	19	15.210526315789474	778
FBgn0265379	1005	1000	999	11	3	3.6666666666666665	994
FBgn0265381	1005	1000	952	58	6	9.666666666666666	947
FBgn0265382	1022	1000	985	59	9	6.555555555555555	963
FBgn0265414	1080	1000	1053	107	12	8.916666666666666	973
FBgn0265419	1006	1000	948	64	9	7.111111111111111	942
FBgn0265422	1008	1000	935	81	6	13.5	927
FBgn0265423	1017	1000	954	80	7	11.428571428571429	937
FBgn0265425	1006	1000	989	23	5	4.6	983
FBgn0265426	1079	1000	1049	109	10	10.9	970
FBgn0265427	1067	1000	1053	81	5	16.2	986
FBgn0265428	1014	1000	1005	23	7	3.2857142857142856	991
FBgn0265444	1007	1000	979	35	7	5	972
FBgn0265445	1011	1000	935	87	14	6.214285714285714	924
FBgn0265446	1033	1000	999	67	13	5.153846153846154	966
FBgn0265448	1035	1000	1018	52	12	4.333333333333333	983
FBgn0265449	1022	1000	927	117	11	10.636363636363637	905
FBgn0265451	1000	1000	1000	0	0	NA	1000
FBgn0265454	1010	1000	910	110	11	10	900
FBgn0265455	1027	1000	996	58	11	5.2727272727272725	969
FBgn0265458	1000	1000	987	13	3	4.333333333333333	987
FBgn0265464	1009	1000	1003	15	5	3	994
FBgn0265468	1019	1000	982	56	18	3.111111111111111	963
FBgn0265469	1068	1000	1015	121	13	9.307692307692308	947
FBgn0265470	1012	1000	954	70	7	10	942
FBgn0265487	1020	1000	1008	32	8	4	988
FBgn0265496	1061	1000	1042	80	11	7.2727272727272725	981
FBgn0265498	1009	1000	957	61	8	7.625	948
FBgn0265499	1004	1000	982	26	6	4.333333333333333	978
FBgn0265500	1001	1000	985	17	4	4.25	984
FBgn0265508	1018	1000	1008	28	6	4.666666666666667	990
FBgn0265509	1006	1000	840	172	7	24.571428571428573	834
FBgn0265510	1032	1000	1017	47	12	3.9166666666666665	985
FBgn0265511	1041	1000	1017	65	12	5.416666666666667	976
FBgn0265523	1043	1000	990	96	20	4.8	947
FBgn0265524	1040	1000	959	121	15	8.066666666666666	919
FBgn0265525	1023	1000	980	66	15	4.4	957
FBgn0265526	1006	1000	963	49	8	6.125	957
FBgn0265527	1038	1000	1035	41	7	5.857142857142857	997
FBgn0265529	1007	1000	990	24	8	3	983
FBgn0265530	1030	1000	991	69	15	4.6	961
FBgn0265531	1011	1000	1007	15	5	3	996
FBgn0265532	1012	1000	989	35	5	7	977
FBgn0265534	1060	1000	980	140	16	8.75	920
FBgn0265537	1000	1000	977	23	5	4.6	977
FBgn0265539	1015	1000	950	80	8	10	935
FBgn0265540	1031	1000	1029	33	7	4.714285714285714	998
FBgn0265543	1003	1000	976	30	7	4.285714285714286	973
FBgn0265544	1048	1000	930	166	14	11.857142857142858	882
FBgn0265545	1023	1000	1012	34	16	2.125	989
FBgn0265549	1003	1000	966	40	9	4.444444444444445	963
FBgn0265550	1013	1000	1001	25	4	6.25	988
FBgn0265551	1058	1000	1046	70	9	7.777777777777778	988
FBgn0265574	1000	1000	984	16	4	4	984
FBgn0265575	1026	1000	963	89	13	6.846153846153846	937
FBgn0265578	878	872	871	13	4	3.25	865
FBgn0265579	1014	1000	842	186	7	26.571428571428573	828
FBgn0265580	1014	1000	997	31	4	7.75	983
FBgn0265582	1030	1000	920	140	8	17.5	890
FBgn0265583	1002	1000	986	18	4	4.5	984
FBgn0265584	752	750	714	40	7	5.714285714285714	712
FBgn0265585	1025	1000	977	73	7	10.428571428571429	952
FBgn0265588	1037	1000	1033	41	9	4.555555555555555	996
FBgn0265589	1000	1000	997	3	1	3	997
FBgn0265590	1000	1000	975	25	5	5	975
FBgn0265591	1017	1000	1007	27	5	5.4	990
FBgn0265592	1024	1000	977	71	16	4.4375	953
FBgn0265593	1024	1000	947	101	10	10.1	923
FBgn0265594	1011	1000	982	40	7	5.714285714285714	971
FBgn0265595	1019	1000	978	60	13	4.615384615384615	959
FBgn0265596	1076	1000	1037	115	17	6.764705882352941	961
FBgn0265597	1018	1000	975	61	10	6.1	957
FBgn0265605	1003	1000	985	21	8	2.625	982
FBgn0265606	1001	1000	996	6	4	1.5	995
FBgn0265608	1040	1000	970	110	8	13.75	930
FBgn0265611	1089	1000	1065	113	14	8.071428571428571	976
FBgn0265612	1024	1000	988	60	10	6	964
FBgn0265613	1149	1000	1049	249	20	12.45	900
FBgn0265614	1027	1000	990	64	8	8	963
FBgn0265623	1040	1000	1011	69	9	7.666666666666667	971
FBgn0265625	1017	1000	999	35	7	5	982
FBgn0265630	1014	1000	997	31	8	3.875	983
FBgn0265631	1023	1000	995	51	10	5.1	972
FBgn0265632	1017	1000	1001	33	7	4.714285714285714	984
FBgn0265635	1012	1000	996	28	7	4	984
FBgn0265636	1031	1000	1024	38	9	4.222222222222222	993
FBgn0265637	1013	1000	888	138	7	19.714285714285715	875
FBgn0265638	1021	1000	964	78	9	8.666666666666666	943
FBgn0265639	1036	1000	985	87	10	8.7	949
FBgn0265640	1013	1000	929	97	10	9.7	916
FBgn0265641	1039	1000	1013	65	14	4.642857142857143	974
FBgn0265642	1015	1000	989	41	13	3.1538461538461537	974
FBgn0265643	1007	1000	987	27	6	4.5	980
FBgn0265646	988	985	981	10	6	1.6666666666666667	978
FBgn0265649	1007	1000	954	60	8	7.5	947
FBgn0265651	1016	1000	953	79	8	9.875	937
FBgn0265657	1025	1000	974	76	9	8.444444444444445	949
FBgn0265658	1017	1000	1005	29	9	3.2222222222222223	988
FBgn0265660	1005	1000	971	39	8	4.875	966
FBgn0265661	1012	1000	988	36	13	2.769230769230769	976
FBgn0265662	1027	1000	1010	44	9	4.888888888888889	983
FBgn0265663	1000	1000	903	97	9	10.777777777777779	903
FBgn0265664	1033	1000	677	389	16	24.3125	644
FBgn0265665	778	771	771	14	5	2.8	764
FBgn0265666	1036	1000	1033	39	4	9.75	997
FBgn0265670	863	854	849	23	4	5.75	840
FBgn0265671	1010	1000	966	54	7	7.714285714285714	956
FBgn0265672	1027	1000	1009	45	8	5.625	982
FBgn0265673	1006	1000	991	21	4	5.25	985
FBgn0265674	1019	1000	997	41	8	5.125	978
FBgn0265675	1000	1000	966	34	4	8.5	966
FBgn0265676	1005	1000	649	361	7	51.57142857142857	644
FBgn0265678	1000	1000	976	24	3	8	976
FBgn0265679	1001	1000	990	12	5	2.4	989
FBgn0265680	1022	1000	1008	36	5	7.2	986
FBgn0265682	1054	1000	1046	62	8	7.75	992
FBgn0265683	1005	1000	923	87	14	6.214285714285714	918
FBgn0265684	1053	1000	1023	83	11	7.545454545454546	970
FBgn0265687	1008	1000	956	60	15	4	948
FBgn0265688	1019	1000	960	78	11	7.090909090909091	941
FBgn0265690	752	752	735	17	4	4.25	735
FBgn0265691	1016	1000	967	65	8	8.125	951
FBgn0265692	1000	1000	993	7	2	3.5	993
FBgn0265693	1014	1000	950	78	9	8.666666666666666	936
FBgn0265694	1005	1000	959	51	4	12.75	954
FBgn0265695	1005	1000	937	73	6	12.166666666666666	932
FBgn0265696	1001	1000	888	114	5	22.8	887
FBgn0265697	1053	1000	990	116	9	12.88888888888889	937
FBgn0265699	1000	1000	990	10	1	10	990
FBgn0265700	1087	1000	1064	110	16	6.875	977
FBgn0265701	1044	1000	925	163	18	9.055555555555555	881
FBgn0265702	1014	1000	1002	26	9	2.888888888888889	988
FBgn0265704	1031	1000	977	85	9	9.444444444444445	946
FBgn0265705	1023	1000	981	65	13	5	958
FBgn0265706	1026	1000	1013	39	7	5.571428571428571	987
FBgn0265707	1025	1000	977	73	11	6.636363636363637	952
FBgn0265708	1016	1000	883	149	11	13.545454545454545	867
FBgn0265710	1085	1000	1033	137	15	9.133333333333333	948
FBgn0265712	1014	1000	990	38	8	4.75	976
FBgn0265713	1010	1000	913	107	6	17.833333333333332	903
FBgn0265715	1025	1000	991	59	13	4.538461538461538	966
FBgn0265716	1001	1000	992	10	4	2.5	991
FBgn0265718	1009	1000	986	32	10	3.2	977
FBgn0265719	1028	1000	956	100	12	8.333333333333334	928
FBgn0265720	1015	1000	969	61	10	6.1	954
FBgn0265721	1031	1000	1006	56	7	8	975
FBgn0265722	1011	1000	954	68	10	6.8	943
FBgn0265723	1004	1000	972	36	5	7.2	968
FBgn0265725	1009	1000	1004	14	3	4.666666666666667	995
FBgn0265726	1054	1000	994	114	15	7.6	940
FBgn0265728	1015	1000	1003	27	5	5.4	988
FBgn0265729	1025	1000	1020	30	3	10	995
FBgn0265730	1012	1000	958	66	7	9.428571428571429	946
FBgn0265731	1030	1000	987	73	13	5.615384615384615	957
FBgn0265732	1057	1000	1039	75	8	9.375	982
FBgn0265733	1051	1000	1035	67	13	5.153846153846154	984
FBgn0265735	1013	1000	992	34	8	4.25	979
FBgn0265737	1040	1000	1027	53	8	6.625	987
FBgn0265738	1004	1000	1000	8	3	2.6666666666666665	996
FBgn0265739	1005	1000	968	42	6	7	963
FBgn0265740	1024	1000	951	97	9	10.777777777777779	927
FBgn0265741	1035	1000	1031	39	5	7.8	996
FBgn0265742	1000	1000	998	2	2	1	998
FBgn0265743	1104	1000	1082	126	14	9	978
FBgn0265744	1057	1000	1032	82	10	8.2	975
FBgn0265745	1006	1000	969	43	7	6.142857142857143	963
FBgn0265746	1060	1000	1026	94	9	10.444444444444445	966
FBgn0265747	1028	1000	1028	28	5	5.6	1000
FBgn0265749	1030	1000	1010	50	9	5.555555555555555	980
FBgn0265751	1013	1000	995	31	4	7.75	982
FBgn0265752	1010	1000	997	23	5	4.6	987
FBgn0265753	1017	1000	924	110	9	12.222222222222221	907
FBgn0265754	1074	1000	1038	110	10	11	964
FBgn0265755	1004	1000	999	9	5	1.8	995
FBgn0265756	1010	1000	995	25	6	4.166666666666667	985
FBgn0265758	1069	1000	1052	86	11	7.818181818181818	983
FBgn0265759	1043	1000	1023	63	9	7	980
FBgn0265760	1054	1000	1004	104	13	8	950
FBgn0265761	1041	1000	866	216	12	18	825
FBgn0265762	1007	1000	992	22	6	3.6666666666666665	985
FBgn0265763	1002	1000	987	17	6	2.8333333333333335	985
FBgn0265764	1005	1000	993	17	5	3.4	988
FBgn0265765	1008	1000	992	24	6	4	984
FBgn0265766	1000	1000	976	24	1	24	976
FBgn0265767	1015	1000	652	378	9	42	637
FBgn0265778	1010	1000	976	44	7	6.285714285714286	966
FBgn0265784	1014	1000	987	41	11	3.727272727272727	973
FBgn0265785	1035	1000	1020	50	7	7.142857142857143	985
FBgn0265786	964	957	923	48	7	6.857142857142857	916
FBgn0265788	1009	1000	1005	13	9	1.4444444444444444	996
FBgn0265789	1000	1000	973	27	3	9	973
FBgn0265790	1015	1000	1000	30	9	3.3333333333333335	985
FBgn0265791	823	812	769	65	7	9.285714285714286	758
FBgn0265792	1064	1000	1029	99	10	9.9	965
FBgn0265794	1022	1000	1003	41	11	3.727272727272727	981
FBgn0265795	1031	1000	996	66	14	4.714285714285714	965
FBgn0265796	1001	1000	955	47	9	5.222222222222222	954
FBgn0265797	1031	1000	994	68	13	5.230769230769231	963
FBgn0265798	1072	1000	1012	132	19	6.947368421052632	940
FBgn0265799	1040	1000	986	94	23	4.086956521739131	946
FBgn0265800	1003	1000	997	9	4	2.25	994
FBgn0265801	1011	1000	993	29	8	3.625	982
FBgn0265802	1006	1000	858	154	14	11	852
FBgn0265803	1006	1000	987	25	6	4.166666666666667	981
FBgn0265805	1010	1000	990	30	7	4.285714285714286	980
FBgn0265807	1001	1000	817	185	8	23.125	816
FBgn0265808	1060	1000	1032	88	13	6.769230769230769	972
FBgn0265811	1004	1000	988	20	6	3.3333333333333335	984
FBgn0265812	1005	1000	984	26	9	2.888888888888889	979
FBgn0265813	1012	1000	997	27	12	2.25	985
FBgn0265814	1001	1000	944	58	11	5.2727272727272725	943
FBgn0265815	1017	1000	975	59	7	8.428571428571429	958
FBgn0265817	1019	1000	973	65	8	8.125	954
FBgn0265818	1033	1000	1008	58	9	6.444444444444445	975
FBgn0265820	1023	1000	1019	27	7	3.857142857142857	996
FBgn0265821	1008	1000	983	33	11	3	975
FBgn0265823	1049	1000	1018	80	12	6.666666666666667	969
FBgn0265824	1003	1000	984	22	8	2.75	981
FBgn0265826	1010	1000	970	50	5	10	960
FBgn0265827	1004	1000	979	29	5	5.8	975
FBgn0265828	1006	1000	1003	9	3	3	997
FBgn0265829	1013	1000	929	97	10	9.7	916
FBgn0265831	1104	1000	1057	151	18	8.38888888888889	953
FBgn0265832	1066	1000	1011	121	19	6.368421052631579	945
FBgn0265833	1036	1000	1020	52	10	5.2	984
FBgn0265834	1017	1000	969	65	9	7.222222222222222	952
FBgn0265837	1034	1000	1013	55	10	5.5	979
FBgn0265838	1001	1000	995	7	5	1.4	994
FBgn0265839	1009	1000	955	63	7	9	946
FBgn0265840	1051	1000	1046	56	4	14	995
FBgn0265841	1013	1000	999	27	4	6.75	986
FBgn0265842	1013	1000	916	110	6	18.333333333333332	903
FBgn0265843	1010	1000	965	55	10	5.5	955
FBgn0265844	1008	1000	979	37	7	5.285714285714286	971
FBgn0265845	1013	1000	1012	14	4	3.5	999
FBgn0265846	1020	1000	1002	38	11	3.4545454545454546	982
FBgn0265849	1032	1000	1016	48	6	8	984
FBgn0265850	909	899	896	23	7	3.2857142857142856	886
FBgn0265851	1015	1000	956	74	12	6.166666666666667	941
FBgn0265853	1008	1000	954	62	13	4.769230769230769	946
FBgn0265854	1056	1000	1014	98	12	8.166666666666666	958
FBgn0265855	1025	1000	1004	46	7	6.571428571428571	979
FBgn0265857	1063	1000	1020	106	14	7.571428571428571	957
FBgn0265859	1035	1000	1010	60	10	6	975
FBgn0265861	1014	1000	960	68	7	9.714285714285714	946
FBgn0265862	1013	1000	958	68	8	8.5	945
FBgn0265863	1019	1000	961	77	10	7.7	942
FBgn0265864	1012	1000	1001	23	4	5.75	989
FBgn0265865	1027	1000	956	98	20	4.9	929
FBgn0265866	1033	1000	933	133	15	8.866666666666667	900
FBgn0265869	1003	1000	875	131	13	10.076923076923077	872
FBgn0265870	1020	1000	1012	28	6	4.666666666666667	992
FBgn0265873	1012	1000	979	45	8	5.625	967
FBgn0265874	1002	1000	907	97	12	8.083333333333334	905
FBgn0265876	1004	1000	981	27	5	5.4	977
FBgn0265878	1005	1000	979	31	10	3.1	974
FBgn0265879	1007	1000	979	35	7	5	972
FBgn0265880	1043	1000	965	121	15	8.066666666666666	922
FBgn0265882	1003	1000	965	41	6	6.833333333333333	962
FBgn0265883	1006	1000	936	76	14	5.428571428571429	930
FBgn0265884	1023	1000	932	114	6	19	909
FBgn0265885	1028	1000	1004	52	9	5.777777777777778	976
FBgn0265886	1000	1000	950	50	2	25	950
FBgn0265887	1060	1000	1045	75	13	5.769230769230769	985
FBgn0265889	1061	1000	1037	85	13	6.538461538461538	976
FBgn0265890	1014	1000	985	43	8	5.375	971
FBgn0265891	1053	1000	1026	80	9	8.88888888888889	973
FBgn0265892	1018	1000	902	134	10	13.4	884
FBgn0265893	691	687	675	20	4	5	671
FBgn0265894	1009	1000	931	87	10	8.7	922
FBgn0265895	1007	1000	997	17	4	4.25	990
FBgn0265897	1029	1000	1022	36	8	4.5	993
FBgn0265898	1030	1000	1003	57	10	5.7	973
FBgn0265900	1035	1000	994	76	5	15.2	959
FBgn0265901	1004	1000	998	10	6	1.6666666666666667	994
FBgn0265902	1018	1000	763	273	5	54.6	745
FBgn0265903	1016	1000	911	121	7	17.285714285714285	895
FBgn0265904	1022	1000	1017	27	7	3.857142857142857	995
FBgn0265905	1004	1000	960	48	3	16	956
FBgn0265908	1020	1000	1009	31	9	3.4444444444444446	989
FBgn0265911	1023	1000	1004	42	9	4.666666666666667	981
FBgn0265912	1034	1000	972	96	16	6	938
FBgn0265913	1003	1000	955	51	8	6.375	952
FBgn0265914	1026	1000	976	76	13	5.846153846153846	950
FBgn0265915	1037	1000	956	118	5	23.6	919
FBgn0265916	1008	1000	993	23	3	7.666666666666667	985
FBgn0265917	1014	1000	981	47	7	6.714285714285714	967
FBgn0265918	1028	1000	968	88	15	5.866666666666666	940
FBgn0265919	1003	1000	894	112	16	7	891
FBgn0265921	1053	1000	1023	83	8	10.375	970
FBgn0265922	1040	1000	971	109	15	7.266666666666667	931
FBgn0265924	1044	1000	1003	85	10	8.5	959
FBgn0265926	1014	1000	956	72	13	5.538461538461538	942
FBgn0265927	1055	1000	979	131	21	6.238095238095238	924
FBgn0265928	941	905	919	58	11	5.2727272727272725	883
FBgn0265931	1080	1000	1030	130	24	5.416666666666667	950
FBgn0265933	1054	1000	1020	88	17	5.176470588235294	966
FBgn0265934	1075	1000	1044	106	17	6.235294117647059	969
FBgn0265937	1021	1000	1009	33	7	4.714285714285714	988
FBgn0265938	1061	1000	1044	78	9	8.666666666666666	983
FBgn0265939	1004	1000	946	62	11	5.636363636363637	942
FBgn0265942	1012	1000	1003	21	5	4.2	991
FBgn0265943	1001	1000	941	61	4	15.25	940
FBgn0265944	1015	1000	1006	24	9	2.6666666666666665	991
FBgn0265945	1013	1000	1003	23	6	3.8333333333333335	990
FBgn0265946	1003	1000	986	20	5	4	983
FBgn0265948	1033	1000	1021	45	6	7.5	988
FBgn0265949	1060	1000	1035	85	6	14.166666666666666	975
FBgn0265950	1016	1000	1010	22	3	7.333333333333333	994
FBgn0265951	1028	1000	1003	53	11	4.818181818181818	975
FBgn0265952	1022	1000	989	55	8	6.875	967
FBgn0265954	1018	1000	984	52	9	5.777777777777778	966
FBgn0265955	1034	1000	1016	52	10	5.2	982
FBgn0265956	1016	1000	922	110	11	10	906
FBgn0265957	1043	1000	1003	83	15	5.533333333333333	960
FBgn0265958	1025	1000	1016	34	7	4.857142857142857	991
FBgn0265959	1066	1000	1061	71	12	5.916666666666667	995
FBgn0265961	1013	1000	1004	22	5	4.4	991
FBgn0265963	1029	1000	995	63	10	6.3	966
FBgn0265964	1018	1000	1007	29	11	2.6363636363636362	989
FBgn0265965	1015	1000	997	33	5	6.6	982
FBgn0265967	1006	1000	1000	12	5	2.4	994
FBgn0265974	1003	1000	974	32	9	3.5555555555555554	971
FBgn0265976	1000	1000	992	8	2	4	992
FBgn0265977	1008	1000	1002	14	3	4.666666666666667	994
FBgn0265980	1000	1000	999	1	1	1	999
FBgn0265981	1024	1000	981	67	7	9.571428571428571	957
FBgn0265982	1063	1000	1025	101	11	9.181818181818182	962
FBgn0265983	1000	1000	997	3	1	3	997
FBgn0265986	1063	1000	1029	97	12	8.083333333333334	966
FBgn0265991	1006	1000	963	49	6	8.166666666666666	957
FBgn0265992	1010	1000	1005	15	7	2.142857142857143	995
FBgn0265993	1000	1000	995	5	3	1.6666666666666667	995
FBgn0265994	1000	1000	974	26	5	5.2	974
FBgn0265995	1019	1000	1016	22	4	5.5	997
FBgn0265996	1049	1000	1047	51	8	6.375	998
FBgn0265997	1033	1000	1029	37	5	7.4	996
FBgn0265998	1009	1000	1008	10	2	5	999
FBgn0266000	1052	1000	1037	67	8	8.375	985
FBgn0266001	1004	1000	924	84	13	6.461538461538462	920
FBgn0266002	1016	1000	1005	27	4	6.75	989
FBgn0266003	1020	1000	1003	37	8	4.625	983
FBgn0266007	1103	1000	1091	115	11	10.454545454545455	988
FBgn0266008	1021	1000	1009	33	9	3.6666666666666665	988
FBgn0266009	1028	1000	1010	46	7	6.571428571428571	982
FBgn0266010	1038	1000	1010	66	12	5.5	972
FBgn0266011	934	931	930	7	4	1.75	927
FBgn0266019	1007	1000	963	51	11	4.636363636363637	956
FBgn0266021	1017	1000	998	36	9	4	981
FBgn0266022	1006	1000	956	56	9	6.222222222222222	950
FBgn0266023	1002	1000	998	6	5	1.2	996
FBgn0266024	1035	1000	1016	54	9	6	981
FBgn0266025	1035	1000	992	78	12	6.5	957
FBgn0266027	1008	1000	988	28	7	4	980
FBgn0266028	1000	1000	983	17	1	17	983
FBgn0266029	1038	1000	969	107	9	11.88888888888889	931
FBgn0266030	1015	1000	1004	26	9	2.888888888888889	989
FBgn0266032	1028	1000	932	124	10	12.4	904
FBgn0266033	1000	1000	995	5	2	2.5	995
FBgn0266034	1023	1000	976	70	14	5	953
FBgn0266036	1028	1000	1028	28	3	9.333333333333334	1000
FBgn0266037	1003	1000	1003	3	1	3	1000
FBgn0266039	1026	1000	977	75	7	10.714285714285714	951
FBgn0266040	1006	1000	967	45	13	3.4615384615384617	961
FBgn0266041	1001	1000	997	5	4	1.25	996
FBgn0266042	863	858	846	22	5	4.4	841
FBgn0266043	932	860	922	82	9	9.11111111111111	850
FBgn0266045	1023	1000	981	65	13	5	958
FBgn0266046	1000	1000	822	178	3	59.333333333333336	822
FBgn0266048	1008	1000	1002	14	3	4.666666666666667	994
FBgn0266049	1004	1000	984	24	8	3	980
FBgn0266051	711	702	681	39	9	4.333333333333333	672
FBgn0266053	1020	1000	984	56	8	7	964
FBgn0266064	1005	1000	964	46	12	3.8333333333333335	959
FBgn0266065	1068	1000	1065	71	7	10.142857142857142	997
FBgn0266066	1020	1000	1001	39	8	4.875	981
FBgn0266067	1006	1000	989	23	5	4.6	983
FBgn0266068	1016	1000	988	44	11	4	972
FBgn0266070	1072	1000	977	167	14	11.928571428571429	905
FBgn0266071	1000	1000	983	17	1	17	983
FBgn0266073	1003	1000	960	46	7	6.571428571428571	957
FBgn0266074	1023	1000	1013	33	10	3.3	990
FBgn0266084	1018	1000	984	52	7	7.428571428571429	966
FBgn0266086	1013	1000	946	80	6	13.333333333333334	933
FBgn0266087	1000	1000	997	3	1	3	997
FBgn0266088	1002	1000	983	21	3	7	981
FBgn0266095	1000	1000	1000	0	0	NA	1000
FBgn0266096	1033	1000	1029	37	8	4.625	996
FBgn0266097	1029	1000	979	79	14	5.642857142857143	950
FBgn0266099	1015	1000	1006	24	5	4.8	991
FBgn0266100	1053	1000	989	117	17	6.882352941176471	936
FBgn0266102	889	884	845	49	10	4.9	840
FBgn0266111	1032	1000	1005	59	9	6.555555555555555	973
FBgn0266115	1025	1000	1010	40	6	6.666666666666667	985
FBgn0266124	1000	1000	963	37	3	12.333333333333334	963
FBgn0266137	1018	1000	996	40	7	5.714285714285714	978
FBgn0266139	1001	1000	1001	1	1	1	1000
FBgn0266141	1039	1000	1036	42	8	5.25	997
FBgn0266142	1011	1000	990	32	4	8	979
FBgn0266144	1001	1000	929	73	3	24.333333333333332	928
FBgn0266145	1002	1000	982	22	7	3.142857142857143	980
FBgn0266146	1002	1000	985	19	4	4.75	983
FBgn0266147	1031	1000	982	80	14	5.714285714285714	951
FBgn0266149	1012	1000	1004	20	2	10	992
FBgn0266150	1003	1000	982	24	6	4	979
FBgn0266151	1005	1000	942	68	5	13.6	937
FBgn0266153	1034	1000	1003	65	12	5.416666666666667	969
FBgn0266155	840	837	794	49	4	12.25	791
FBgn0266156	1016	1000	999	33	4	8.25	983
FBgn0266157	1007	1000	996	18	3	6	989
FBgn0266158	1001	1000	985	17	4	4.25	984
FBgn0266159	1037	1000	971	103	12	8.583333333333334	934
FBgn0266160	1026	1000	1023	29	7	4.142857142857143	997
FBgn0266161	1012	1000	1002	22	5	4.4	990
FBgn0266163	1008	1000	1007	9	2	4.5	999
FBgn0266164	1004	1000	990	18	6	3	986
FBgn0266165	1027	1000	1019	35	9	3.888888888888889	992
FBgn0266166	1002	1000	977	27	10	2.7	975
FBgn0266167	1048	1000	1042	54	6	9	994
FBgn0266169	1012	1000	931	93	13	7.153846153846154	919
FBgn0266179	1064	1000	1057	71	9	7.888888888888889	993
FBgn0266180	1067	1000	889	245	16	15.3125	822
FBgn0266182	1035	1000	1010	60	11	5.454545454545454	975
FBgn0266183	1013	1000	991	35	8	4.375	978
FBgn0266196	785	722	759	89	8	11.125	696
FBgn0266197	1015	1000	1010	20	4	5	995
FBgn0266198	1053	1000	1011	95	16	5.9375	958
FBgn0266201	1000	1000	986	14	3	4.666666666666667	986
FBgn0266202	1000	1000	989	11	4	2.75	989
FBgn0266204	1013	1000	982	44	6	7.333333333333333	969
FBgn0266207	1012	1000	1006	18	7	2.5714285714285716	994
FBgn0266208	1016	1000	1013	19	5	3.8	997
FBgn0266209	1030	1000	1028	32	5	6.4	998
FBgn0266210	1017	1000	987	47	6	7.833333333333333	970
FBgn0266211	725	713	593	144	6	24	581
FBgn0266212	842	820	810	54	10	5.4	788
FBgn0266214	1031	1000	938	124	11	11.272727272727273	907
FBgn0266215	1011	1000	1010	12	2	6	999
FBgn0266216	1005	1000	1000	10	6	1.6666666666666667	995
FBgn0266217	1010	1000	996	24	6	4	986
FBgn0266220	1007	1000	991	23	8	2.875	984
FBgn0266221	1020	1000	975	65	10	6.5	955
FBgn0266225	1019	1000	978	60	9	6.666666666666667	959
FBgn0266226	1021	1000	983	59	9	6.555555555555555	962
FBgn0266229	1012	1000	979	45	8	5.625	967
FBgn0266230	1015	1000	1002	28	6	4.666666666666667	987
FBgn0266231	1006	1000	798	214	4	53.5	792
FBgn0266232	1034	1000	958	110	18	6.111111111111111	924
FBgn0266233	1010	1000	976	44	8	5.5	966
FBgn0266234	1011	1000	1011	11	1	11	1000
FBgn0266236	1000	1000	976	24	2	12	976
FBgn0266237	1001	1000	992	10	6	1.6666666666666667	991
FBgn0266238	1011	1000	985	37	8	4.625	974
FBgn0266239	1096	1000	1028	164	12	13.666666666666666	932
FBgn0266240	1054	1000	1032	76	12	6.333333333333333	978
FBgn0266242	1007	1000	980	34	10	3.4	973
FBgn0266243	1026	1000	1007	45	11	4.090909090909091	981
FBgn0266245	1018	1000	975	61	9	6.777777777777778	957
FBgn0266246	1016	1000	956	76	9	8.444444444444445	940
FBgn0266247	1034	1000	1030	38	6	6.333333333333333	996
FBgn0266248	1038	1000	954	122	15	8.133333333333333	916
FBgn0266251	1043	1000	1011	75	13	5.769230769230769	968
FBgn0266252	1000	1000	992	8	5	1.6	992
FBgn0266254	1000	1000	997	3	2	1.5	997
FBgn0266255	1023	1000	1004	42	5	8.4	981
FBgn0266256	1052	1000	1017	87	6	14.5	965
FBgn0266257	1008	1000	1000	16	7	2.2857142857142856	992
FBgn0266259	1029	1000	1025	33	5	6.6	996
FBgn0266260	1035	1000	1022	48	7	6.857142857142857	987
FBgn0266263	1018	1000	924	112	16	7	906
FBgn0266264	1000	1000	1000	0	0	NA	1000
FBgn0266268	1028	1000	1024	32	5	6.4	996
FBgn0266276	1025	1000	1018	32	5	6.4	993
FBgn0266278	1003	1000	911	95	11	8.636363636363637	908
FBgn0266279	1028	1000	945	111	15	7.4	917
FBgn0266281	1003	1000	975	31	3	10.333333333333334	972
FBgn0266282	1025	1000	960	90	13	6.923076923076923	935
FBgn0266302	1024	1000	990	58	13	4.461538461538462	966
FBgn0266303	1001	1000	984	18	2	9	983
FBgn0266305	1078	1000	1068	88	9	9.777777777777779	990
FBgn0266307	1001	1000	547	455	5	91	546
FBgn0266309	1024	1000	995	53	12	4.416666666666667	971
FBgn0266310	1043	1000	1021	65	8	8.125	978
FBgn0266311	1025	1000	1020	30	6	5	995
FBgn0266312	1008	1000	962	54	10	5.4	954
FBgn0266313	1021	1000	982	60	10	6	961
FBgn0266315	1019	1000	1016	22	4	5.5	997
FBgn0266316	1002	1000	996	8	5	1.6	994
FBgn0266317	1004	1000	1002	6	4	1.5	998
FBgn0266318	1035	1000	993	77	13	5.923076923076923	958
FBgn0266319	1038	1000	974	102	13	7.846153846153846	936
FBgn0266320	1007	1000	1006	8	3	2.6666666666666665	999
FBgn0266321	1056	1000	1020	92	20	4.6	964
FBgn0266322	1106	1000	1101	111	12	9.25	995
FBgn0266323	1012	1000	933	91	10	9.1	921
FBgn0266324	1022	1000	1006	38	4	9.5	984
FBgn0266325	1002	1000	962	42	7	6	960
FBgn0266326	1000	1000	996	4	2	2	996
FBgn0266327	1021	1000	990	52	10	5.2	969
FBgn0266328	1026	1000	989	63	13	4.846153846153846	963
FBgn0266329	1014	1000	604	424	5	84.8	590
FBgn0266331	1049	1000	1007	91	13	7	958
FBgn0266346	983	969	936	61	18	3.388888888888889	922
FBgn0266347	1041	1000	695	387	14	27.642857142857142	654
FBgn0266348	1076	1000	1057	95	13	7.3076923076923075	981
FBgn0266349	1018	1000	1014	22	4	5.5	996
FBgn0266351	740	737	682	61	7	8.714285714285714	679
FBgn0266352	1023	1000	908	138	11	12.545454545454545	885
FBgn0266355	1022	1000	965	79	7	11.285714285714286	943
FBgn0266356	1008	1000	996	20	6	3.3333333333333335	988
FBgn0266358	1049	1000	1030	68	17	4	981
FBgn0266359	1000	1000	986	14	5	2.8	986
FBgn0266360	1003	1000	979	27	7	3.857142857142857	976
FBgn0266363	1005	1000	330	680	5	136	325
FBgn0266371	1046	1000	1010	82	9	9.11111111111111	964
FBgn0266372	1047	1000	1037	57	13	4.384615384615385	990
FBgn0266377	1019	1000	1000	38	10	3.8	981
FBgn0266379	1006	1000	1003	9	6	1.5	997
FBgn0266381	1051	1000	1001	101	9	11.222222222222221	950
FBgn0266382	1002	1000	1002	2	1	2	1000
FBgn0266383	1008	1000	966	50	6	8.333333333333334	958
FBgn0266384	1002	1000	972	32	8	4	970
FBgn0266388	1069	1000	1011	127	13	9.76923076923077	942
FBgn0266389	1015	1000	950	80	11	7.2727272727272725	935
FBgn0266391	1018	1000	1006	30	9	3.3333333333333335	988
FBgn0266392	1001	1000	963	39	6	6.5	962
FBgn0266395	1052	1000	1052	52	7	7.428571428571429	1000
FBgn0266396	1015	1000	947	83	9	9.222222222222221	932
FBgn0266398	1030	1000	1013	47	7	6.714285714285714	983
FBgn0266399	1054	1000	1050	58	5	11.6	996
FBgn0266401	1001	1000	991	11	5	2.2	990
FBgn0266402	1010	1000	990	30	4	7.5	980
FBgn0266403	1005	1000	937	73	7	10.428571428571429	932
FBgn0266404	715	698	707	25	8	3.125	690
FBgn0266408	1000	1000	940	60	6	10	940
FBgn0266409	1044	1000	1036	52	14	3.7142857142857144	992
FBgn0266410	1006	1000	945	67	7	9.571428571428571	939
FBgn0266412	1000	1000	965	35	6	5.833333333333333	965
FBgn0266413	1031	1000	955	107	10	10.7	924
FBgn0266414	1000	1000	942	58	7	8.285714285714286	942
FBgn0266415	1006	1000	997	15	2	7.5	991
FBgn0266416	1010	1000	997	23	5	4.6	987
FBgn0266417	1003	1000	987	19	7	2.7142857142857144	984
FBgn0266418	1001	1000	1000	2	2	1	999
FBgn0266419	1001	1000	972	30	6	5	971
FBgn0266420	1033	1000	1027	39	6	6.5	994
FBgn0266421	1000	1000	819	181	3	60.333333333333336	819
FBgn0266429	1062	1000	1002	122	26	4.6923076923076925	940
FBgn0266430	1042	1000	1035	49	10	4.9	993
FBgn0266431	1009	1000	990	28	10	2.8	981
FBgn0266433	1037	1000	1005	69	10	6.9	968
FBgn0266437	1019	1000	1014	24	6	4	995
FBgn0266443	1038	1000	996	80	11	7.2727272727272725	958
FBgn0266449	1014	1000	988	40	10	4	974
FBgn0266465	1031	1000	1020	42	11	3.8181818181818183	989
FBgn0266518	1002	1000	1002	2	2	1	1000
FBgn0266521	1040	1000	980	100	10	10	940
FBgn0266534	1002	1000	991	13	5	2.6	989
FBgn0266535	1005	1000	991	19	6	3.1666666666666665	986
FBgn0266536	1038	1000	985	91	13	7	947
FBgn0266537	1020	1000	860	180	9	20	840
FBgn0266549	1002	1000	982	22	9	2.4444444444444446	980
FBgn0266564	1031	1000	944	118	17	6.9411764705882355	913
FBgn0266565	1023	1000	992	54	14	3.857142857142857	969
FBgn0266566	1012	1000	1002	22	4	5.5	990
FBgn0266573	1003	1000	949	57	2	28.5	946
FBgn0266574	1007	1000	1007	7	2	3.5	1000
FBgn0266577	1021	1000	975	67	9	7.444444444444445	954
FBgn0266579	973	959	954	33	6	5.5	940
FBgn0266581	1000	1000	1000	0	0	NA	1000
FBgn0266585	1038	1000	993	83	12	6.916666666666667	955
FBgn0266586	1026	1000	966	86	16	5.375	940
FBgn0266587	1035	1000	992	78	9	8.666666666666666	957
FBgn0266588	1010	1000	990	30	5	6	980
FBgn0266589	1022	1000	1021	23	4	5.75	999
FBgn0266590	1000	1000	998	2	2	1	998
FBgn0266591	1018	1000	985	51	6	8.5	967
FBgn0266593	1026	1000	1008	44	11	4	982
FBgn0266594	1014	1000	974	54	9	6	960
FBgn0266595	1002	1000	991	13	3	4.333333333333333	989
FBgn0266598	1007	1000	990	24	5	4.8	983
FBgn0266599	1034	1000	1032	36	7	5.142857142857143	998
FBgn0266618	1032	1000	996	68	10	6.8	964
FBgn0266622	1002	1000	975	29	6	4.833333333333333	973
FBgn0266623	865	860	862	8	2	4	857
FBgn0266624	1014	1000	934	94	14	6.714285714285714	920
FBgn0266625	1007	1000	1006	8	2	4	999
FBgn0266626	1023	1000	997	49	8	6.125	974
FBgn0266627	1009	1000	990	28	6	4.666666666666667	981
FBgn0266628	1001	1000	991	11	4	2.75	990
FBgn0266629	1025	1000	971	79	15	5.266666666666667	946
FBgn0266630	1000	1000	981	19	2	9.5	981
FBgn0266632	1029	1000	1017	41	8	5.125	988
FBgn0266634	1045	1000	1039	51	9	5.666666666666667	994
FBgn0266635	1023	1000	1013	33	7	4.714285714285714	990
FBgn0266636	1000	1000	995	5	2	2.5	995
FBgn0266637	1003	1000	1000	6	3	2	997
FBgn0266638	1006	1000	1002	10	2	5	996
FBgn0266639	1011	1000	979	43	7	6.142857142857143	968
FBgn0266640	1101	1000	1076	126	10	12.6	975
FBgn0266641	1041	1000	1021	61	11	5.545454545454546	980
FBgn0266643	1014	1000	973	55	8	6.875	959
FBgn0266644	733	733	732	1	1	1	732
FBgn0266645	1000	1000	1000	0	0	NA	1000
FBgn0266646	1014	1000	990	38	8	4.75	976
FBgn0266648	1017	1000	873	161	8	20.125	856
FBgn0266649	1011	1000	962	60	13	4.615384615384615	951
FBgn0266650	1022	1000	999	45	5	9	977
FBgn0266651	1015	1000	976	54	12	4.5	961
FBgn0266654	1082	1000	1064	100	15	6.666666666666667	982
FBgn0266655	1045	1000	992	98	10	9.8	947
FBgn0266657	1009	1000	1003	15	3	5	994
FBgn0266666	1015	1000	968	62	8	7.75	953
FBgn0266667	1001	1000	987	15	5	3	986
FBgn0266669	1001	1000	1001	1	1	1	1000
FBgn0266670	1020	1000	1020	20	4	5	1000
FBgn0266671	1001	1000	974	28	5	5.6	973
FBgn0266674	1021	1000	1011	31	8	3.875	990
FBgn0266675	1007	1000	988	26	2	13	981
FBgn0266677	1035	1000	1026	44	9	4.888888888888889	991
FBgn0266678	1021	1000	1013	29	9	3.2222222222222223	992
FBgn0266680	1014	1000	987	41	13	3.1538461538461537	973
FBgn0266681	1007	1000	995	19	8	2.375	988
FBgn0266682	1030	1000	1019	41	6	6.833333333333333	989
FBgn0266685	1010	1000	995	25	8	3.125	985
FBgn0266686	1000	1000	994	6	1	6	994
FBgn0266688	1018	1000	1015	21	5	4.2	997
FBgn0266693	1050	1000	1011	89	14	6.357142857142857	961
FBgn0266696	1000	1000	999	1	1	1	999
FBgn0266697	1009	1000	1006	12	3	4	997
FBgn0266699	1013	1000	1003	23	8	2.875	990
FBgn0266700	1003	1000	1000	6	4	1.5	997
FBgn0266701	1008	1000	1001	15	7	2.142857142857143	993
FBgn0266703	1000	1000	999	1	1	1	999
FBgn0266706	1004	1000	988	20	7	2.857142857142857	984
FBgn0266708	1046	1000	957	135	16	8.4375	911
FBgn0266711	1018	1000	989	47	9	5.222222222222222	971
FBgn0266717	1000	1000	989	11	2	5.5	989
FBgn0266719	1000	1000	1000	0	0	NA	1000
FBgn0266721	1032	1000	1018	46	13	3.5384615384615383	986
FBgn0266722	1000	1000	999	1	1	1	999
FBgn0266723	704	703	698	7	3	2.3333333333333335	697
FBgn0266724	1031	1000	1020	42	13	3.230769230769231	989
FBgn0266725	1002	1000	988	16	6	2.6666666666666665	986
FBgn0266731	788	776	752	48	11	4.363636363636363	740
FBgn0266732	1018	1000	917	119	9	13.222222222222221	899
FBgn0266734	1026	1000	1007	45	8	5.625	981
FBgn0266735	1000	1000	991	9	1	9	991
FBgn0266736	1024	1000	1022	26	7	3.7142857142857144	998
FBgn0266737	1018	1000	1002	34	8	4.25	984
FBgn0266738	1083	1000	1066	100	14	7.142857142857143	983
FBgn0266741	1000	1000	994	6	2	3	994
FBgn0266742	1008	1000	991	25	6	4.166666666666667	983
FBgn0266744	1006	1000	1006	6	1	6	1000
FBgn0266745	1013	1000	999	27	7	3.857142857142857	986
FBgn0266750	1001	1000	999	3	2	1.5	998
FBgn0266751	1000	1000	984	16	4	4	984
FBgn0266756	1019	1000	975	63	12	5.25	956
FBgn0266757	1036	1000	1006	66	13	5.076923076923077	970
FBgn0266763	1013	1000	989	37	7	5.285714285714286	976
FBgn0266764	1012	1000	942	82	4	20.5	930
FBgn0266766	1001	1000	956	46	6	7.666666666666667	955
FBgn0266768	1026	1000	937	115	13	8.846153846153847	911
FBgn0266769	1019	1000	826	212	13	16.307692307692307	807
FBgn0266771	1009	1000	959	59	5	11.8	950
FBgn0266772	1027	1000	975	79	7	11.285714285714286	948
FBgn0266773	1009	1000	1001	17	5	3.4	992
FBgn0266774	742	735	684	65	10	6.5	677
FBgn0266775	1001	1000	977	25	3	8.333333333333334	976
FBgn0266776	1001	1000	992	10	6	1.6666666666666667	991
FBgn0266777	1020	1000	998	42	7	6	978
FBgn0266778	1057	1000	1028	86	10	8.6	971
FBgn0266780	1008	1000	930	86	11	7.818181818181818	922
FBgn0266781	1002	1000	977	27	4	6.75	975
FBgn0266782	1018	1000	945	91	12	7.583333333333333	927
FBgn0266783	1004	1000	951	57	11	5.181818181818182	947
FBgn0266784	1001	1000	983	19	6	3.1666666666666665	982
FBgn0266785	1042	1000	1001	83	11	7.545454545454546	959
FBgn0266786	1053	1000	1017	89	20	4.45	964
FBgn0266787	1000	1000	1000	0	0	NA	1000
FBgn0266790	930	926	885	49	7	7	881
FBgn0266795	1044	1000	1012	76	15	5.066666666666666	968
FBgn0266796	1037	1000	1020	54	12	4.5	983
FBgn0266797	1010	1000	977	43	7	6.142857142857143	967
FBgn0266798	1001	1000	999	3	3	1	998
FBgn0266799	1033	1000	963	103	10	10.3	930
FBgn0266800	1021	1000	1019	23	3	7.666666666666667	998
FBgn0266801	1017	1000	967	67	9	7.444444444444445	950
FBgn0266802	1000	1000	597	403	1	403	597
FBgn0266803	1008	1000	1002	14	4	3.5	994
FBgn0266804	1040	1000	985	95	11	8.636363636363637	945
FBgn0266805	1005	1000	750	260	4	65	745
FBgn0266806	1001	1000	989	13	4	3.25	988
FBgn0266807	1022	1000	1004	40	9	4.444444444444445	982
FBgn0266808	1015	1000	1008	22	5	4.4	993
FBgn0266809	1056	1000	1042	70	7	10	986
FBgn0266811	1002	1000	960	44	6	7.333333333333333	958
FBgn0266812	1019	1000	1014	24	3	8	995
FBgn0266813	1030	1000	1009	51	7	7.285714285714286	979
FBgn0266814	1003	1000	914	92	8	11.5	911
FBgn0266815	1029	1000	719	339	7	48.42857142857143	690
FBgn0266816	1068	1000	1024	112	12	9.333333333333334	956
FBgn0266818	1028	1000	959	97	14	6.928571428571429	931
FBgn0266819	1024	1000	1000	48	8	6	976
FBgn0266821	1004	1000	945	63	5	12.6	941
FBgn0266822	1001	1000	885	117	5	23.4	884
FBgn0266824	1031	1000	1011	51	8	6.375	980
FBgn0266825	1003	1000	968	38	8	4.75	965
FBgn0266827	1011	1000	962	60	8	7.5	951
FBgn0266828	1015	1000	990	40	6	6.666666666666667	975
FBgn0266829	1038	1000	1031	45	4	11.25	993
FBgn0266831	1037	1000	1032	42	8	5.25	995
FBgn0266834	1000	1000	984	16	4	4	984
FBgn0266836	1001	1000	997	5	3	1.6666666666666667	996
FBgn0266837	1009	1000	883	135	12	11.25	874
FBgn0266841	1003	1000	985	21	7	3	982
FBgn0266842	1018	1000	984	52	11	4.7272727272727275	966
FBgn0266843	1012	1000	951	73	11	6.636363636363637	939
FBgn0266844	1050	1000	1022	78	17	4.588235294117647	972
FBgn0266845	1000	1000	996	4	3	1.3333333333333333	996
FBgn0266846	1019	1000	1004	34	5	6.8	985
FBgn0266848	1056	1000	1004	108	12	9	948
FBgn0266849	1000	1000	983	17	4	4.25	983
FBgn0266850	1008	1000	995	21	7	3	987
FBgn0266851	1000	1000	995	5	2	2.5	995
FBgn0266852	1026	1000	1016	36	8	4.5	990
FBgn0266854	1022	1000	946	98	15	6.533333333333333	924
FBgn0266855	1005	1000	962	48	8	6	957
FBgn0266856	1013	1000	848	178	9	19.77777777777778	835
FBgn0266858	1014	1000	935	93	11	8.454545454545455	921
FBgn0266859	1019	1000	1019	19	3	6.333333333333333	1000
FBgn0266860	1003	1000	978	28	3	9.333333333333334	975
FBgn0266861	1004	1000	994	14	4	3.5	990
FBgn0266863	1101	1000	1033	169	14	12.071428571428571	932
FBgn0266864	1019	1000	962	76	9	8.444444444444445	943
FBgn0266866	1001	1000	993	9	3	3	992
FBgn0266867	1025	1000	1011	39	6	6.5	986
FBgn0266868	1014	1000	976	52	11	4.7272727272727275	962
FBgn0266870	1012	1000	969	55	11	5	957
FBgn0266872	1049	1000	1047	51	5	10.2	998
FBgn0266877	1004	1000	979	29	6	4.833333333333333	975
FBgn0266880	1036	1000	1018	54	11	4.909090909090909	982
FBgn0266881	1006	1000	978	34	6	5.666666666666667	972
FBgn0266882	1000	1000	950	50	6	8.333333333333334	950
FBgn0266884	1056	1000	1034	78	11	7.090909090909091	978
FBgn0266885	1000	1000	971	29	5	5.8	971
FBgn0266886	1024	1000	988	60	12	5	964
FBgn0266889	1010	1000	1007	13	5	2.6	997
FBgn0266891	1000	1000	940	60	7	8.571428571428571	940
FBgn0266892	1116	1000	1076	156	12	13	960
FBgn0266893	1022	1000	1002	42	11	3.8181818181818183	980
FBgn0266895	1032	1000	1002	62	13	4.769230769230769	970
FBgn0266896	1015	1000	1009	21	7	3	994
FBgn0266898	1003	1000	972	34	4	8.5	969
FBgn0266901	1012	1000	950	74	9	8.222222222222221	938
FBgn0266905	1001	1000	983	19	5	3.8	982
FBgn0266910	1032	1000	994	70	10	7	962
FBgn0266911	1019	1000	949	89	12	7.416666666666667	930
FBgn0266914	1003	1000	964	42	6	7	961
FBgn0266915	1018	1000	822	214	11	19.454545454545453	804
FBgn0266916	769	740	742	56	14	4	713
FBgn0266917	1029	1000	996	62	5	12.4	967
FBgn0266918	1004	1000	980	28	7	4	976
FBgn0266925	1036	1000	1035	37	6	6.166666666666667	999
FBgn0266926	1044	1000	1029	59	11	5.363636363636363	985
FBgn0266927	1003	1000	983	23	5	4.6	980
FBgn0266928	1017	1000	973	61	6	10.166666666666666	956
FBgn0266931	1004	1000	1004	4	1	4	1000
FBgn0266932	1045	1000	1014	76	12	6.333333333333333	969
FBgn0266933	1029	1000	1021	37	11	3.3636363636363638	992
FBgn0266937	1020	1000	801	239	9	26.555555555555557	781
FBgn0266939	1032	1000	751	313	9	34.77777777777778	719
FBgn0266941	1001	1000	975	27	7	3.857142857142857	974
FBgn0266942	1011	1000	954	68	8	8.5	943
FBgn0266945	1004	1000	979	29	7	4.142857142857143	975
FBgn0266946	1005	1000	964	46	6	7.666666666666667	959
FBgn0266947	1004	1000	984	24	6	4	980
FBgn0266948	1039	1000	995	83	10	8.3	956
FBgn0266949	1037	1000	945	129	14	9.214285714285714	908
FBgn0266950	1028	1000	977	79	13	6.076923076923077	949
FBgn0266951	1120	1000	1021	219	15	14.6	901
FBgn0266952	1003	1000	996	10	5	2	993
FBgn0266954	1019	1000	943	95	13	7.3076923076923075	924
FBgn0266956	1033	1000	1018	48	8	6	985
FBgn0266957	1001	1000	993	9	5	1.8	992
FBgn0266959	1054	1000	1034	74	9	8.222222222222221	980
FBgn0266960	1004	1000	992	16	5	3.2	988
FBgn0266961	1011	1000	988	34	9	3.7777777777777777	977
FBgn0266962	1021	1000	962	80	8	10	941
FBgn0266963	1010	1000	996	24	6	4	986
FBgn0266964	1014	1000	994	34	7	4.857142857142857	980
FBgn0266965	1019	1000	1002	36	9	4	983
FBgn0266966	1002	1000	998	6	4	1.5	996
FBgn0266967	1014	1000	1003	25	6	4.166666666666667	989
FBgn0266968	1014	1000	989	39	9	4.333333333333333	975
FBgn0266969	1004	1000	1000	8	3	2.6666666666666665	996
FBgn0266970	1022	1000	914	130	12	10.833333333333334	892
FBgn0266971	1016	1000	995	37	10	3.7	979
FBgn0266972	1007	1000	981	33	9	3.6666666666666665	974
FBgn0266973	1014	1000	983	45	12	3.75	969
FBgn0266974	1004	1000	999	9	4	2.25	995
FBgn0266975	1023	1000	1021	25	5	5	998
FBgn0266976	1022	1000	997	47	9	5.222222222222222	975
FBgn0266977	1002	1000	1002	2	2	1	1000
FBgn0266978	1035	1000	1028	42	7	6	993
FBgn0266979	1022	1000	1019	25	6	4.166666666666667	997
FBgn0266980	1005	1000	1001	9	6	1.5	996
FBgn0266983	1023	1000	869	177	7	25.285714285714285	846
FBgn0266984	1063	1000	1051	75	12	6.25	988
FBgn0266986	1010	1000	926	94	11	8.545454545454545	916
FBgn0266987	1042	1000	1035	49	10	4.9	993
FBgn0266989	1000	1000	995	5	3	1.6666666666666667	995
FBgn0266990	1017	1000	948	86	11	7.818181818181818	931
FBgn0266992	1057	1000	1045	69	12	5.75	988
FBgn0266994	1011	1000	929	93	6	15.5	918
FBgn0266995	1002	1000	999	5	3	1.6666666666666667	997
FBgn0267003	1020	1000	1001	39	7	5.571428571428571	981
FBgn0267005	1038	1000	991	85	16	5.3125	953
FBgn0267006	1018	1000	989	47	15	3.1333333333333333	971
FBgn0267007	1022	1000	985	59	11	5.363636363636363	963
FBgn0267008	1000	1000	988	12	3	4	988
FBgn0267010	897	880	884	30	7	4.285714285714286	867
FBgn0267011	1028	1000	1017	39	9	4.333333333333333	989
FBgn0267012	1003	1000	915	91	6	15.166666666666666	912
FBgn0267014	1022	1000	860	184	6	30.666666666666668	838
FBgn0267017	1078	1000	1075	81	14	5.785714285714286	997
FBgn0267018	1023	1000	987	59	9	6.555555555555555	964
FBgn0267019	1003	1000	999	7	2	3.5	996
FBgn0267021	1042	1000	938	146	15	9.733333333333333	896
FBgn0267022	1029	1000	998	60	11	5.454545454545454	969
FBgn0267023	1012	1000	1007	17	5	3.4	995
FBgn0267024	1000	1000	968	32	3	10.666666666666666	968
FBgn0267025	1008	1000	985	31	5	6.2	977
FBgn0267026	1031	1000	920	142	18	7.888888888888889	889
FBgn0267028	1059	1000	987	131	12	10.916666666666666	928
FBgn0267030	1028	1000	1019	37	9	4.111111111111111	991
FBgn0267032	1056	1000	1014	98	7	14	958
FBgn0267033	1051	1000	986	116	9	12.88888888888889	935
FBgn0267037	1004	1000	861	147	13	11.307692307692308	857
FBgn0267038	1009	1000	957	61	14	4.357142857142857	948
FBgn0267040	1003	1000	906	100	18	5.555555555555555	903
FBgn0267041	859	817	823	78	13	6	781
FBgn0267056	1039	1000	1020	58	10	5.8	981
FBgn0267057	1063	1000	1054	72	5	14.4	991
FBgn0267065	818	807	809	20	8	2.5	798
FBgn0267068	1007	1000	969	45	6	7.5	962
FBgn0267069	1002	1000	935	69	11	6.2727272727272725	933
FBgn0267071	863	854	829	43	11	3.909090909090909	820
FBgn0267072	1015	1000	976	54	10	5.4	961
FBgn0267074	1006	1000	980	32	8	4	974
FBgn0267075	1012	1000	960	64	12	5.333333333333333	948
FBgn0267076	1007	1000	1003	11	4	2.75	996
FBgn0267077	1045	1000	999	91	13	7	954
FBgn0267078	1000	1000	960	40	5	8	960
FBgn0267080	1056	1000	1017	95	17	5.588235294117647	961
FBgn0267081	1005	1000	964	46	6	7.666666666666667	959
FBgn0267083	1031	1000	975	87	15	5.8	944
FBgn0267084	1082	1000	1057	107	13	8.23076923076923	975
FBgn0267088	1025	1000	973	77	9	8.555555555555555	948
FBgn0267089	1017	1000	972	62	12	5.166666666666667	955
FBgn0267090	1001	1000	958	44	11	4	957
FBgn0267091	1008	1000	934	82	13	6.3076923076923075	926
FBgn0267096	1017	1000	955	79	11	7.181818181818182	938
FBgn0267097	1011	1000	914	108	18	6	903
FBgn0267098	1067	1000	1021	113	21	5.380952380952381	954
FBgn0267099	1028	1000	1019	37	8	4.625	991
FBgn0267100	1040	1000	978	102	11	9.272727272727273	938
FBgn0267101	1013	1000	922	104	12	8.666666666666666	909
FBgn0267102	1036	1000	985	87	14	6.214285714285714	949
FBgn0267103	1012	1000	845	179	9	19.88888888888889	833
FBgn0267104	1014	1000	974	54	8	6.75	960
FBgn0267105	1014	1000	984	44	6	7.333333333333333	970
FBgn0267106	1036	1000	998	74	9	8.222222222222221	962
FBgn0267107	1008	1000	983	33	8	4.125	975
FBgn0267109	1000	1000	741	259	1	259	741
FBgn0267110	1009	1000	992	26	9	2.888888888888889	983
FBgn0267112	1015	1000	982	48	7	6.857142857142857	967
FBgn0267113	1010	1000	997	23	6	3.8333333333333335	987
FBgn0267114	1000	1000	999	1	1	1	999
FBgn0267115	1009	1000	996	22	5	4.4	987
FBgn0267116	1053	1000	961	145	18	8.055555555555555	908
FBgn0267119	1008	1000	983	33	7	4.714285714285714	975
FBgn0267120	1019	1000	997	41	8	5.125	978
FBgn0267121	1000	1000	983	17	4	4.25	983
FBgn0267122	1007	1000	918	96	10	9.6	911
FBgn0267123	1005	1000	986	24	8	3	981
FBgn0267125	1006	1000	979	33	4	8.25	973
FBgn0267126	1007	1000	955	59	12	4.916666666666667	948
FBgn0267127	1025	1000	1023	27	4	6.75	998
FBgn0267128	1046	1000	1021	71	12	5.916666666666667	975
FBgn0267129	1048	1000	1031	65	12	5.416666666666667	983
FBgn0267131	1002	1000	999	5	3	1.6666666666666667	997
FBgn0267134	901	860	845	97	13	7.461538461538462	804
FBgn0267135	1024	1000	998	50	4	12.5	974
FBgn0267136	1010	1000	1009	11	5	2.2	999
FBgn0267137	824	803	813	32	8	4	792
FBgn0267139	1002	1000	992	12	3	4	990
FBgn0267140	1037	1000	992	82	10	8.2	955
FBgn0267141	1006	1000	954	58	7	8.285714285714286	948
FBgn0267142	1025	1000	987	63	13	4.846153846153846	962
FBgn0267143	1011	1000	981	41	8	5.125	970
FBgn0267144	1005	1000	963	47	9	5.222222222222222	958
FBgn0267145	1022	1000	992	52	6	8.666666666666666	970
FBgn0267146	1011	1000	961	61	8	7.625	950
FBgn0267147	794	794	781	13	6	2.1666666666666665	781
FBgn0267148	1036	1000	1019	53	11	4.818181818181818	983
FBgn0267149	1034	1000	986	82	14	5.857142857142857	952
FBgn0267150	1023	1000	1002	44	8	5.5	979
FBgn0267153	1008	1000	995	21	4	5.25	987
FBgn0267154	1013	1000	992	34	10	3.4	979
FBgn0267155	1027	1000	1016	38	8	4.75	989
FBgn0267157	1019	1000	1011	27	5	5.4	992
FBgn0267158	1000	1000	896	104	5	20.8	896
FBgn0267159	1008	1000	1004	12	4	3	996
FBgn0267160	1000	1000	988	12	3	4	988
FBgn0267161	1049	1000	1035	63	12	5.25	986
FBgn0267162	1018	1000	867	169	11	15.363636363636363	849
FBgn0267165	1030	1000	1015	45	10	4.5	985
FBgn0267166	1040	1000	1010	70	12	5.833333333333333	970
FBgn0267167	1000	1000	964	36	7	5.142857142857143	964
FBgn0267169	1038	1000	997	79	15	5.266666666666667	959
FBgn0267170	1020	1000	967	73	8	9.125	947
FBgn0267171	1021	1000	997	45	12	3.75	976
FBgn0267173	974	934	944	70	8	8.75	904
FBgn0267176	1022	1000	1010	34	10	3.4	988
FBgn0267178	1000	1000	946	54	7	7.714285714285714	946
FBgn0267180	1011	1000	982	40	9	4.444444444444445	971
FBgn0267181	1016	1000	982	50	8	6.25	966
FBgn0267182	1018	1000	909	127	9	14.11111111111111	891
FBgn0267183	1015	1000	1004	26	11	2.3636363636363638	989
FBgn0267184	1021	1000	812	230	11	20.90909090909091	791
FBgn0267185	923	850	849	147	11	13.363636363636363	776
FBgn0267187	1010	1000	1002	18	6	3	992
FBgn0267188	1050	1000	1034	66	7	9.428571428571429	984
FBgn0267189	1009	1000	935	83	14	5.928571428571429	926
FBgn0267190	1007	1000	949	65	12	5.416666666666667	942
FBgn0267191	1003	1000	984	22	7	3.142857142857143	981
FBgn0267192	1031	1000	1026	36	11	3.272727272727273	995
FBgn0267194	1000	1000	987	13	2	6.5	987
FBgn0267195	955	927	915	68	11	6.181818181818182	887
FBgn0267198	1042	1000	1036	48	6	8	994
FBgn0267200	1052	1000	1014	90	11	8.181818181818182	962
FBgn0267202	1011	1000	1002	20	6	3.3333333333333335	991
FBgn0267205	1019	1000	973	65	13	5	954
FBgn0267206	1001	1000	884	118	6	19.666666666666668	883
FBgn0267208	1000	1000	995	5	1	5	995
FBgn0267209	1002	1000	975	29	6	4.833333333333333	973
FBgn0267210	1063	1000	1056	70	9	7.777777777777778	993
FBgn0267212	1019	1000	976	62	6	10.333333333333334	957
FBgn0267213	1020	1000	987	53	10	5.3	967
FBgn0267214	1002	1000	916	88	6	14.666666666666666	914
FBgn0267216	1032	1000	1006	58	11	5.2727272727272725	974
FBgn0267217	1059	1000	1024	94	13	7.230769230769231	965
FBgn0267218	879	874	811	73	8	9.125	806
FBgn0267219	1009	1000	992	26	3	8.666666666666666	983
FBgn0267220	1026	1000	1002	50	9	5.555555555555555	976
FBgn0267222	1012	1000	960	64	11	5.818181818181818	948
FBgn0267229	1003	1000	978	28	4	7	975
FBgn0267230	1028	1000	1024	32	9	3.5555555555555554	996
FBgn0267233	1043	1000	537	549	11	49.90909090909091	494
FBgn0267234	1003	1000	983	23	8	2.875	980
FBgn0267235	1046	1000	1039	53	5	10.6	993
FBgn0267236	1003	1000	1000	6	4	1.5	997
FBgn0267237	1025	999	1011	40	11	3.6363636363636362	985
FBgn0267238	1003	1000	961	45	7	6.428571428571429	958
FBgn0267239	1001	1000	975	27	5	5.4	974
FBgn0267240	1030	1000	1008	52	6	8.666666666666666	978
FBgn0267241	1000	1000	989	11	4	2.75	989
FBgn0267243	1067	1000	1058	76	8	9.5	991
FBgn0267244	1002	1000	974	30	8	3.75	972
FBgn0267245	1003	1000	985	21	5	4.2	982
FBgn0267246	1007	1000	977	37	6	6.166666666666667	970
FBgn0267247	913	906	883	37	7	5.285714285714286	876
FBgn0267249	1000	1000	987	13	4	3.25	987
FBgn0267252	1036	1000	1018	54	10	5.4	982
FBgn0267253	1019	1000	975	63	13	4.846153846153846	956
FBgn0267255	1020	1000	1014	26	4	6.5	994
FBgn0267256	1029	1000	998	60	9	6.666666666666667	969
FBgn0267257	1002	1000	911	93	6	15.5	909
FBgn0267259	1014	1000	988	40	8	5	974
FBgn0267260	1010	1000	993	27	5	5.4	983
FBgn0267261	1017	1000	1011	23	7	3.2857142857142856	994
FBgn0267262	1049	1000	1046	52	5	10.4	997
FBgn0267263	1003	1000	948	58	12	4.833333333333333	945
FBgn0267264	1020	1000	989	51	9	5.666666666666667	969
FBgn0267265	1000	1000	996	4	3	1.3333333333333333	996
FBgn0267266	1000	1000	927	73	7	10.428571428571429	927
FBgn0267267	1008	1000	651	365	7	52.142857142857146	643
FBgn0267268	1037	1000	802	272	10	27.2	765
FBgn0267269	1000	1000	981	19	5	3.8	981
FBgn0267270	1042	1000	1037	47	6	7.833333333333333	995
FBgn0267271	1001	1000	970	32	8	4	969
FBgn0267273	1000	1000	885	115	9	12.777777777777779	885
FBgn0267274	1012	1000	958	66	6	11	946
FBgn0267275	1047	1000	993	101	15	6.733333333333333	946
FBgn0267276	1000	1000	997	3	3	1	997
FBgn0267278	1004	1000	807	201	9	22.333333333333332	803
FBgn0267279	1079	1000	1071	87	10	8.7	992
FBgn0267280	1043	1000	998	88	16	5.5	955
FBgn0267281	1077	1000	1049	105	16	6.5625	972
FBgn0267282	1033	1000	1021	45	5	9	988
FBgn0267283	1017	1000	990	44	8	5.5	973
FBgn0267284	1007	1000	992	22	11	2	985
FBgn0267286	1031	1000	961	101	21	4.809523809523809	930
FBgn0267288	1034	1000	987	81	10	8.1	953
FBgn0267289	1007	1000	997	17	8	2.125	990
FBgn0267290	1001	1000	997	5	3	1.6666666666666667	996
FBgn0267291	1006	1000	999	13	5	2.6	993
FBgn0267292	1061	1000	1030	92	14	6.571428571428571	969
FBgn0267293	1064	1000	965	163	10	16.3	901
FBgn0267294	1011	1000	1006	16	5	3.2	995
FBgn0267295	1002	1000	876	128	18	7.111111111111111	874
FBgn0267296	691	673	662	47	8	5.875	644
FBgn0267297	1004	1000	981	27	4	6.75	977
FBgn0267298	1001	1000	994	8	4	2	993
FBgn0267301	1021	1000	998	44	5	8.8	977
FBgn0267302	1048	1000	1045	51	8	6.375	997
FBgn0267303	1031	1000	1030	32	4	8	999
FBgn0267304	1037	1000	1026	48	5	9.6	989
FBgn0267305	1007	1000	920	94	9	10.444444444444445	913
FBgn0267306	1020	1000	990	50	8	6.25	970
FBgn0267307	1035	1000	1023	47	9	5.222222222222222	988
FBgn0267308	1008	1000	1008	8	2	4	1000
FBgn0267309	1006	1000	981	31	5	6.2	975
FBgn0267310	1017	1000	997	37	10	3.7	980
FBgn0267312	1038	1000	1037	39	5	7.8	999
FBgn0267313	1017	1000	989	45	7	6.428571428571429	972
FBgn0267314	1056	1000	1051	61	5	12.2	995
FBgn0267318	1005	1000	744	266	11	24.181818181818183	739
FBgn0267322	1080	1000	1040	120	19	6.315789473684211	960
FBgn0267323	1004	1000	966	42	10	4.2	962
FBgn0267327	1051	1000	1039	63	12	5.25	988
FBgn0267330	1017	1000	1017	17	6	2.8333333333333335	1000
FBgn0267348	1033	1000	1017	49	7	7	984
FBgn0267350	1004	1000	986	22	5	4.4	982
FBgn0267351	1009	1000	1001	17	4	4.25	992
FBgn0267376	1000	1000	996	4	2	2	996
FBgn0267378	1017	1000	1014	20	5	4	997
FBgn0267383	1019	1000	976	62	14	4.428571428571429	957
FBgn0267384	1017	1000	999	35	9	3.888888888888889	982
FBgn0267390	902	887	840	77	9	8.555555555555555	825
FBgn0267399	1016	1000	1008	24	6	4	992
FBgn0267400	1000	1000	936	64	7	9.142857142857142	936
FBgn0267425	1058	1000	884	232	18	12.88888888888889	826
FBgn0267428	1032	1000	720	344	8	43	688
FBgn0267438	1002	1000	976	28	7	4	974
FBgn0267440	1017	1000	995	39	9	4.333333333333333	978
FBgn0267442	1041	1000	985	97	13	7.461538461538462	944
FBgn0267447	1000	1000	958	42	5	8.4	958
FBgn0267448	1001	1000	345	657	2	328.5	344
FBgn0267450	1009	1000	995	23	4	5.75	986
FBgn0267451	738	723	697	56	8	7	682
FBgn0267452	1043	1000	1017	69	13	5.3076923076923075	974
FBgn0267453	1083	1000	741	425	16	26.5625	658
FBgn0267454	1011	1000	976	46	9	5.111111111111111	965
FBgn0267455	1004	1000	994	14	6	2.3333333333333335	990
FBgn0267457	825	824	813	13	5	2.6	812
FBgn0267461	1003	1000	1000	6	3	2	997
FBgn0267462	1000	1000	984	16	1	16	984
FBgn0267463	1039	1000	1031	47	9	5.222222222222222	992
FBgn0267464	967	967	960	7	2	3.5	960
FBgn0267465	1034	1000	997	71	9	7.888888888888889	963
FBgn0267468	1000	1000	1000	0	0	NA	1000
FBgn0267469	1040	1000	939	141	12	11.75	899
FBgn0267470	1000	1000	992	8	2	4	992
FBgn0267471	1003	1000	860	146	7	20.857142857142858	857
FBgn0267472	1000	1000	997	3	1	3	997
FBgn0267473	1019	1000	950	88	13	6.769230769230769	931
FBgn0267474	1007	1000	996	18	4	4.5	989
FBgn0267476	1033	1000	994	72	10	7.2	961
FBgn0267479	1000	1000	986	14	4	3.5	986
FBgn0267480	1048	1000	1017	79	13	6.076923076923077	969
FBgn0267482	1034	1000	1004	64	9	7.111111111111111	970
FBgn0267484	1006	1000	967	45	4	11.25	961
FBgn0267485	1004	1000	966	42	5	8.4	962
FBgn0267487	915	915	867	48	9	5.333333333333333	867
FBgn0267488	1001	1000	972	30	6	5	971
FBgn0267525	1009	1000	963	55	9	6.111111111111111	954
FBgn0267526	1011	1000	993	29	3	9.666666666666666	982
FBgn0267527	1000	1000	942	58	8	7.25	942
FBgn0267528	1047	1000	971	123	7	17.571428571428573	924
FBgn0267529	869	862	825	51	10	5.1	818
FBgn0267531	887	887	887	0	0	NA	887
FBgn0267535	1012	1000	976	48	11	4.363636363636363	964
FBgn0267541	1028	1000	982	74	14	5.285714285714286	954
FBgn0267544	1037	1000	1029	45	10	4.5	992
FBgn0267545	1022	1000	1012	32	9	3.5555555555555554	990
FBgn0267546	843	824	833	29	7	4.142857142857143	814
FBgn0267547	1053	1000	1047	59	7	8.428571428571429	994
FBgn0267548	1013	1000	967	59	7	8.428571428571429	954
FBgn0267549	1014	1000	939	89	14	6.357142857142857	925
FBgn0267551	1014	1000	1002	26	7	3.7142857142857144	988
FBgn0267555	1081	1000	1061	101	12	8.416666666666666	980
FBgn0267556	1007	1000	1004	10	2	5	997
FBgn0267559	1004	1000	523	485	6	80.83333333333333	519
FBgn0267560	1025	1000	974	76	11	6.909090909090909	949
FBgn0267561	1003	1000	985	21	4	5.25	982
FBgn0267564	1018	1000	1001	35	6	5.833333333333333	983
FBgn0267566	1005	1000	991	19	6	3.1666666666666665	986
FBgn0267567	1024	1000	997	51	5	10.2	973
FBgn0267568	1018	1000	796	240	7	34.285714285714285	778
FBgn0267569	1002	1000	989	15	3	5	987
FBgn0267570	1009	1000	1004	14	11	1.2727272727272727	995
FBgn0267571	1014	1000	915	113	11	10.272727272727273	901
FBgn0267572	1000	1000	984	16	2	8	984
FBgn0267573	1044	1000	989	99	14	7.071428571428571	945
FBgn0267574	1028	1000	946	110	5	22	918
FBgn0267575	1006	1000	1004	8	2	4	998
FBgn0267576	1006	1000	991	21	10	2.1	985
FBgn0267579	1007	1000	991	23	7	3.2857142857142856	984
FBgn0267580	1039	1000	1037	41	5	8.2	998
FBgn0267586	1019	1000	929	109	9	12.11111111111111	910
FBgn0267587	1000	1000	986	14	3	4.666666666666667	986
FBgn0267589	949	949	949	0	0	NA	949
FBgn0267590	1000	1000	997	3	1	3	997
FBgn0267591	1013	1000	996	30	8	3.75	983
FBgn0267597	1079	1000	961	197	23	8.565217391304348	882
FBgn0267598	1034	1000	1011	57	9	6.333333333333333	977
FBgn0267599	1055	1000	1027	83	11	7.545454545454546	972
FBgn0267601	1083	1000	1060	106	14	7.571428571428571	977
FBgn0267604	1035	1000	1001	69	12	5.75	966
FBgn0267606	1074	1000	1055	93	9	10.333333333333334	981
FBgn0267607	1017	1000	804	230	7	32.857142857142854	787
FBgn0267611	1044	1000	983	105	15	7	939
FBgn0267620	1005	1000	987	23	4	5.75	982
FBgn0267621	1043	1000	1037	49	8	6.125	994
FBgn0267622	1053	1000	975	131	12	10.916666666666666	922
FBgn0267625	1019	1000	990	48	7	6.857142857142857	971
FBgn0267626	1027	1000	1020	34	8	4.25	993
FBgn0267628	1001	1000	970	32	5	6.4	969
FBgn0267629	880	872	802	86	6	14.333333333333334	794
FBgn0267630	885	878	863	29	7	4.142857142857143	856
FBgn0267631	1032	1000	1009	55	8	6.875	977
FBgn0267632	1000	1000	996	4	2	2	996
FBgn0267633	1011	1000	1000	22	7	3.142857142857143	989
FBgn0267636	1009	1000	955	63	15	4.2	946
FBgn0267639	1005	1000	960	50	8	6.25	955
FBgn0267642	1001	1000	986	16	4	4	985
FBgn0267644	1019	1000	975	63	16	3.9375	956
FBgn0267647	1010	1000	998	22	5	4.4	988
FBgn0267653	1003	1000	932	74	5	14.8	929
FBgn0267655	1040	1000	1025	55	11	5	985
FBgn0267658	1040	1000	1013	67	6	11.166666666666666	973
FBgn0267660	1055	1000	1046	64	10	6.4	991
FBgn0267661	1085	1000	1032	138	16	8.625	947
FBgn0267663	1001	1000	947	55	7	7.857142857142857	946
FBgn0267664	1000	1000	961	39	5	7.8	961
FBgn0267665	1019	1000	1001	37	11	3.3636363636363638	982
FBgn0267666	1004	1000	990	18	7	2.5714285714285716	986
FBgn0267668	1039	1000	1025	53	7	7.571428571428571	986
FBgn0267671	1000	1000	997	3	3	1	997
FBgn0267672	1003	1000	990	16	6	2.6666666666666665	987
FBgn0267674	1036	1000	1033	39	5	7.8	997
FBgn0267675	840	826	818	36	8	4.5	804
FBgn0267676	1000	1000	999	1	1	1	999
FBgn0267681	1008	1000	993	23	4	5.75	985
FBgn0267683	1033	1000	1002	64	10	6.4	969
FBgn0267685	1026	1000	1018	34	8	4.25	992
FBgn0267689	796	790	778	24	7	3.4285714285714284	772
FBgn0267690	765	718	738	74	12	6.166666666666667	691
FBgn0267692	1001	1000	995	7	4	1.75	994
FBgn0267693	1019	1000	980	58	6	9.666666666666666	961
FBgn0267694	1024	1000	977	71	9	7.888888888888889	953
FBgn0267695	1000	1000	1000	0	0	NA	1000
FBgn0267697	1003	1000	1001	5	4	1.25	998
FBgn0267701	1035	1000	731	339	11	30.818181818181817	696
FBgn0267702	1003	1000	925	81	13	6.230769230769231	922
FBgn0267703	1038	1000	1035	41	5	8.2	997
FBgn0267707	813	795	763	68	11	6.181818181818182	745
FBgn0267708	1022	1000	944	100	16	6.25	922
FBgn0267710	1006	1000	981	31	12	2.5833333333333335	975
FBgn0267711	1005	1000	868	142	3	47.333333333333336	863
FBgn0267712	1052	1000	1047	57	11	5.181818181818182	995
FBgn0267713	1006	1000	924	88	8	11	918
FBgn0267714	1000	1000	72	928	2	464	72
FBgn0267715	1098	1000	945	251	16	15.6875	847
FBgn0267716	1033	1000	982	84	18	4.666666666666667	949
FBgn0267717	1010	1000	934	86	12	7.166666666666667	924
FBgn0267721	1001	1000	948	54	9	6	947
FBgn0267722	1014	1000	1007	21	7	3	993
FBgn0267723	1002	1000	980	24	10	2.4	978
FBgn0267725	1004	1000	934	74	10	7.4	930
FBgn0267729	1009	1000	979	39	7	5.571428571428571	970
FBgn0267730	1000	1000	964	36	4	9	964
FBgn0267732	1044	1000	1031	57	11	5.181818181818182	987
FBgn0267735	1065	1000	1014	116	13	8.923076923076923	949
FBgn0267736	1015	1000	974	56	11	5.090909090909091	959
FBgn0267737	1076	1000	1048	104	9	11.555555555555555	972
FBgn0267738	1008	1000	1003	13	4	3.25	995
FBgn0267739	1000	1000	1000	0	0	NA	1000
FBgn0267740	1055	1000	991	119	18	6.611111111111111	936
FBgn0267742	1022	1000	1020	24	3	8	998
FBgn0267744	1023	1000	993	53	8	6.625	970
FBgn0267745	1014	1000	972	56	10	5.6	958
FBgn0267746	1003	1000	997	9	6	1.5	994
FBgn0267747	1001	1000	983	19	8	2.375	982
FBgn0267748	1003	1000	943	63	4	15.75	940
FBgn0267751	1047	1000	1044	50	6	8.333333333333334	997
FBgn0267753	1002	1000	977	27	7	3.857142857142857	975
FBgn0267754	1027	1000	904	150	4	37.5	877
FBgn0267755	1000	1000	991	9	2	4.5	991
FBgn0267756	1000	1000	975	25	3	8.333333333333334	975
FBgn0267760	1014	1000	1006	22	4	5.5	992
FBgn0267761	1040	1000	1040	40	3	13.333333333333334	1000
FBgn0267762	1003	1000	1001	5	3	1.6666666666666667	998
FBgn0267763	1005	1000	940	70	5	14	935
FBgn0267765	903	894	894	18	5	3.6	885
FBgn0267766	1001	1000	974	28	3	9.333333333333334	973
FBgn0267767	1013	1000	975	51	12	4.25	962
FBgn0267768	1000	1000	999	1	1	1	999
FBgn0267769	1011	1000	993	29	10	2.9	982
FBgn0267770	1000	1000	994	6	2	3	994
FBgn0267771	1011	1000	948	74	11	6.7272727272727275	937
FBgn0267773	1058	1000	1045	71	11	6.454545454545454	987
FBgn0267774	1038	1000	980	96	9	10.666666666666666	942
FBgn0267775	1002	1000	980	24	8	3	978
FBgn0267776	1008	1000	1007	9	4	2.25	999
FBgn0267778	1000	1000	1000	0	0	NA	1000
FBgn0267779	1025	1000	858	192	12	16	833
FBgn0267782	1024	1000	967	81	9	9	943
FBgn0267783	1001	1000	960	42	14	3	959
FBgn0267785	1000	1000	974	26	1	26	974
FBgn0267788	1010	1000	982	38	13	2.923076923076923	972
FBgn0267789	1011	1000	997	25	6	4.166666666666667	986
FBgn0267790	1004	1000	963	45	4	11.25	959
FBgn0267791	1023	1000	965	81	10	8.1	942
FBgn0267792	1001	1000	742	260	3	86.66666666666667	741
FBgn0267793	1020	1000	1006	34	6	5.666666666666667	986
FBgn0267794	1033	1000	1004	62	8	7.75	971
FBgn0267795	1022	1000	1004	40	7	5.714285714285714	982
FBgn0267796	1051	1000	1042	60	7	8.571428571428571	991
FBgn0267803	1000	1000	1000	0	0	NA	1000
FBgn0267804	766	721	752	59	10	5.9	707
FBgn0267805	1031	1000	1028	34	9	3.7777777777777777	997
FBgn0267806	1005	1000	967	43	7	6.142857142857143	962
FBgn0267807	1022	1000	1015	29	8	3.625	993
FBgn0267809	947	943	936	15	5	3	932
FBgn0267810	1056	1000	1015	97	14	6.928571428571429	959
FBgn0267811	1035	1000	1026	44	6	7.333333333333333	991
FBgn0267817	1029	1000	1000	58	8	7.25	971
FBgn0267819	1004	1000	1004	4	2	2	1000
FBgn0267820	1019	1000	1006	32	9	3.5555555555555554	987
FBgn0267823	1000	1000	1000	0	0	NA	1000
FBgn0267824	1059	1000	1012	106	20	5.3	953
FBgn0267826	1062	1000	950	174	16	10.875	888
FBgn0267827	1012	1000	995	29	6	4.833333333333333	983
FBgn0267828	1000	1000	998	2	1	2	998
FBgn0267849	1019	1000	998	40	9	4.444444444444445	979
FBgn0267865	1006	1000	992	20	8	2.5	986
FBgn0267868	1031	1000	964	98	13	7.538461538461538	933
FBgn0267912	1053	1000	1047	59	9	6.555555555555555	994
FBgn0267914	1007	1000	994	20	5	4	987
FBgn0267915	1066	1000	1011	121	11	11	945
FBgn0267916	1006	1000	950	62	12	5.166666666666667	944
FBgn0267917	1009	1000	1005	13	3	4.333333333333333	996
FBgn0267918	1034	1000	1020	48	6	8	986
FBgn0267919	1009	1000	991	27	12	2.25	982
FBgn0267921	1042	1000	774	310	16	19.375	732
FBgn0267922	1010	1000	995	25	9	2.7777777777777777	985
FBgn0267923	1022	1000	1007	37	12	3.0833333333333335	985
FBgn0267925	1023	1000	962	84	9	9.333333333333334	939
FBgn0267926	1031	1000	1017	45	10	4.5	986
FBgn0267927	1004	1000	984	24	11	2.1818181818181817	980
FBgn0267928	1029	1000	988	70	9	7.777777777777778	959
FBgn0267930	1013	1000	946	80	10	8	933
FBgn0267932	1018	1000	984	52	11	4.7272727272727275	966
FBgn0267933	1008	1000	806	210	5	42	798
FBgn0267934	1058	1000	1005	111	10	11.1	947
FBgn0267935	1024	1000	989	59	12	4.916666666666667	965
FBgn0267936	1016	1000	945	87	14	6.214285714285714	929
FBgn0267937	1001	1000	974	28	3	9.333333333333334	973
FBgn0267938	1004	1000	971	37	6	6.166666666666667	967
FBgn0267939	1002	1000	972	32	5	6.4	970
FBgn0267940	1033	1000	991	75	11	6.818181818181818	958
FBgn0267941	1082	1000	1075	89	13	6.846153846153846	993
FBgn0267945	1014	1000	989	39	6	6.5	975
FBgn0267946	1001	1000	962	40	6	6.666666666666667	961
FBgn0267947	1042	1000	958	126	19	6.631578947368421	916
FBgn0267948	1025	1000	986	64	9	7.111111111111111	961
FBgn0267950	1017	1000	995	39	9	4.333333333333333	978
FBgn0267952	1036	1000	1022	50	5	10	986
FBgn0267953	1000	1000	1000	0	0	NA	1000
FBgn0267954	1008	1000	1005	11	5	2.2	997
FBgn0267956	1007	1000	967	47	9	5.222222222222222	960
FBgn0267957	1003	1000	804	202	11	18.363636363636363	801
FBgn0267958	1008	1000	968	48	5	9.6	960
FBgn0267959	1036	1000	1003	69	13	5.3076923076923075	967
FBgn0267960	1047	1000	973	121	19	6.368421052631579	926
FBgn0267961	1023	1000	999	47	11	4.2727272727272725	976
FBgn0267962	1015	1000	941	89	15	5.933333333333334	926
FBgn0267966	1004	1000	958	50	7	7.142857142857143	954
FBgn0267969	1002	1000	955	49	10	4.9	953
FBgn0267970	1000	1000	987	13	3	4.333333333333333	987
FBgn0267972	1006	1000	977	35	7	5	971
FBgn0267977	1061	1000	1013	109	12	9.083333333333334	952
FBgn0267978	1030	1000	942	118	15	7.866666666666666	912
FBgn0267982	1010	1000	999	21	5	4.2	989
FBgn0267984	1023	1000	961	85	9	9.444444444444445	938
FBgn0267988	1033	1000	992	74	10	7.4	959
FBgn0267989	1006	1000	995	17	3	5.666666666666667	989
FBgn0267992	1012	1000	979	45	8	5.625	967
FBgn0267993	1000	1000	962	38	5	7.6	962
FBgn0267994	1029	1000	1029	29	6	4.833333333333333	1000
FBgn0267995	1005	1000	989	21	4	5.25	984
FBgn0267996	1003	1000	1000	6	3	2	997
FBgn0268063	1016	1000	982	50	7	7.142857142857143	966
FBgn0270927	1001	1000	986	16	6	2.6666666666666665	985
FBgn0275432	1037	1000	1032	42	8	5.25	995
FBgn0275434	1022	1000	1002	42	8	5.25	980
FBgn0278597	1005	1000	1003	7	5	1.4	998
FBgn0278600	1044	1000	1044	44	4	11	1000
FBgn0278604	1001	1000	996	6	3	2	995
FBgn0283426	1030	1000	1002	58	14	4.142857142857143	972
FBgn0283427	1010	1000	1004	16	6	2.6666666666666665	994
FBgn0283437	1005	1000	950	60	8	7.5	945
FBgn0283438	1002	1000	949	55	4	13.75	947
FBgn0283451	1040	1000	1013	67	10	6.7	973
FBgn0283467	1005	1000	999	11	7	1.5714285714285714	994
FBgn0283469	1039	1000	1018	60	9	6.666666666666667	979
FBgn0283471	1004	1000	941	67	18	3.7222222222222223	937
FBgn0283472	1002	1000	1001	3	2	1.5	999
FBgn0283476	1047	1000	1030	64	11	5.818181818181818	983
FBgn0283477	1006	1000	999	13	5	2.6	993
FBgn0283478	1000	1000	994	6	2	3	994
FBgn0283479	1009	1000	955	63	8	7.875	946
FBgn0283480	1067	1000	918	216	8	27	851
FBgn0283500	1014	1000	1010	18	4	4.5	996
FBgn0283501	1021	1000	1014	28	7	4	993
FBgn0283508	1026	1000	1000	52	8	6.5	974
FBgn0283509	1011	1000	1011	11	2	5.5	1000
FBgn0283525	755	746	722	42	4	10.5	713
FBgn0283531	1039	1000	978	100	9	11.11111111111111	939
FBgn0283535	1011	1000	1007	15	5	3	996
FBgn0283536	1010	1000	1004	16	9	1.7777777777777777	994
FBgn0283547	1025	1000	980	70	7	10	955
FBgn0283548	1000	1000	996	4	3	1.3333333333333333	996
FBgn0283554	1042	1000	1041	43	4	10.75	999
FBgn0283557	1026	1000	982	70	6	11.666666666666666	956
FBgn0283560	1012	1000	985	39	5	7.8	973
FBgn0283625	1059	1000	1048	70	10	7	989
FBgn0283626	1005	1000	364	646	3	215.33333333333334	359
FBgn0283649	971	939	971	32	3	10.666666666666666	939
FBgn0283651	1001	1000	994	8	4	2	993
FBgn0283657	1001	1000	995	7	3	2.3333333333333335	994
FBgn0283658	864	821	817	90	12	7.5	774
FBgn0283659	1000	1000	995	5	3	1.6666666666666667	995
FBgn0283666	1018	1000	987	49	13	3.769230769230769	969
FBgn0283678	1015	1000	946	84	9	9.333333333333334	931
FBgn0283680	1020	1000	999	41	11	3.727272727272727	979
FBgn0283681	1000	1000	999	1	1	1	999
FBgn0283682	1006	1000	993	19	5	3.8	987
FBgn0283724	1020	1000	1014	26	7	3.7142857142857144	994
FBgn0283728	1000	1000	977	23	8	2.875	977
FBgn0284081	1069	1000	1056	82	14	5.857142857142857	987
FBgn0284084	1026	1000	1019	33	4	8.25	993
FBgn0284220	1018	1000	968	68	15	4.533333333333333	950
FBgn0284244	1000	1000	937	63	7	9	937
FBgn0284245	1001	1000	971	31	7	4.428571428571429	970
FBgn0284246	1031	1000	811	251	9	27.88888888888889	780
FBgn0284247	1010	1000	989	31	4	7.75	979
FBgn0284249	1004	1000	982	26	5	5.2	978
FBgn0284252	1046	1000	1040	52	10	5.2	994
FBgn0284253	1033	1000	1023	43	6	7.166666666666667	990
FBgn0284255	1024	1000	1007	41	15	2.7333333333333334	983
FBgn0284256	1072	1000	1025	119	13	9.153846153846153	953
FBgn0284257	1034	1000	941	127	13	9.76923076923077	907
FBgn0284409	1002	1000	963	41	4	10.25	961
FBgn0284410	1003	1000	995	11	5	2.2	992
FBgn0284411	1027	1000	967	87	12	7.25	940
FBgn0284412	1004	1000	902	106	9	11.777777777777779	898
FBgn0284413	1028	1000	1003	53	11	4.818181818181818	975
FBgn0284414	1030	1000	1016	44	8	5.5	986
FBgn0284415	1008	1000	984	32	7	4.571428571428571	976
FBgn0284416	1073	1000	1024	122	10	12.2	951
FBgn0284418	1009	1000	969	49	6	8.166666666666666	960
FBgn0284419	1001	1000	984	18	4	4.5	983
FBgn0284420	1006	1000	1001	11	5	2.2	995
FBgn0284421	1013	1000	996	30	6	5	983
FBgn0284444	1008	1000	941	75	14	5.357142857142857	933
FBgn0285879	1052	1000	1006	98	12	8.166666666666666	954
FBgn0285892	895	875	867	48	6	8	847
FBgn0285917	1006	1000	1002	10	5	2	996
FBgn0285926	1022	1000	972	72	12	6	950
FBgn0285940	1025	1000	1000	50	7	7.142857142857143	975
FBgn0285941	1032	1000	1004	60	5	12	972
FBgn0285943	1008	1000	1002	14	4	3.5	994
FBgn0285944	1063	1000	978	148	12	12.333333333333334	915
FBgn0285947	1000	1000	491	509	5	101.8	491
FBgn0285950	1012	1000	1011	13	2	6.5	999
FBgn0285954	1002	1000	996	8	5	1.6	994
FBgn0285955	1005	1000	981	29	7	4.142857142857143	976
FBgn0285962	1019	1000	994	44	8	5.5	975
FBgn0285963	1034	1000	978	90	15	6	944
FBgn0285971	1034	1000	1032	36	6	6	998
FBgn0286005	1002	1000	992	12	3	4	990
FBgn0286027	1006	1000	1001	11	4	2.75	995
FBgn0286028	1011	1000	992	30	6	5	981
FBgn0286029	1007	1000	978	36	11	3.272727272727273	971
FBgn0286031	1028	1000	1027	29	5	5.8	999
FBgn0286033	1009	1000	1007	11	3	3.6666666666666665	998
FBgn0286051	1070	1000	1067	73	9	8.11111111111111	997
FBgn0286071	1024	1000	938	110	15	7.333333333333333	914
FBgn0286075	1003	1000	1000	6	3	2	997
FBgn0286198	992	970	965	49	9	5.444444444444445	943
FBgn0286203	1023	1000	969	77	14	5.5	946
FBgn0286204	1056	1000	1027	85	11	7.7272727272727275	971
FBgn0286222	1015	1000	997	33	7	4.714285714285714	982
FBgn0286507	735	711	734	25	3	8.333333333333334	710
FBgn0286508	1013	1000	880	146	17	8.588235294117647	867
FBgn0286516	1071	1000	1040	102	14	7.285714285714286	969
FBgn0286567	1021	1000	1016	26	6	4.333333333333333	995
FBgn0286726	930	927	914	19	3	6.333333333333333	911
FBgn0286728	1001	1000	960	42	7	6	959
FBgn0286731	1026	1000	1023	29	13	2.230769230769231	997
FBgn0286732	1064	1000	1057	71	9	7.888888888888889	993
FBgn0286733	1071	1000	1036	106	11	9.636363636363637	965
FBgn0286735	1043	1000	1000	86	13	6.615384615384615	957
FBgn0286740	1012	1000	991	33	4	8.25	979
FBgn0286782	1063	1000	1013	113	17	6.647058823529412	950
FBgn0286783	735	710	697	63	9	7	672
FBgn0286784	1006	1000	999	13	6	2.1666666666666665	993
FBgn0286785	1074	1000	1051	97	18	5.388888888888889	977
FBgn0286786	1069	1000	1050	88	10	8.8	981
FBgn0286813	1001	1000	999	3	2	1.5	998
FBgn0286827	1003	1000	944	62	7	8.857142857142858	941
FBgn0286828	1006	1000	1002	10	5	2	996
FBgn0286833	1001	1000	964	38	4	9.5	963
FBgn0286834	1027	1000	1018	36	9	4	991
FBgn0286852	1039	1000	1004	74	11	6.7272727272727275	965
FBgn0286868	1030	1000	980	80	14	5.714285714285714	950
FBgn0286873	1058	1000	1045	71	15	4.733333333333333	987
FBgn0286874	864	862	860	6	4	1.5	858
FBgn0286875	1043	1000	1010	76	17	4.470588235294118	967
FBgn0286880	1002	1000	928	76	7	10.857142857142858	926
FBgn0286881	913	863	836	127	9	14.11111111111111	786
FBgn0286882	1002	1000	1000	4	4	1	998
FBgn0286885	711	711	166	545	2	272.5	166
FBgn0286891	1000	1000	946	54	5	10.8	946
FBgn0286898	1020	1000	1008	32	5	6.4	988
FBgn0286916	1066	1000	1063	69	8	8.625	997
FBgn0286921	1071	1000	1045	97	10	9.7	974
FBgn0286926	922	883	881	80	8	10	842
FBgn0286927	1032	1000	967	97	11	8.818181818181818	935
FBgn0286933	1057	1000	1039	75	13	5.769230769230769	982
FBgn0287182	1035	1000	672	398	13	30.615384615384617	637
FBgn0287185	1041	1000	596	486	12	40.5	555
FBgn0287211	1023	1000	966	80	10	8	943
FBgn0287213	1016	1000	1010	22	9	2.4444444444444446	994
FBgn0287214	1015	1000	1015	15	2	7.5	1000
FBgn0287216	1000	1000	972	28	4	7	972
FBgn0287218	1044	1000	1001	87	11	7.909090909090909	957
FBgn0287225	1002	1000	995	9	3	3	993
FBgn0287234	1006	1000	987	25	8	3.125	981
FBgn0287423	1007	1000	968	46	10	4.6	961
FBgn0287454	1030	1000	995	65	5	13	965
FBgn0287462	1020	1000	1013	27	8	3.375	993
FBgn0287463	1000	1000	998	2	1	2	998
FBgn0287464	1046	1000	1019	73	11	6.636363636363637	973
FBgn0287465	1002	1000	994	10	4	2.5	992
FBgn0287585	1023	1000	1019	27	8	3.375	996
FBgn0287587	1016	1000	1012	20	4	5	996
FBgn0287591	1021	1000	990	52	7	7.428571428571429	969
FBgn0287594	1037	1000	977	97	11	8.818181818181818	940
FBgn0287601	1007	1000	993	21	7	3	986
FBgn0287602	1014	1000	969	59	9	6.555555555555555	955
FBgn0287604	1050	1000	973	127	16	7.9375	923
FBgn0287605	810	801	794	25	5	5	785
FBgn0287609	1008	1000	992	24	6	4	984
FBgn0287615	1000	1000	941	59	10	5.9	941
FBgn0287616	1013	1000	868	158	8	19.75	855
FBgn0287617	1007	1000	993	21	4	5.25	986
FBgn0287621	1006	1000	995	17	7	2.4285714285714284	989
FBgn0287631	1004	1000	986	22	8	2.75	982
FBgn0287633	1033	1000	859	207	16	12.9375	826
FBgn0287645	1028	1000	995	61	12	5.083333333333333	967
FBgn0287667	1004	1000	999	9	5	1.8	995
FBgn0287668	1030	1000	1026	34	6	5.666666666666667	996
FBgn0287670	1005	1000	991	19	8	2.375	986
FBgn0287695	1019	1000	1017	21	7	3	998
FBgn0287696	1004	1000	974	34	6	5.666666666666667	970
FBgn0287720	1027	1000	996	58	15	3.8666666666666667	969
FBgn0287768	1027	1000	862	192	14	13.714285714285714	835
FBgn0287775	1000	1000	989	11	4	2.75	989
FBgn0287788	1000	1000	997	3	1	3	997
FBgn0287825	1000	1000	986	14	3	4.666666666666667	986
FBgn0287828	1042	1000	987	97	12	8.083333333333334	945
FBgn0287844	1092	1000	1070	114	13	8.76923076923077	978
FBgn0287864	1002	1000	984	20	5	4	982
FBgn0287873	1019	1000	1010	28	7	4	991
